Time,Team,Operation,BuyVolume,SellVolume,EtfPosition,FuturePosition,EtfPrice,FuturePrice,TotalFees,AccountBalance,ProfitOrLoss,Status
1e-06,TraderOne,Tick,0,0,0,0,,,0,0,0,OK
0.202698,TraderOne,Tick,0,0,0,0,,,0,0,0,OK
0.489474,TraderOne,Tick,0,0,0,0,,,0,0,0,OK
0.795278,TraderOne,Tick,0,0,0,0,,,0,0,0,OK
0.979641,TraderOne,Tick,0,10,-10,10,147600,,-147,147,147,OK
1.22406,TraderOne,Tick,1,10,-9,9,147100,147100,-162,162,162,OK
1.522615,TraderOne,Tick,1,10,-9,9,147100,147100,-162,162,162,OK
1.775186,TraderOne,Tick,1,10,-9,9,147100,147100,-162,162,162,OK
2.042858,TraderOne,Tick,1,10,-9,9,147100,147000,-162,162,-738,OK
2.24185,TraderOne,Tick,1,10,-9,9,147100,146900,-162,162,-1638,OK
2.526537,TraderOne,Tick,11,10,1,-1,146400,146900,-309,-1691,-1891,OK
2.790115,TraderOne,Tick,11,10,1,-1,146400,146900,-309,-1691,-1891,OK
3.0056,TraderOne,Tick,11,10,1,-1,146400,146900,-309,-1691,-1891,OK
3.27758,TraderOne,Tick,11,10,1,-1,146400,146900,-309,-1691,-1891,OK
3.456409,TraderOne,Tick,11,20,-9,9,147500,146900,-456,-1544,-3344,OK
3.740713,TraderOne,Tick,21,20,1,-1,146300,146900,-603,-2397,-2597,OK
4.019006,TraderOne,Tick,21,20,1,-1,146300,146900,-603,-2397,-2597,OK
4.254544,TraderOne,Tick,21,20,1,-1,146300,146900,-603,-2397,-2597,OK
4.473451,TraderOne,Tick,21,20,1,-1,146300,146900,-603,-2397,-2597,OK
4.735201,TraderOne,Tick,31,20,11,-11,146300,146900,-750,-2250,-4450,OK
4.958952,TraderOne,Tick,31,20,11,-11,146300,146900,-750,-2250,-4450,OK
5.249389,TraderOne,Tick,31,20,11,-11,146300,146800,-750,-2250,-4450,OK
5.502712,TraderOne,Tick,31,20,11,-11,146300,146800,-750,-2250,-4450,OK
5.702233,TraderOne,Tick,31,20,11,-11,146300,146800,-750,-2250,-4450,OK
6.037869,TraderOne,Tick,31,30,1,-1,147000,146800,-456,-2544,-2344,OK
6.277523,TraderOne,Tick,31,40,-9,9,147000,146800,-162,-1838,-3638,OK
6.523979,TraderOne,Tick,31,50,-19,19,147000,146800,132,868,-2932,OK
6.71653,TraderOne,Tick,31,60,-29,29,147200,146700,426,3574,-2226,OK
6.981296,TraderOne,Tick,31,60,-29,29,147200,146900,426,3574,-2226,OK
7.273554,TraderOne,Tick,31,60,-29,29,147200,146900,426,3574,-2226,OK
7.499996,TraderOne,Tick,31,60,-29,29,147200,146900,426,3574,-2226,OK
7.74269,TraderOne,Tick,31,60,-29,29,147200,146900,426,3574,-2226,OK
8.027353,TraderOne,Tick,31,60,-29,29,147200,146900,426,3574,-2226,OK
8.224836,TraderOne,Tick,41,60,-19,19,147000,146900,279,721,-1179,OK
8.524134,TraderOne,Tick,41,60,-19,19,147000,146900,279,721,-1179,OK
8.792655,TraderOne,Tick,41,60,-19,19,147000,146900,279,721,-1179,OK
8.964288,TraderOne,Tick,51,60,-9,9,146700,146900,132,-1132,668,OK
9.296234,TraderOne,Tick,61,60,1,-1,146400,146900,425,1575,1375,OK
9.50998,TraderOne,Tick,71,60,11,-11,146400,146900,718,4282,2082,OK
9.765239,TraderOne,Tick,81,60,21,-21,146400,146900,1011,5989,1789,OK
9.976651,TraderOne,Tick,81,60,21,-21,146400,146900,1011,5989,1789,OK
10.285963,TraderOne,Tick,91,60,31,-31,146400,146900,1304,7696,1496,OK
10.469826,TraderOne,Tick,101,60,41,-41,146400,146900,1597,11403,3203,OK
10.72032,TraderOne,Tick,111,70,41,-41,146500,147000,1744,8256,56,OK
11.01971,TraderOne,Tick,111,80,31,-31,147300,147000,1597,4403,10603,OK
11.248602,TraderOne,Tick,111,80,31,-31,147300,147000,1597,4403,10603,OK
11.48546,TraderOne,Tick,111,80,31,-31,147300,147000,1597,4403,10603,OK
11.736112,TraderOne,Tick,111,80,31,-31,147300,147200,1597,4403,7503,OK
11.956655,TraderOne,Tick,111,90,21,-21,147400,147200,1450,2550,6750,OK
12.261266,TraderOne,Tick,111,90,21,-21,147400,147200,1450,2550,6750,OK
12.463554,TraderOne,Tick,111,90,21,-21,147400,147200,1450,2550,6750,OK
12.729591,TraderOne,Tick,111,90,21,-21,147400,147200,1450,2550,6750,OK
12.960789,TraderOne,Tick,111,90,21,-21,147400,147200,1450,2550,6750,OK
13.289195,TraderOne,Tick,121,90,31,-31,146700,147200,1303,4697,-1503,OK
13.46633,TraderOne,Tick,121,90,31,-31,146700,147200,1303,4697,-1503,OK
13.787285,TraderOne,Tick,121,90,31,-31,146700,147200,1303,4697,-1503,OK
13.969215,TraderOne,Tick,121,97,24,-24,146700,147200,1508,2392,-2408,OK
14.239731,TraderOne,Tick,121,97,24,-24,146700,147200,1508,2392,-2408,OK
14.547901,TraderOne,Tick,121,97,24,-24,146700,147200,1508,2392,-2408,OK
14.786108,TraderOne,Tick,121,97,24,-24,146700,147200,1508,2392,-2408,OK
15.042824,TraderOne,Tick,121,97,24,-24,146700,147200,1508,2392,-2408,OK
15.238313,TraderOne,Tick,121,97,24,-24,146700,147200,1508,2392,-2408,OK
15.513217,TraderOne,Tick,121,107,14,-14,146900,146800,1361,539,1939,OK
15.78698,TraderOne,Tick,121,107,14,-14,146900,146800,1361,539,1939,OK
15.970984,TraderOne,Tick,121,117,4,-4,146900,146900,1214,-2314,-2314,OK
16.291854,TraderOne,Tick,121,117,4,-4,146900,146900,1214,-2314,-2314,OK
16.466187,TraderOne,Tick,121,117,4,-4,146900,146900,1214,-2314,-2314,OK
16.737679,TraderOne,Tick,121,117,4,-4,146900,146900,1214,-2314,-2314,OK
16.951723,TraderOne,Tick,121,117,4,-4,146900,146900,1214,-2314,-2314,OK
17.274445,TraderOne,Tick,121,117,4,-4,146900,146900,1214,-2314,-2314,OK
17.520584,TraderOne,Tick,121,117,4,-4,146900,146900,1214,-2314,-2314,OK
17.731473,TraderOne,Tick,131,117,14,-14,146900,146900,1508,-1608,-1608,OK
18.018536,TraderOne,Tick,141,117,24,-24,146600,146900,1802,-902,-5702,OK
18.220797,TraderOne,Tick,141,117,24,-24,146600,146900,1802,-902,-5702,OK
18.483577,TraderOne,Tick,141,117,24,-24,146600,147100,1802,-902,-5702,OK
18.757611,TraderOne,Tick,151,117,34,-34,146900,147100,2096,-196,-6996,OK
19.02127,TraderOne,Tick,151,117,34,-34,146900,147100,2096,-196,-6996,OK
19.212399,TraderOne,Tick,151,117,34,-34,146900,147100,2096,-196,-6996,OK
19.494916,TraderOne,Tick,151,117,34,-34,146900,147200,2096,-196,-6996,OK
19.745759,TraderOne,Tick,151,117,34,-34,146900,147200,2096,-196,-6996,OK
19.952449,TraderOne,Tick,151,117,34,-34,146900,147200,2096,-196,-6996,OK
20.273689,TraderOne,Tick,161,117,44,-44,146900,147200,2390,2510,-6290,OK
20.517827,TraderOne,Tick,171,117,54,-54,146900,147900,2684,7216,-3584,OK
20.762003,TraderOne,Tick,181,127,54,-54,147500,147900,2831,10069,-731,OK
20.974732,TraderOne,Tick,181,133,48,-48,147600,147900,3008,8092,-1508,OK
21.209778,TraderOne,Tick,181,133,48,-48,147600,147900,3008,8092,-1508,OK
21.478124,TraderOne,Tick,181,133,48,-48,147600,147900,3008,8092,-1508,OK
21.794822,TraderOne,Tick,181,133,48,-48,147600,147900,3008,8092,-1508,OK
21.987235,TraderOne,Tick,181,133,48,-48,147600,148000,3008,8092,-1508,OK
22.255962,TraderOne,Tick,181,133,48,-48,147600,148000,3008,8092,-1508,OK
22.518795,TraderOne,Tick,181,133,48,-48,147600,148100,3008,8092,-1508,OK
22.773704,TraderOne,Tick,181,133,48,-48,147600,148100,3008,8092,-1508,OK
23.046515,TraderOne,Tick,181,133,48,-48,147600,148000,3008,8092,-1508,OK
23.255411,TraderOne,Tick,181,133,48,-48,147600,148000,3008,8092,-1508,OK
23.452926,TraderOne,Tick,181,143,38,-38,147400,147700,3303,4797,-2803,OK
23.713886,TraderOne,Tick,181,143,38,-38,147400,147700,3303,4797,-2803,OK
23.977635,TraderOne,Tick,181,143,38,-38,147400,147700,3303,4797,-2803,OK
24.228863,TraderOne,Tick,191,143,48,-48,147400,147700,3598,7502,-2098,OK
24.465389,TraderOne,Tick,191,143,48,-48,147400,147700,3598,7502,-2098,OK
24.70647,TraderOne,Tick,201,143,58,-58,147400,147700,3893,12207,607,OK
25.007622,TraderOne,Tick,201,143,58,-58,147400,148100,3893,12207,607,OK
25.298565,TraderOne,Tick,211,143,68,-68,147700,148200,4188,16912,3312,OK
25.511745,TraderOne,Tick,211,153,58,-58,147600,147900,4483,10617,-983,OK
25.744955,TraderOne,Tick,211,160,51,-51,147600,147900,4380,7220,-2980,OK
25.998507,TraderOne,Tick,211,160,51,-51,147600,147900,4380,7220,-2980,OK
26.297851,TraderOne,Tick,211,160,51,-51,147600,147900,4380,7220,-2980,OK
26.478223,TraderOne,Tick,221,160,61,-61,147400,147900,4233,12367,167,OK
26.781653,TraderOne,Tick,221,160,61,-61,147400,147900,4233,12367,167,OK
26.988198,TraderOne,Tick,221,170,51,-51,147400,147900,4528,6072,-4128,OK
27.201412,TraderOne,Tick,221,170,51,-51,147400,147900,4528,6072,-4128,OK
27.497492,TraderOne,Tick,221,170,51,-51,147400,147900,4528,6072,-4128,OK
27.703408,TraderOne,Tick,221,170,51,-51,147400,147900,4528,6072,-4128,OK
27.993517,TraderOne,Tick,231,180,51,-51,147200,147800,4233,6367,-3833,OK
28.239804,TraderOne,Tick,231,180,51,-51,147200,147800,4233,6367,-3833,OK
28.546369,TraderOne,Tick,231,190,41,-41,147700,147800,4086,1514,-2586,OK
28.708983,TraderOne,Tick,231,190,41,-41,147700,147600,4086,1514,5614,OK
28.997257,TraderOne,Tick,231,190,41,-41,147700,147600,4086,1514,5614,OK
29.291726,TraderOne,Tick,231,190,41,-41,147700,147600,4086,1514,5614,OK
29.479239,TraderOne,Tick,231,190,41,-41,147700,147600,4086,1514,5614,OK
29.719562,TraderOne,Tick,231,190,41,-41,147700,147600,4086,1514,5614,OK
29.972922,TraderOne,Tick,231,200,31,-31,147700,147600,3939,-2339,761,OK
30.254815,TraderOne,Tick,231,200,31,-31,147700,147600,3939,-2339,761,OK
30.456916,TraderOne,Tick,231,200,31,-31,147700,147600,3939,-2339,761,OK
30.799021,TraderOne,Tick,231,200,31,-31,147700,147400,3939,-2339,3861,OK
30.98213,TraderOne,Tick,241,200,41,-41,147000,147400,4233,367,-7833,OK
31.22546,TraderOne,Tick,241,200,41,-41,147000,147400,4233,367,-7833,OK
31.475554,TraderOne,Tick,251,200,51,-51,147000,147400,4527,4073,-6127,OK
31.76575,TraderOne,Tick,251,200,51,-51,147000,147400,4527,4073,-6127,OK
31.978194,TraderOne,Tick,261,200,61,-61,147000,147400,4380,9220,-2980,OK
32.24881,TraderOne,Tick,261,200,61,-61,147000,147400,4380,9220,-2980,OK
32.501958,TraderOne,Tick,261,210,51,-51,147100,147400,4674,2926,-7274,OK
32.703941,TraderOne,Tick,261,210,51,-51,147100,147600,4674,2926,-7274,OK
33.045723,TraderOne,Tick,261,210,51,-51,147100,147600,4674,2926,-7274,OK
33.281844,TraderOne,Tick,261,220,41,-41,146900,147600,4968,-2368,-10568,OK
33.453356,TraderOne,Tick,261,220,41,-41,146900,147600,4968,-2368,-10568,OK
33.780698,TraderOne,Tick,261,230,31,-31,146900,147600,5262,-6662,-12862,OK
33.980561,TraderOne,Tick,261,230,31,-31,146900,147600,5262,-6662,-12862,OK
34.203828,TraderOne,Tick,261,230,31,-31,146900,147200,5262,-6662,-12862,OK
34.542425,TraderOne,Tick,261,230,31,-31,146900,147200,5262,-6662,-12862,OK
34.778051,TraderOne,Tick,261,230,31,-31,146900,147200,5262,-6662,-12862,OK
35.004989,TraderOne,Tick,261,230,31,-31,146900,147200,5262,-6662,-12862,OK
35.208547,TraderOne,Tick,261,230,31,-31,146900,147300,5262,-6662,-12862,OK
35.478283,TraderOne,Tick,261,240,21,-21,147100,147400,5115,-11515,-15715,OK
35.75147,TraderOne,Tick,261,250,11,-11,147200,147000,5409,-12809,-10609,OK
36.015964,TraderOne,Tick,261,250,11,-11,147200,147000,5409,-12809,-10609,OK
36.213035,TraderOne,Tick,261,250,11,-11,147200,147000,5409,-12809,-10609,OK
36.531092,TraderOne,Tick,261,257,4,-4,147200,147000,5615,-13715,-12915,OK
36.748541,TraderOne,Tick,261,257,4,-4,147200,147000,5615,-13715,-12915,OK
37.023602,TraderOne,Tick,261,257,4,-4,147200,147000,5615,-13715,-12915,OK
37.270896,TraderOne,Tick,261,257,4,-4,147200,147000,5615,-13715,-12915,OK
37.518616,TraderOne,Tick,261,257,4,-4,147200,147300,5615,-13715,-14115,OK
37.780737,TraderOne,Tick,261,257,4,-4,147200,147300,5615,-13715,-14115,OK
37.996202,TraderOne,Tick,261,257,4,-4,147200,147300,5615,-13715,-14115,OK
38.245703,TraderOne,Tick,261,257,4,-4,147200,147300,5615,-13715,-14115,OK
38.504769,TraderOne,Tick,261,257,4,-4,147200,147300,5615,-13715,-14115,OK
38.796745,TraderOne,Tick,261,257,4,-4,147200,147300,5615,-13715,-14115,OK
38.981361,TraderOne,Tick,271,257,14,-14,147500,147300,5910,-14010,-11210,OK
39.259322,TraderOne,Tick,281,257,24,-24,147500,147300,5763,-12863,-8063,OK
39.518229,TraderOne,Tick,281,267,14,-14,147700,147300,5616,-14716,-11916,OK
39.789248,TraderOne,Tick,281,267,14,-14,147700,147300,5616,-14716,-11916,OK
39.967911,TraderOne,Tick,281,267,14,-14,147700,147300,5616,-14716,-11916,OK
40.20321,TraderOne,Tick,281,267,14,-14,147700,147300,5616,-14716,-11916,OK
40.453285,TraderOne,Tick,281,277,4,-4,147700,147300,5469,-15569,-14769,OK
40.737602,TraderOne,Tick,281,277,4,-4,147700,147300,5469,-15569,-14769,OK
41.005172,TraderOne,Tick,281,277,4,-4,147700,147300,5469,-15569,-14769,OK
41.206629,TraderOne,Tick,281,277,4,-4,147700,147300,5469,-15569,-14769,OK
41.454545,TraderOne,Tick,281,277,4,-4,147700,147300,5469,-15569,-14769,OK
41.733759,TraderOne,Tick,281,277,4,-4,147700,147300,5469,-15569,-14769,OK
41.991184,TraderOne,Tick,281,277,4,-4,147700,147300,5469,-15569,-14769,OK
42.207786,TraderOne,Tick,281,285,-4,4,147500,147200,5351,-14651,-15451,OK
42.51476,TraderOne,Tick,281,285,-4,4,147500,147200,5351,-14651,-15451,OK
42.725074,TraderOne,Tick,281,285,-4,4,147500,147200,5351,-14651,-15451,OK
43.013142,TraderOne,Tick,281,285,-4,4,147500,147200,5351,-14651,-15451,OK
43.244768,TraderOne,Tick,281,285,-4,4,147500,147200,5351,-14651,-15451,OK
43.527951,TraderOne,Tick,281,285,-4,4,147500,147200,5351,-14651,-15451,OK
43.728722,TraderOne,Tick,281,285,-4,4,147500,147400,5351,-14651,-15051,OK
44.009988,TraderOne,Tick,281,285,-4,4,147500,147400,5351,-14651,-15051,OK
44.223882,TraderOne,Tick,281,285,-4,4,147500,147400,5351,-14651,-15051,OK
44.494132,TraderOne,Tick,281,285,-4,4,147500,147400,5351,-14651,-15051,OK
44.74836,TraderOne,Tick,281,285,-4,4,147500,147400,5351,-14651,-15051,OK
45.009054,TraderOne,Tick,281,285,-4,4,147700,147400,5351,-14651,-15451,OK
45.277763,TraderOne,Tick,281,285,-4,4,147700,147500,5351,-14651,-15451,OK
45.517475,TraderOne,Tick,281,285,-4,4,147700,147500,5351,-14651,-15451,OK
45.759746,TraderOne,Tick,281,295,-14,14,147400,147500,5646,-14946,-13546,OK
45.971641,TraderOne,Tick,281,295,-14,14,147400,147500,5646,-14946,-13546,OK
46.293302,TraderOne,Tick,281,295,-14,14,147400,147500,5646,-14946,-13546,OK
46.513224,TraderOne,Tick,281,295,-14,14,147400,147500,5646,-14946,-13546,OK
46.701731,TraderOne,Tick,281,295,-14,14,147400,147500,5646,-14946,-13546,OK
46.989928,TraderOne,Tick,281,295,-14,14,147400,147500,5646,-14946,-13546,OK
47.208423,TraderOne,Tick,281,295,-14,14,147400,147500,5646,-14946,-13546,OK
47.491528,TraderOne,Tick,281,295,-14,14,147400,147500,5646,-14946,-13546,OK
47.760327,TraderOne,Tick,281,305,-24,24,147700,147500,5498,-12798,-17598,OK
47.978789,TraderOne,Tick,281,305,-24,24,147700,147500,5498,-12798,-17598,OK
48.298962,TraderOne,Tick,284,305,-21,21,147400,147500,5454,-13954,-11854,OK
48.455767,TraderOne,Tick,284,305,-21,21,147400,147500,5454,-13954,-11854,OK
48.746243,TraderOne,Tick,284,305,-21,21,147400,147500,5454,-13954,-11854,OK
48.982302,TraderOne,Tick,284,305,-21,21,147400,147500,5454,-13954,-11854,OK
49.222205,TraderOne,Tick,284,305,-21,21,147400,147500,5454,-13954,-11854,OK
49.509687,TraderOne,Tick,294,305,-11,11,147700,147500,5749,-17249,-19449,OK
49.772613,TraderOne,Tick,294,305,-11,11,147700,147500,5749,-17249,-19449,OK
49.98903,TraderOne,Tick,294,305,-11,11,147700,147500,5749,-17249,-19449,OK
50.248269,TraderOne,Tick,294,305,-11,11,147700,147500,5749,-17249,-19449,OK
50.471082,TraderOne,Tick,294,305,-11,11,147700,147500,5749,-17249,-19449,OK
50.739481,TraderOne,Tick,294,305,-11,11,147700,147500,5749,-17249,-19449,OK
51.024005,TraderOne,Tick,294,305,-11,11,147700,147500,5749,-17249,-19449,OK
51.238567,TraderOne,Tick,294,305,-11,11,147700,147500,5749,-17249,-19449,OK
51.460193,TraderOne,Tick,294,305,-11,11,147700,147500,5749,-17249,-19449,OK
51.737971,TraderOne,Tick,294,305,-11,11,147700,147500,5749,-17249,-19449,OK
51.95366,TraderOne,Tick,294,305,-11,11,147700,147300,5749,-17249,-19449,OK
52.214851,TraderOne,Tick,294,305,-11,11,147700,147300,5749,-17249,-19449,OK
52.527494,TraderOne,Tick,294,305,-11,11,147700,147300,5749,-17249,-19449,OK
52.784015,TraderOne,Tick,294,305,-11,11,147700,147300,5749,-17249,-19449,OK
53.030931,TraderOne,Tick,294,305,-11,11,147700,147300,5749,-17249,-19449,OK
53.290585,TraderOne,Tick,294,305,-11,11,147700,147300,5749,-17249,-19449,OK
53.513351,TraderOne,Tick,294,305,-11,11,147700,147300,5749,-17249,-19449,OK
53.778439,TraderOne,Tick,294,305,-11,11,147700,147300,5749,-17249,-19449,OK
54.027936,TraderOne,Tick,294,305,-11,11,147800,147300,5749,-17249,-19449,OK
54.238392,TraderOne,Tick,294,305,-11,11,147800,147300,5749,-17249,-19449,OK
54.516556,TraderOne,Tick,294,305,-11,11,147800,147200,5749,-17249,-19449,OK
54.711671,TraderOne,Tick,294,305,-11,11,147800,147200,5749,-17249,-19449,OK
54.991672,TraderOne,Tick,294,305,-11,11,147800,147200,5749,-17249,-19449,OK
55.215051,TraderOne,Tick,294,305,-11,11,147800,147300,5749,-17249,-19449,OK
55.516289,TraderOne,Tick,294,305,-11,11,147300,146900,5749,-17249,-19449,OK
55.75444,TraderOne,Tick,304,305,-1,1,147300,146900,5602,-21102,-21302,OK
56.038785,TraderOne,Tick,304,314,-10,10,147300,147100,5867,-19567,-21567,OK
56.251486,TraderOne,Tick,304,314,-10,10,147300,147100,5867,-19567,-21567,OK
56.52074,TraderOne,Tick,304,314,-10,10,147300,147100,5867,-19567,-21567,OK
56.712693,TraderOne,Tick,304,314,-10,10,147300,147100,5867,-19567,-21567,OK
56.964871,TraderOne,Tick,304,324,-20,20,147100,147100,6161,-17861,-17861,OK
57.277029,TraderOne,Tick,304,332,-28,28,147100,147100,6396,-16496,-16496,OK
57.500734,TraderOne,Tick,304,332,-28,28,147100,146800,6396,-16496,-22096,OK
57.714865,TraderOne,Tick,304,342,-38,38,147000,146700,6690,-13790,-21390,OK
58.042872,TraderOne,Tick,304,342,-38,38,147000,146600,6690,-13790,-21390,OK
58.275845,TraderOne,Tick,304,342,-38,38,147000,146700,6690,-13790,-21390,OK
58.51634,TraderOne,Tick,304,342,-38,38,147000,146700,6690,-13790,-21390,OK
58.728883,TraderOne,Tick,304,342,-38,38,147000,146700,6690,-13790,-21390,OK
59.046962,TraderOne,Tick,304,342,-38,38,147000,146700,6690,-13790,-21390,OK
59.283338,TraderOne,Tick,304,349,-45,45,147000,146700,6896,-11196,-20196,OK
59.505392,TraderOne,Tick,304,349,-45,45,147000,146500,6896,-11196,-20196,OK
59.707276,TraderOne,Tick,304,349,-45,45,147000,146500,6896,-11196,-20196,OK
60.020103,TraderOne,Tick,304,349,-45,45,147000,146500,6896,-11196,-20196,OK
60.244975,TraderOne,Tick,304,349,-45,45,147000,146700,6896,-11196,-20196,OK
60.454597,TraderOne,Tick,304,349,-45,45,147000,146700,6896,-11196,-20196,OK
60.736814,TraderOne,Tick,304,349,-45,45,147000,146600,6896,-11196,-20196,OK
60.974661,TraderOne,Tick,304,349,-45,45,147000,146500,6896,-11196,-20196,OK
61.248715,TraderOne,Tick,304,349,-45,45,147000,146500,6896,-11196,-20196,OK
61.510915,TraderOne,Tick,304,349,-45,45,147000,146500,6896,-11196,-20196,OK
61.764637,TraderOne,Tick,304,349,-45,45,147000,146500,6896,-11196,-20196,OK
62.015715,TraderOne,Tick,304,349,-45,45,147000,146500,6896,-11196,-20196,OK
62.223557,TraderOne,Tick,304,349,-45,45,147000,146500,6896,-11196,-20196,OK
62.544301,TraderOne,Tick,304,359,-55,55,146700,146300,7190,-5490,-16490,OK
62.712127,TraderOne,Tick,314,359,-45,45,146800,146300,7484,-11784,-20784,OK
62.953781,TraderOne,Tick,324,359,-35,35,146800,146300,7337,-17637,-24637,OK
63.218802,TraderOne,Tick,324,359,-35,35,146800,146300,7337,-17637,-24637,OK
63.454258,TraderOne,Tick,324,359,-35,35,146800,146300,7337,-17637,-24637,OK
63.713103,TraderOne,Tick,324,359,-35,35,146800,146300,7337,-17637,-24637,OK
64.010654,TraderOne,Tick,324,359,-35,35,146800,146300,7337,-17637,-24637,OK
64.296455,TraderOne,Tick,334,359,-25,25,146700,146300,7631,-20931,-25931,OK
64.49855,TraderOne,Tick,334,359,-25,25,146700,146300,7631,-20931,-25931,OK
64.732677,TraderOne,Tick,334,359,-25,25,146700,146300,7631,-20931,-25931,OK
65.017383,TraderOne,Tick,334,359,-25,25,146700,146300,7631,-20931,-25931,OK
65.245178,TraderOne,Tick,334,359,-25,25,146700,146900,7631,-20931,-15931,OK
65.528158,TraderOne,Tick,334,359,-25,25,146700,146900,7631,-20931,-15931,OK
65.71774,TraderOne,Tick,334,359,-25,25,146700,146900,7631,-20931,-15931,OK
65.991489,TraderOne,Tick,344,359,-15,15,146600,146900,7484,-23784,-20784,OK
66.257157,TraderOne,Tick,344,359,-15,15,146600,146900,7484,-23784,-20784,OK
66.466751,TraderOne,Tick,344,369,-25,25,147300,146900,7337,-20637,-25637,OK
66.730835,TraderOne,Tick,344,369,-25,25,147300,146900,7337,-20637,-25637,OK
67.003964,TraderOne,Tick,354,369,-15,15,146500,146900,7190,-23490,-20490,OK
67.207044,TraderOne,Tick,354,369,-15,15,146500,146900,7190,-23490,-20490,OK
67.471459,TraderOne,Tick,354,369,-15,15,146500,146900,7190,-23490,-20490,OK
67.733661,TraderOne,Tick,364,369,-5,5,146900,146900,7484,-25784,-25784,OK
67.951821,TraderOne,Tick,364,369,-5,5,146900,146900,7484,-25784,-25784,OK
68.273037,TraderOne,Tick,364,379,-15,15,146900,146900,7337,-25637,-25637,OK
68.473002,TraderOne,Tick,374,389,-15,15,146500,146900,7484,-24784,-21784,OK
68.718786,TraderOne,Tick,374,389,-15,15,146500,147200,7484,-24784,-21784,OK
68.982571,TraderOne,Tick,374,389,-15,15,146500,147200,7484,-24784,-21784,OK
69.236667,TraderOne,Tick,374,399,-25,25,147500,147200,7337,-22637,-27637,OK
69.52471,TraderOne,Tick,374,399,-25,25,147500,147200,7337,-22637,-27637,OK
69.717956,TraderOne,Tick,374,399,-25,25,147500,147300,7337,-22637,-27637,OK
69.967159,TraderOne,Tick,374,399,-25,25,147500,147300,7337,-22637,-27637,OK
70.221028,TraderOne,Tick,374,399,-25,25,147500,147300,7337,-22637,-27637,OK
70.505573,TraderOne,Tick,374,399,-25,25,147500,147300,7337,-22637,-27637,OK
70.780737,TraderOne,Tick,384,399,-15,15,146500,147300,7190,-25490,-22490,OK
70.952821,TraderOne,Tick,384,399,-15,15,146500,147300,7190,-25490,-22490,OK
71.290072,TraderOne,Tick,384,399,-15,15,146500,147300,7190,-25490,-22490,OK
71.455047,TraderOne,Tick,384,399,-15,15,146500,147300,7190,-25490,-22490,OK
71.77822,TraderOne,Tick,384,399,-15,15,146500,147300,7190,-25490,-22490,OK
71.963547,TraderOne,Tick,384,399,-15,15,146500,147300,7190,-25490,-22490,OK
72.202316,TraderOne,Tick,384,399,-15,15,146500,147300,7190,-25490,-22490,OK
72.470922,TraderOne,Tick,384,409,-25,25,147500,147300,7042,-24342,-29342,OK
72.794528,TraderOne,Tick,384,409,-25,25,147500,147300,7042,-24342,-29342,OK
72.969833,TraderOne,Tick,384,409,-25,25,147600,147300,7042,-24342,-29342,OK
73.215758,TraderOne,Tick,384,409,-25,25,147600,147300,7042,-24342,-29342,OK
73.52622,TraderOne,Tick,384,409,-25,25,147600,147200,7042,-24342,-29342,OK
73.757934,TraderOne,Tick,394,409,-15,15,147600,147200,7337,-27637,-30637,OK
74.021589,TraderOne,Tick,394,409,-15,15,147600,147200,7337,-27637,-30637,OK
74.223528,TraderOne,Tick,404,409,-5,5,147600,147200,7632,-29932,-30932,OK
74.500925,TraderOne,Tick,404,409,-5,5,147600,147200,7632,-29932,-30932,OK
74.777685,TraderOne,Tick,404,419,-15,15,147500,147200,7927,-29227,-32227,OK
75.036844,TraderOne,Tick,404,419,-15,15,147500,147200,7927,-29227,-32227,OK
75.257913,TraderOne,Tick,404,419,-15,15,147500,147400,7927,-29227,-30727,OK
75.518223,TraderOne,Tick,404,419,-15,15,147500,147400,7927,-29227,-30727,OK
75.774146,TraderOne,Tick,404,419,-15,15,147500,147400,7927,-29227,-30727,OK
76.014296,TraderOne,Tick,404,419,-15,15,147500,147400,7927,-29227,-30727,OK
76.21297,TraderOne,Tick,404,419,-15,15,147500,147400,7927,-29227,-30727,OK
76.490911,TraderOne,Tick,404,419,-15,15,147500,147500,7927,-29227,-29227,OK
76.781067,TraderOne,Tick,414,419,-5,5,147600,147600,8222,-30522,-30522,OK
77.007771,TraderOne,Tick,414,419,-5,5,147600,147600,8222,-30522,-30522,OK
77.29765,TraderOne,Tick,414,429,-15,15,147500,147600,8517,-29817,-28317,OK
77.534449,TraderOne,Tick,414,429,-15,15,147500,147600,8517,-29817,-28317,OK
77.712877,TraderOne,Tick,424,429,-5,5,147400,147600,8370,-31670,-30670,OK
77.961754,TraderOne,Tick,424,429,-5,5,147400,147600,8370,-31670,-30670,OK
78.242175,TraderOne,Tick,424,429,-5,5,147400,147600,8370,-31670,-30670,OK
78.534377,TraderOne,Tick,424,429,-5,5,147400,147600,8370,-31670,-30670,OK
78.749963,TraderOne,Tick,424,429,-5,5,147400,147600,8370,-31670,-30670,OK
78.992552,TraderOne,Tick,434,429,5,-5,147400,147600,8665,-32965,-33965,OK
79.289625,TraderOne,Tick,444,429,15,-15,147400,147600,8960,-31260,-34260,OK
79.469625,TraderOne,Tick,446,429,17,-17,147400,147600,9019,-30919,-34319,OK
79.773176,TraderOne,Tick,456,429,27,-27,147600,148500,9314,-29214,-34614,OK
79.95489,TraderOne,Tick,466,429,37,-37,147900,148400,9609,-23109,-30509,OK
80.21358,TraderOne,Tick,476,429,47,-47,147900,148400,9905,-20405,-29805,OK
80.465084,TraderOne,Tick,476,429,47,-47,147900,148400,9905,-20405,-29805,OK
80.756471,TraderOne,Tick,476,429,47,-47,147900,148400,9905,-20405,-29805,OK
81.045263,TraderOne,Tick,486,429,57,-57,147900,148400,10201,-16701,-28101,OK
81.290198,TraderOne,Tick,486,429,57,-57,147900,148200,10201,-16701,-28101,OK
81.45421,TraderOne,Tick,486,429,57,-57,147900,148400,10201,-16701,-28101,OK
81.775943,TraderOne,Tick,496,429,67,-67,148000,148400,10497,-10997,-24397,OK
82.020264,TraderOne,Tick,496,429,67,-67,148000,148400,10497,-10997,-24397,OK
82.213314,TraderOne,Tick,496,429,67,-67,148000,148400,10497,-10997,-24397,OK
82.49522,TraderOne,Tick,496,439,57,-57,148200,148800,10349,-17849,-29249,OK
82.73712,TraderOne,Tick,496,439,57,-57,148200,148800,10349,-17849,-29249,OK
82.984079,TraderOne,Tick,496,439,57,-57,148200,148800,10349,-17849,-29249,OK
83.267376,TraderOne,Tick,496,439,57,-57,148300,148800,10349,-17849,-29249,OK
83.510994,TraderOne,Tick,496,439,57,-57,148300,148800,10349,-17849,-29249,OK
83.725725,TraderOne,Tick,496,439,57,-57,148300,148800,10349,-17849,-29249,OK
83.988339,TraderOne,Tick,496,439,57,-57,148400,149000,10349,-17849,-29249,OK
84.272812,TraderOne,Tick,506,439,67,-67,148500,149000,10646,-13146,-26546,OK
84.486353,TraderOne,Tick,506,439,67,-67,148500,149000,10646,-13146,-26546,OK
84.711443,TraderOne,Tick,506,439,67,-67,148500,149200,10646,-13146,-26546,OK
84.966053,TraderOne,Tick,512,449,63,-63,148600,149200,10675,-16575,-29175,OK
85.299854,TraderOne,Tick,512,459,53,-53,148600,149200,10972,-22872,-33472,OK
85.496247,TraderOne,Tick,512,469,43,-43,148800,149200,10823,-27723,-36323,OK
85.735456,TraderOne,Tick,512,469,43,-43,148800,149200,10823,-27723,-36323,OK
86.006101,TraderOne,Tick,522,469,53,-53,148800,149600,11121,-23021,-33621,OK
86.255707,TraderOne,Tick,522,479,43,-43,149000,149600,10972,-29872,-38472,OK
86.515364,TraderOne,Tick,522,479,43,-43,149000,149600,10972,-29872,-38472,OK
86.791959,TraderOne,Tick,522,489,33,-33,149600,149600,10823,-32723,-32723,OK
87.003915,TraderOne,Tick,522,489,33,-33,149600,149600,10823,-32723,-32723,OK
87.238732,TraderOne,Tick,522,489,33,-33,149600,149600,10823,-32723,-32723,OK
87.537528,TraderOne,Tick,522,489,33,-33,149600,149700,10823,-32723,-36023,OK
87.759865,TraderOne,Tick,522,489,33,-33,149600,149600,10823,-32723,-32723,OK
88.026153,TraderOne,Tick,522,489,33,-33,149600,149500,10823,-32723,-29423,OK
88.285675,TraderOne,Tick,522,489,33,-33,149600,149500,10823,-32723,-29423,OK
88.524889,TraderOne,Tick,522,489,33,-33,149600,149200,10823,-32723,-26123,OK
88.791939,TraderOne,Tick,522,489,33,-33,149600,149200,10823,-32723,-26123,OK
88.964279,TraderOne,Tick,522,489,33,-33,149600,149100,10823,-32723,-26123,OK
89.22408,TraderOne,Tick,522,489,33,-33,149600,149100,10823,-32723,-26123,OK
89.548045,TraderOne,Tick,522,489,33,-33,149600,148900,10823,-32723,-26123,OK
89.707078,TraderOne,Tick,522,489,33,-33,149600,148900,10823,-32723,-26123,OK
90.023955,TraderOne,Tick,522,489,33,-33,149600,148900,10823,-32723,-26123,OK
90.248994,TraderOne,Tick,522,489,33,-33,149600,148900,10823,-32723,-26123,OK
90.506425,TraderOne,Tick,522,489,33,-33,149600,149100,10823,-32723,-26123,OK
90.72878,TraderOne,Tick,522,489,33,-33,149600,149100,10823,-32723,-26123,OK
91.031869,TraderOne,Tick,522,499,23,-23,148800,149100,10674,-35574,-40174,OK
91.260909,TraderOne,Tick,522,509,13,-13,149400,149100,10973,-32873,-30273,OK
91.4936,TraderOne,Tick,522,514,8,-8,149400,148900,11122,-31022,-29422,OK
91.72821,TraderOne,Tick,522,519,3,-3,148900,148900,11048,-31948,-31948,OK
91.956852,TraderOne,Tick,522,523,-1,1,149500,148900,11168,-30468,-30668,OK
92.266651,TraderOne,Tick,532,523,9,-9,148500,148900,11019,-31319,-33119,OK
92.528365,TraderOne,Tick,532,523,9,-9,148500,148900,11019,-31319,-33119,OK
92.742417,TraderOne,Tick,532,523,9,-9,148500,148900,11019,-31319,-33119,OK
92.957261,TraderOne,Tick,532,523,9,-9,148500,148900,11019,-31319,-33119,OK
93.261821,TraderOne,Tick,532,523,9,-9,148500,149200,11019,-31319,-33119,OK
93.487587,TraderOne,Tick,532,523,9,-9,148500,149200,11019,-31319,-33119,OK
93.744232,TraderOne,Tick,532,523,9,-9,148500,149200,11019,-31319,-33119,OK
93.983564,TraderOne,Tick,532,523,9,-9,148500,149200,11019,-31319,-33119,OK
94.246115,TraderOne,Tick,532,523,9,-9,148500,149200,11019,-31319,-33119,OK
94.529875,TraderOne,Tick,532,523,9,-9,148500,149200,11019,-31319,-33119,OK
94.704344,TraderOne,Tick,532,523,9,-9,148500,149200,11019,-31319,-33119,OK
94.985677,TraderOne,Tick,532,523,9,-9,148500,149200,11019,-31319,-33119,OK
95.241195,TraderOne,Tick,532,523,9,-9,148500,149200,11019,-31319,-33119,OK
95.452717,TraderOne,Tick,538,523,15,-15,149600,149200,11199,-31499,-28499,OK
95.742477,TraderOne,Tick,538,523,15,-15,149600,149200,11199,-31499,-28499,OK
96.048623,TraderOne,Tick,538,523,15,-15,149600,149200,11199,-31499,-28499,OK
96.293488,TraderOne,Tick,538,523,15,-15,149600,149200,11199,-31499,-28499,OK
96.512938,TraderOne,Tick,538,523,15,-15,149600,149200,11199,-31499,-28499,OK
96.719255,TraderOne,Tick,538,523,15,-15,149600,149200,11199,-31499,-28499,OK
96.990247,TraderOne,Tick,538,523,15,-15,149600,149200,11199,-31499,-28499,OK
97.269874,TraderOne,Tick,538,523,15,-15,149600,149200,11199,-31499,-28499,OK
97.502036,TraderOne,Tick,548,533,15,-15,149800,149600,10899,-31199,-28199,OK
97.760666,TraderOne,Tick,548,533,15,-15,149800,149800,10899,-31199,-31199,OK
98.006415,TraderOne,Tick,548,533,15,-15,149800,149800,10899,-31199,-31199,OK
98.269382,TraderOne,Tick,548,533,15,-15,149800,149800,10899,-31199,-31199,OK
98.504385,TraderOne,Tick,558,533,25,-25,149800,149800,10749,-30049,-30049,OK
98.736465,TraderOne,Tick,558,533,25,-25,149800,149800,10749,-30049,-30049,OK
98.952508,TraderOne,Tick,558,533,25,-25,149800,149800,10749,-30049,-30049,OK
99.261164,TraderOne,Tick,558,533,25,-25,149800,150100,10749,-30049,-37549,OK
99.541148,TraderOne,Tick,568,533,35,-35,149800,150000,11049,-28349,-35349,OK
99.730207,TraderOne,Tick,568,533,35,-35,149800,150000,11049,-28349,-35349,OK
99.996564,TraderOne,Tick,568,533,35,-35,149800,150000,11049,-28349,-35349,OK
100.283586,TraderOne,Tick,568,543,25,-25,149900,149900,10899,-31199,-31199,OK
100.536886,TraderOne,Tick,568,543,25,-25,149900,149900,10899,-31199,-31199,OK
100.766279,TraderOne,Tick,568,543,25,-25,149900,149900,10899,-31199,-31199,OK
101.00896,TraderOne,Tick,568,543,25,-25,149900,149900,10899,-31199,-31199,OK
101.269521,TraderOne,Tick,578,543,35,-35,149400,149900,10749,-29049,-39549,OK
101.509369,TraderOne,Tick,578,543,35,-35,149400,150100,10749,-29049,-39549,OK
101.738174,TraderOne,Tick,578,543,35,-35,149400,150100,10749,-29049,-39549,OK
101.985349,TraderOne,Tick,578,543,35,-35,149400,150100,10749,-29049,-39549,OK
102.248545,TraderOne,Tick,578,543,35,-35,149400,150100,10749,-29049,-39549,OK
102.467074,TraderOne,Tick,578,543,35,-35,149400,150100,10749,-29049,-39549,OK
102.747806,TraderOne,Tick,588,543,45,-45,149900,150300,11049,-26349,-39849,OK
103.026672,TraderOne,Tick,588,543,45,-45,149900,150300,11049,-26349,-39849,OK
103.225022,TraderOne,Tick,588,543,45,-45,149900,150300,11049,-26349,-39849,OK
103.545033,TraderOne,Tick,592,553,39,-39,149900,150300,10839,-29139,-40839,OK
103.707514,TraderOne,Tick,592,555,37,-37,150100,150300,10899,-29799,-37199,OK
103.954806,TraderOne,Tick,592,555,37,-37,150100,150400,10899,-29799,-40899,OK
104.264713,TraderOne,Tick,592,555,37,-37,150100,150200,10899,-29799,-33499,OK
104.470959,TraderOne,Tick,592,555,37,-37,150100,150200,10899,-29799,-33499,OK
104.777646,TraderOne,Tick,592,555,37,-37,150100,150200,10899,-29799,-33499,OK
105.038841,TraderOne,Tick,592,555,37,-37,150100,150200,10899,-29799,-33499,OK
105.269467,TraderOne,Tick,592,555,37,-37,150100,150200,10899,-29799,-33499,OK
105.492785,TraderOne,Tick,592,555,37,-37,150100,150200,10899,-29799,-33499,OK
105.713062,TraderOne,Tick,592,555,37,-37,150100,150200,10899,-29799,-33499,OK
106.047123,TraderOne,Tick,592,555,37,-37,150100,150300,10899,-29799,-37199,OK
106.249711,TraderOne,Tick,592,555,37,-37,150100,150500,10899,-29799,-40899,OK
106.474564,TraderOne,Tick,602,555,47,-47,150200,150500,10749,-26649,-40749,OK
106.722978,TraderOne,Tick,602,555,47,-47,150200,150400,10749,-26649,-36049,OK
106.997903,TraderOne,Tick,602,555,47,-47,150200,150300,10749,-26649,-31349,OK
107.223406,TraderOne,Tick,602,555,47,-47,150200,150300,10749,-26649,-31349,OK
107.495806,TraderOne,Tick,602,555,47,-47,150200,150400,10749,-26649,-36049,OK
107.727009,TraderOne,Tick,602,555,47,-47,150200,150400,10749,-26649,-36049,OK
107.969639,TraderOne,Tick,602,555,47,-47,150200,150400,10749,-26649,-36049,OK
108.223762,TraderOne,Tick,602,555,47,-47,150200,150300,10749,-26649,-31349,OK
108.549522,TraderOne,Tick,602,555,47,-47,150200,150100,10749,-26649,-21949,OK
108.778138,TraderOne,Tick,612,565,47,-47,149600,150100,10899,-27799,-41899,OK
109.006476,TraderOne,Tick,612,565,47,-47,149600,150100,10899,-27799,-41899,OK
109.230045,TraderOne,Tick,612,565,47,-47,149600,150100,10899,-27799,-41899,OK
109.523813,TraderOne,Tick,612,575,37,-37,149800,150100,10749,-31649,-42749,OK
109.778252,TraderOne,Tick,612,585,27,-27,150100,150100,11049,-32949,-32949,OK
109.979845,TraderOne,Tick,612,595,17,-17,150100,150100,11349,-33249,-33249,OK
110.267548,TraderOne,Tick,612,605,7,-7,150200,150500,11649,-35549,-37649,OK
110.498582,TraderOne,Tick,622,605,17,-17,150200,150500,11949,-33849,-38949,OK
110.708471,TraderOne,Tick,632,605,27,-27,150200,150700,12249,-31149,-39249,OK
110.978382,TraderOne,Tick,642,605,37,-37,150200,150600,12549,-27449,-38549,OK
111.246666,TraderOne,Tick,652,605,47,-47,150200,150600,12849,-23749,-37849,OK
111.46897,TraderOne,Tick,652,606,46,-46,150200,150600,12834,-24134,-37934,OK
111.751866,TraderOne,Tick,652,606,46,-46,150100,150600,12834,-24134,-37934,OK
112.025068,TraderOne,Tick,652,606,46,-46,150100,150600,12834,-24134,-37934,OK
112.24525,TraderOne,Tick,652,606,46,-46,150100,150500,12834,-24134,-37934,OK
112.472383,TraderOne,Tick,652,616,36,-36,150100,150400,13134,-28434,-39234,OK
112.749618,TraderOne,Tick,652,616,36,-36,150100,150500,13134,-28434,-39234,OK
112.974692,TraderOne,Tick,652,616,36,-36,150100,150700,13134,-28434,-39234,OK
113.213801,TraderOne,Tick,652,616,36,-36,150100,150600,13134,-28434,-39234,OK
113.525227,TraderOne,Tick,652,616,36,-36,150100,150500,13134,-28434,-39234,OK
113.733323,TraderOne,Tick,652,616,36,-36,150100,150500,13134,-28434,-39234,OK
114.007138,TraderOne,Tick,652,616,36,-36,150100,150500,13134,-28434,-39234,OK
114.280917,TraderOne,Tick,652,616,36,-36,150500,150600,13134,-28434,-32034,OK
114.494638,TraderOne,Tick,652,616,36,-36,150500,150500,13134,-28434,-28434,OK
114.703062,TraderOne,Tick,652,616,36,-36,150500,150500,13134,-28434,-28434,OK
115.003537,TraderOne,Tick,652,616,36,-36,150500,150900,13134,-28434,-39234,OK
115.260522,TraderOne,Tick,662,616,46,-46,150200,150500,12984,-29284,-43084,OK
115.546635,TraderOne,Tick,662,625,37,-37,150100,150500,13254,-32754,-43854,OK
115.774366,TraderOne,Tick,662,625,37,-37,150100,150500,13254,-32754,-43854,OK
115.992685,TraderOne,Tick,662,625,37,-37,150100,150400,13254,-32754,-43854,OK
116.200928,TraderOne,Tick,662,635,27,-27,150600,150500,13104,-35604,-32904,OK
116.467584,TraderOne,Tick,662,635,27,-27,150600,150800,13104,-35604,-41004,OK
116.731771,TraderOne,Tick,662,635,27,-27,150600,150800,13104,-35604,-41004,OK
117.011674,TraderOne,Tick,672,635,37,-37,150000,150500,12954,-34454,-45554,OK
117.200429,TraderOne,Tick,672,635,37,-37,150000,150500,12954,-34454,-45554,OK
117.478331,TraderOne,Tick,672,635,37,-37,150000,150300,12954,-34454,-45554,OK
117.728652,TraderOne,Tick,672,635,37,-37,150000,150300,12954,-34454,-45554,OK
118.027089,TraderOne,Tick,672,635,37,-37,150000,150300,12954,-34454,-45554,OK
118.250372,TraderOne,Tick,672,635,37,-37,150000,150300,12954,-34454,-45554,OK
118.476874,TraderOne,Tick,672,645,27,-27,150200,150500,12804,-37304,-45404,OK
118.768264,TraderOne,Tick,672,652,20,-20,150500,150400,13015,-37515,-35515,OK
118.954384,TraderOne,Tick,672,652,20,-20,150500,150300,13015,-37515,-33515,OK
119.215839,TraderOne,Tick,672,652,20,-20,150500,150300,13015,-37515,-33515,OK
119.515522,TraderOne,Tick,672,652,20,-20,150500,150300,13015,-37515,-33515,OK
119.766535,TraderOne,Tick,672,653,19,-19,150100,150100,13000,-37700,-37700,OK
120.023908,TraderOne,Tick,672,653,19,-19,150100,150100,13000,-37700,-37700,OK
120.268738,TraderOne,Tick,672,662,10,-10,150200,150600,12865,-43865,-46865,OK
120.475132,TraderOne,Tick,682,662,20,-20,150200,150600,13165,-41165,-47165,OK
120.713712,TraderOne,Tick,688,662,26,-26,150200,150600,13345,-39545,-47345,OK
121.005501,TraderOne,Tick,688,662,26,-26,150200,150600,13345,-39545,-47345,OK
121.221196,TraderOne,Tick,698,662,36,-36,150000,150600,13195,-37395,-48195,OK
121.515675,TraderOne,Tick,698,662,36,-36,150000,150600,13195,-37395,-48195,OK
121.783438,TraderOne,Tick,698,662,36,-36,150000,150600,13195,-37395,-48195,OK
122.003923,TraderOne,Tick,698,662,36,-36,150000,150600,13195,-37395,-48195,OK
122.235786,TraderOne,Tick,708,662,46,-46,150100,150600,13045,-35245,-49045,OK
122.454485,TraderOne,Tick,708,662,46,-46,150100,150500,13045,-35245,-49045,OK
122.777996,TraderOne,Tick,708,662,46,-46,150100,150500,13045,-35245,-49045,OK
122.966399,TraderOne,Tick,708,662,46,-46,150100,150500,13045,-35245,-49045,OK
123.284577,TraderOne,Tick,708,662,46,-46,150100,150400,13045,-35245,-49045,OK
123.49944,TraderOne,Tick,708,662,46,-46,150100,150400,13045,-35245,-49045,OK
123.721225,TraderOne,Tick,708,672,36,-36,150400,150400,12895,-39095,-39095,OK
124.002562,TraderOne,Tick,708,682,26,-26,150400,150400,12745,-41945,-41945,OK
124.286131,TraderOne,Tick,708,692,16,-16,150600,150400,13046,-43246,-40046,OK
124.52787,TraderOne,Tick,708,702,6,-6,150400,150400,13347,-44547,-44547,OK
124.701903,TraderOne,Tick,708,702,6,-6,150400,150400,13347,-44547,-44547,OK
125.029186,TraderOne,Tick,708,702,6,-6,150400,150400,13347,-44547,-44547,OK
125.277348,TraderOne,Tick,708,702,6,-6,150400,150400,13347,-44547,-44547,OK
125.464263,TraderOne,Tick,708,702,6,-6,150400,150400,13347,-44547,-44547,OK
125.787245,TraderOne,Tick,708,702,6,-6,150400,150400,13347,-44547,-44547,OK
125.990165,TraderOne,Tick,718,702,16,-16,150500,150700,13648,-43848,-47048,OK
126.259647,TraderOne,Tick,728,702,26,-26,150500,151100,13949,-43149,-50949,OK
126.54811,TraderOne,Tick,738,702,36,-36,150500,151200,14250,-37450,-48250,OK
126.717434,TraderOne,Tick,748,702,46,-46,150600,151000,14551,-33751,-47551,OK
127.01468,TraderOne,Tick,748,702,46,-46,150600,151000,14551,-33751,-47551,OK
127.249748,TraderOne,Tick,748,702,46,-46,150600,151000,14551,-33751,-47551,OK
127.529792,TraderOne,Tick,748,702,46,-46,150600,150700,14551,-33751,-38351,OK
127.795744,TraderOne,Tick,748,712,36,-36,150400,150400,14852,-36052,-36052,OK
127.981833,TraderOne,Tick,748,712,36,-36,150700,150300,14852,-36052,-25252,OK
128.286953,TraderOne,Tick,748,712,36,-36,150700,150300,14852,-36052,-25252,OK
128.546044,TraderOne,Tick,748,712,36,-36,150700,150200,14852,-36052,-25252,OK
128.794208,TraderOne,Tick,748,712,36,-36,150700,150200,14852,-36052,-25252,OK
128.959406,TraderOne,Tick,748,712,36,-36,150700,150200,14852,-36052,-25252,OK
129.258676,TraderOne,Tick,748,712,36,-36,150700,150200,14852,-36052,-25252,OK
129.495615,TraderOne,Tick,748,722,26,-26,151000,150400,14702,-38902,-31102,OK
129.711145,TraderOne,Tick,748,722,26,-26,151000,150400,14702,-38902,-31102,OK
130.033421,TraderOne,Tick,748,722,26,-26,151000,150400,14702,-38902,-31102,OK
130.212685,TraderOne,Tick,748,722,26,-26,151000,150400,14702,-38902,-31102,OK
130.519922,TraderOne,Tick,748,722,26,-26,151000,150400,14702,-38902,-31102,OK
130.712188,TraderOne,Tick,748,722,26,-26,151000,150400,14702,-38902,-31102,OK
130.993185,TraderOne,Tick,748,722,26,-26,151000,150400,14702,-38902,-31102,OK
131.215667,TraderOne,Tick,758,722,36,-36,149800,150100,14552,-37752,-48552,OK
131.528337,TraderOne,Tick,758,722,36,-36,149800,150100,14552,-37752,-48552,OK
131.780214,TraderOne,Tick,758,722,36,-36,149800,150100,14552,-37752,-48552,OK
132.007183,TraderOne,Tick,758,732,26,-26,150800,150100,14402,-40602,-32802,OK
132.284028,TraderOne,Tick,758,732,26,-26,150800,149800,14402,-40602,-32802,OK
132.50988,TraderOne,Tick,758,742,16,-16,149800,149800,14702,-40902,-40902,OK
132.796974,TraderOne,Tick,758,752,6,-6,149800,149600,15002,-39202,-38002,OK
133.024349,TraderOne,Tick,758,762,-4,4,149800,149600,15302,-37502,-38302,OK
133.211027,TraderOne,Tick,758,772,-14,14,150200,149600,15152,-36352,-39152,OK
133.522831,TraderOne,Tick,758,778,-20,20,149800,149600,15332,-35332,-39332,OK
133.779634,TraderOne,Tick,768,778,-10,10,149000,149500,15182,-37182,-35182,OK
133.968923,TraderOne,Tick,768,778,-10,10,149000,149600,15182,-37182,-35182,OK
134.219531,TraderOne,Tick,768,778,-10,10,149000,149600,15182,-37182,-35182,OK
134.510089,TraderOne,Tick,768,778,-10,10,149000,149700,15182,-37182,-35182,OK
134.744985,TraderOne,Tick,768,778,-10,10,149000,149700,15182,-37182,-35182,OK
135.035661,TraderOne,Tick,768,778,-10,10,149000,149800,15182,-37182,-34182,OK
135.252607,TraderOne,Tick,778,778,0,0,149200,149800,15032,-39032,-39032,OK
135.494133,TraderOne,Tick,788,780,8,-8,149700,149800,14852,-37852,-38652,OK
135.725472,TraderOne,Tick,798,780,18,-18,149300,149900,15151,-33151,-38551,OK
135.983119,TraderOne,Tick,798,780,18,-18,149300,149900,15151,-33151,-38551,OK
136.25675,TraderOne,Tick,798,780,18,-18,149300,149900,15151,-33151,-38551,OK
136.476886,TraderOne,Tick,798,780,18,-18,149300,149900,15151,-33151,-38551,OK
136.709786,TraderOne,Tick,798,780,18,-18,149300,149800,15151,-33151,-38551,OK
137.046522,TraderOne,Tick,798,780,18,-18,149300,149600,15151,-33151,-36751,OK
137.289705,TraderOne,Tick,798,780,18,-18,149300,149600,15151,-33151,-36751,OK
137.463803,TraderOne,Tick,798,780,18,-18,149300,149600,15151,-33151,-36751,OK
137.763942,TraderOne,Tick,798,780,18,-18,149300,149300,15151,-33151,-33151,OK
137.955009,TraderOne,Tick,798,780,18,-18,149300,149300,15151,-33151,-33151,OK
138.260224,TraderOne,Tick,798,780,18,-18,149300,149300,15151,-33151,-33151,OK
138.550277,TraderOne,Tick,798,780,18,-18,149300,149300,15151,-33151,-33151,OK
138.721604,TraderOne,Tick,798,780,18,-18,149300,149100,15151,-33151,-29551,OK
139.047115,TraderOne,Tick,798,780,18,-18,149300,149100,15151,-33151,-29551,OK
139.269266,TraderOne,Tick,798,780,18,-18,149300,149100,15151,-33151,-29551,OK
139.529425,TraderOne,Tick,798,780,18,-18,149300,149300,15151,-33151,-33151,OK
139.746702,TraderOne,Tick,798,780,18,-18,149300,149300,15151,-33151,-33151,OK
139.951278,TraderOne,Tick,798,780,18,-18,149300,149300,15151,-33151,-33151,OK
140.248259,TraderOne,Tick,798,780,18,-18,149300,149300,15151,-33151,-33151,OK
140.501753,TraderOne,Tick,798,787,11,-11,149700,149300,15046,-33746,-31546,OK
140.780978,TraderOne,Tick,798,787,11,-11,149700,149300,15046,-33746,-31546,OK
140.993765,TraderOne,Tick,798,787,11,-11,149700,149300,15046,-33746,-31546,OK
141.229591,TraderOne,Tick,798,797,1,-1,149500,149300,15345,-35045,-34845,OK
141.500774,TraderOne,Tick,798,797,1,-1,149500,149300,15345,-35045,-34845,OK
141.792421,TraderOne,Tick,798,807,-9,9,150200,149500,15195,-34895,-36695,OK
141.995141,TraderOne,Tick,798,807,-9,9,150200,149500,15195,-34895,-36695,OK
142.243227,TraderOne,Tick,798,807,-9,9,150200,149500,15195,-34895,-36695,OK
142.500306,TraderOne,Tick,798,807,-9,9,150200,149500,15195,-34895,-36695,OK
142.768988,TraderOne,Tick,798,817,-19,19,150200,149500,15045,-33745,-37545,OK
143.029912,TraderOne,Tick,798,817,-19,19,150200,149500,15045,-33745,-37545,OK
143.28365,TraderOne,Tick,798,817,-19,19,150200,149500,15045,-33745,-37545,OK
143.500983,TraderOne,Tick,798,817,-19,19,150200,149500,15045,-33745,-37545,OK
143.753224,TraderOne,Tick,798,827,-29,29,150200,149700,14895,-32595,-38395,OK
143.982477,TraderOne,Tick,808,827,-19,19,149200,149700,14745,-35445,-31645,OK
144.233256,TraderOne,Tick,808,827,-19,19,149200,149700,14745,-35445,-31645,OK
144.496229,TraderOne,Tick,818,827,-9,9,149100,149700,14595,-37295,-35495,OK
144.779523,TraderOne,Tick,818,827,-9,9,149100,149700,14595,-37295,-35495,OK
145.036157,TraderOne,Tick,818,827,-9,9,149100,149700,14595,-37295,-35495,OK
145.25605,TraderOne,Tick,818,827,-9,9,149100,149700,14595,-37295,-35495,OK
145.487199,TraderOne,Tick,818,827,-9,9,149100,149700,14595,-37295,-35495,OK
145.729869,TraderOne,Tick,818,827,-9,9,149100,149700,14595,-37295,-35495,OK
146.022603,TraderOne,Tick,818,827,-9,9,149100,149700,14595,-37295,-35495,OK
146.222319,TraderOne,Tick,818,827,-9,9,149100,149700,14595,-37295,-35495,OK
146.535622,TraderOne,Tick,818,827,-9,9,149100,149500,14595,-37295,-35495,OK
146.722966,TraderOne,Tick,818,827,-9,9,149100,149700,14595,-37295,-35495,OK
147.011491,TraderOne,Tick,818,827,-9,9,149100,149700,14595,-37295,-35495,OK
147.268458,TraderOne,Tick,818,827,-9,9,149100,149700,14595,-37295,-35495,OK
147.509793,TraderOne,Tick,818,827,-9,9,149100,149600,14595,-37295,-35495,OK
147.756245,TraderOne,Tick,818,827,-9,9,149100,149600,14595,-37295,-35495,OK
148.002505,TraderOne,Tick,818,827,-9,9,149100,149600,14595,-37295,-35495,OK
148.288181,TraderOne,Tick,818,827,-9,9,149100,149600,14595,-37295,-35495,OK
148.505915,TraderOne,Tick,818,827,-9,9,149100,149600,14595,-37295,-35495,OK
148.753056,TraderOne,Tick,818,827,-9,9,149100,149600,14595,-37295,-35495,OK
148.987222,TraderOne,Tick,818,827,-9,9,149100,149600,14595,-37295,-35495,OK
149.263473,TraderOne,Tick,818,827,-9,9,149100,149600,14595,-37295,-35495,OK
149.549348,TraderOne,Tick,818,837,-19,19,150600,150100,14445,-34145,-39845,OK
149.706525,TraderOne,Tick,818,837,-19,19,150600,150100,14445,-34145,-39845,OK
150.041394,TraderOne,Tick,818,837,-19,19,150600,150100,14445,-34145,-39845,OK
150.224948,TraderOne,Tick,818,837,-19,19,150600,150100,14445,-34145,-39845,OK
150.490756,TraderOne,Tick,818,844,-26,26,150000,150100,14655,-32955,-30355,OK
150.77577,TraderOne,Tick,818,844,-26,26,150000,150100,14655,-32955,-30355,OK
151.007612,TraderOne,Tick,818,844,-26,26,150000,150100,14655,-32955,-30355,OK
151.224005,TraderOne,Tick,818,844,-26,26,150000,150100,14655,-32955,-30355,OK
151.522904,TraderOne,Tick,818,844,-26,26,150000,150100,14655,-32955,-30355,OK
151.71096,TraderOne,Tick,818,844,-26,26,150000,150100,14655,-32955,-30355,OK
151.980265,TraderOne,Tick,818,844,-26,26,150000,150100,14655,-32955,-30355,OK
152.277178,TraderOne,Tick,818,844,-26,26,150000,150100,14655,-32955,-30355,OK
152.536887,TraderOne,Tick,818,844,-26,26,150000,150100,14655,-32955,-30355,OK
152.763607,TraderOne,Tick,818,844,-26,26,150000,150100,14655,-32955,-30355,OK
152.985409,TraderOne,Tick,818,854,-36,36,150400,150100,14505,-29805,-40605,OK
153.27546,TraderOne,Tick,818,854,-36,36,150400,149800,14505,-29805,-40605,OK
153.542088,TraderOne,Tick,818,854,-36,36,150400,149800,14505,-29805,-40605,OK
153.732723,TraderOne,Tick,818,854,-36,36,150400,149800,14505,-29805,-40605,OK
154.030514,TraderOne,Tick,818,854,-36,36,150400,150100,14505,-29805,-40605,OK
154.292601,TraderOne,Tick,818,854,-36,36,150400,150100,14505,-29805,-40605,OK
154.47712,TraderOne,Tick,818,854,-36,36,150400,150100,14505,-29805,-40605,OK
154.771507,TraderOne,Tick,818,854,-36,36,150400,150100,14505,-29805,-40605,OK
155.004894,TraderOne,Tick,828,854,-26,26,150600,150100,14806,-33106,-40906,OK
155.244562,TraderOne,Tick,838,854,-16,16,150600,150100,15107,-36407,-41207,OK
155.513263,TraderOne,Tick,838,854,-16,16,150600,150300,15107,-36407,-41207,OK
155.738142,TraderOne,Tick,838,854,-16,16,150600,150300,15107,-36407,-41207,OK
155.984615,TraderOne,Tick,838,854,-16,16,150600,150300,15107,-36407,-41207,OK
156.235281,TraderOne,Tick,838,854,-16,16,150600,150300,15107,-36407,-41207,OK
156.4644,TraderOne,Tick,838,854,-16,16,150600,150300,15107,-36407,-41207,OK
156.751782,TraderOne,Tick,838,854,-16,16,150600,150300,15107,-36407,-41207,OK
157.031854,TraderOne,Tick,838,854,-16,16,150600,150300,15107,-36407,-41207,OK
157.212629,TraderOne,Tick,838,854,-16,16,150600,150300,15107,-36407,-41207,OK
157.534296,TraderOne,Tick,838,854,-16,16,150600,150300,15107,-36407,-41207,OK
157.72482,TraderOne,Tick,838,854,-16,16,150600,150300,15107,-36407,-41207,OK
158.02832,TraderOne,Tick,838,854,-16,16,150600,150300,15107,-36407,-41207,OK
158.261665,TraderOne,Tick,838,854,-16,16,150600,150300,15107,-36407,-41207,OK
158.524806,TraderOne,Tick,838,854,-16,16,150500,150300,15107,-36407,-39607,OK
158.71746,TraderOne,Tick,838,854,-16,16,150500,150300,15107,-36407,-39607,OK
159.008458,TraderOne,Tick,848,854,-6,6,150600,150400,15408,-38708,-39908,OK
159.239898,TraderOne,Tick,848,864,-16,16,150500,150400,15709,-38009,-39609,OK
159.533156,TraderOne,Tick,848,864,-16,16,150500,150400,15709,-38009,-39609,OK
159.794694,TraderOne,Tick,857,864,-7,7,150600,150400,15980,-40080,-41480,OK
159.990355,TraderOne,Tick,857,864,-7,7,150600,150400,15980,-40080,-41480,OK
160.276269,TraderOne,Tick,857,866,-9,9,150700,150400,15950,-39650,-42350,OK
160.538595,TraderOne,Tick,857,872,-15,15,150600,150400,15860,-38360,-41360,OK
160.735742,TraderOne,Tick,857,872,-15,15,150600,150200,15860,-38360,-42860,OK
161.010637,TraderOne,Tick,857,880,-23,23,150500,150200,16101,-37801,-44701,OK
161.242158,TraderOne,Tick,857,880,-23,23,150500,150200,16101,-37801,-44701,OK
161.46991,TraderOne,Tick,857,880,-23,23,150500,150200,16101,-37801,-44701,OK
161.727021,TraderOne,Tick,857,880,-23,23,150500,150200,16101,-37801,-44701,OK
162.039597,TraderOne,Tick,857,880,-23,23,150500,150200,16101,-37801,-44701,OK
162.225433,TraderOne,Tick,867,880,-13,13,150800,150700,16403,-41103,-42403,OK
162.487935,TraderOne,Tick,877,880,-3,3,150800,150800,16705,-42405,-42405,OK
162.758436,TraderOne,Tick,877,880,-3,3,150800,150800,16705,-42405,-42405,OK
163.029579,TraderOne,Tick,877,880,-3,3,150800,150700,16705,-42405,-42705,OK
163.245256,TraderOne,Tick,877,880,-3,3,150800,150600,16705,-42405,-43005,OK
163.460044,TraderOne,Tick,877,880,-3,3,150800,150800,16705,-42405,-42405,OK
163.734619,TraderOne,Tick,877,880,-3,3,150800,150800,16705,-42405,-42405,OK
163.979089,TraderOne,Tick,877,880,-3,3,150800,150800,16705,-42405,-42405,OK
164.215902,TraderOne,Tick,887,880,7,-7,151000,151000,17007,-43707,-43707,OK
164.508958,TraderOne,Tick,887,880,7,-7,151000,150900,17007,-43707,-43007,OK
164.772269,TraderOne,Tick,887,881,6,-6,151100,150900,16992,-43592,-42392,OK
165.02759,TraderOne,Tick,887,881,6,-6,151100,151000,16992,-43592,-42992,OK
165.294468,TraderOne,Tick,887,891,-4,4,151400,151000,16841,-42441,-43641,OK
165.51995,TraderOne,Tick,887,891,-4,4,151400,151000,16841,-42441,-43641,OK
165.739462,TraderOne,Tick,887,891,-4,4,151400,151000,16841,-42441,-43641,OK
165.957531,TraderOne,Tick,887,891,-4,4,151400,151000,16841,-42441,-43641,OK
166.250679,TraderOne,Tick,887,896,-9,9,151300,151100,16765,-41365,-43165,OK
166.457519,TraderOne,Tick,887,896,-9,9,151300,151100,16765,-41365,-43165,OK
166.751928,TraderOne,Tick,887,896,-9,9,151300,151100,16765,-41365,-43165,OK
166.988103,TraderOne,Tick,887,896,-9,9,151300,151100,16765,-41365,-43165,OK
167.208012,TraderOne,Tick,887,896,-9,9,151300,151100,16765,-41365,-43165,OK
167.472027,TraderOne,Tick,887,896,-9,9,151300,151100,16765,-41365,-43165,OK
167.704976,TraderOne,Tick,897,896,1,-1,151400,151100,17068,-43668,-43368,OK
167.992968,TraderOne,Tick,897,906,-9,9,151500,151100,16917,-43517,-46217,OK
168.285792,TraderOne,Tick,897,906,-9,9,151500,151100,16917,-43517,-46217,OK
168.504339,TraderOne,Tick,897,906,-9,9,151500,151100,16917,-43517,-46217,OK
168.708453,TraderOne,Tick,897,906,-9,9,151500,151100,16917,-43517,-46217,OK
168.969208,TraderOne,Tick,897,906,-9,9,151500,151100,16917,-43517,-46217,OK
169.208779,TraderOne,Tick,897,916,-19,19,151100,150500,17173,-41873,-47573,OK
169.550705,TraderOne,Tick,897,916,-19,19,151100,150500,17173,-41873,-47573,OK
169.752323,TraderOne,Tick,897,916,-19,19,151100,150800,17173,-41873,-47573,OK
170.036865,TraderOne,Tick,897,916,-19,19,151100,150700,17173,-41873,-47573,OK
170.222721,TraderOne,Tick,897,916,-19,19,151100,150700,17173,-41873,-47573,OK
170.51232,TraderOne,Tick,897,916,-19,19,151100,150700,17173,-41873,-47573,OK
170.725635,TraderOne,Tick,897,916,-19,19,151100,150500,17173,-41873,-47573,OK
171.030579,TraderOne,Tick,897,916,-19,19,151100,150500,17173,-41873,-47573,OK
171.224682,TraderOne,Tick,897,916,-19,19,151100,150500,17173,-41873,-47573,OK
171.514844,TraderOne,Tick,901,916,-15,15,150700,150500,17113,-42613,-45613,OK
171.704852,TraderOne,Tick,901,916,-15,15,150700,150500,17113,-42613,-45613,OK
171.996908,TraderOne,Tick,907,926,-19,19,151200,150500,16872,-41572,-47272,OK
172.2954,TraderOne,Tick,907,926,-19,19,151200,150500,16872,-41572,-47272,OK
172.520359,TraderOne,Tick,907,926,-19,19,151200,150500,16872,-41572,-47272,OK
172.725058,TraderOne,Tick,907,936,-29,29,151000,150500,16721,-39421,-48121,OK
173.000354,TraderOne,Tick,907,936,-29,29,151000,150500,16721,-39421,-48121,OK
173.20779,TraderOne,Tick,907,936,-29,29,151000,150500,16721,-39421,-48121,OK
173.526617,TraderOne,Tick,907,936,-29,29,151000,150500,16721,-39421,-48121,OK
173.764835,TraderOne,Tick,907,936,-29,29,151000,150500,16721,-39421,-48121,OK
173.975415,TraderOne,Tick,907,936,-29,29,151000,150500,16721,-39421,-48121,OK
174.226946,TraderOne,Tick,907,936,-29,29,151000,150500,16721,-39421,-48121,OK
174.473501,TraderOne,Tick,907,936,-29,29,151000,150500,16721,-39421,-48121,OK
174.758988,TraderOne,Tick,907,936,-29,29,151000,150600,16721,-39421,-48121,OK
175.015762,TraderOne,Tick,917,936,-19,19,150800,150600,17023,-41723,-45523,OK
175.276915,TraderOne,Tick,927,936,-9,9,150800,150600,17325,-44025,-45825,OK
175.531509,TraderOne,Tick,927,936,-9,9,150800,150600,17325,-44025,-45825,OK
175.766746,TraderOne,Tick,927,936,-9,9,150800,150600,17325,-44025,-45825,OK
176.041916,TraderOne,Tick,927,936,-9,9,150800,150600,17325,-44025,-45825,OK
176.297042,TraderOne,Tick,927,936,-9,9,150800,150600,17325,-44025,-45825,OK
176.485713,TraderOne,Tick,937,936,1,-1,150700,150600,17174,-44874,-44774,OK
176.730705,TraderOne,Tick,937,936,1,-1,150700,150600,17174,-44874,-44774,OK
177.000358,TraderOne,Tick,937,936,1,-1,150700,150600,17174,-44874,-44774,OK
177.286246,TraderOne,Tick,937,936,1,-1,150700,150600,17174,-44874,-44774,OK
177.504749,TraderOne,Tick,937,946,-9,9,151200,150600,17023,-44723,-47423,OK
177.793793,TraderOne,Tick,937,946,-9,9,151200,150300,17023,-44723,-47423,OK
178.032121,TraderOne,Tick,937,946,-9,9,151200,150300,17023,-44723,-47423,OK
178.244884,TraderOne,Tick,937,946,-9,9,151200,150300,17023,-44723,-47423,OK
178.468807,TraderOne,Tick,937,946,-9,9,151200,150200,17023,-44723,-47423,OK
178.791376,TraderOne,Tick,937,956,-19,19,150400,150200,17324,-43024,-46824,OK
179.025928,TraderOne,Tick,937,966,-29,29,150400,150200,17625,-41325,-47125,OK
179.20861,TraderOne,Tick,937,966,-29,29,150400,150200,17625,-41325,-47125,OK
179.474127,TraderOne,Tick,937,966,-29,29,150400,149900,17625,-41325,-50025,OK
179.786283,TraderOne,Tick,937,966,-29,29,150400,149900,17625,-41325,-50025,OK
179.967813,TraderOne,Tick,937,966,-29,29,150100,149900,17625,-41325,-47125,OK
180.288189,TraderOne,Tick,946,976,-30,30,150100,149800,17340,-41640,-50640,OK
180.452078,TraderOne,Tick,946,976,-30,30,150100,149800,17340,-41640,-50640,OK
180.780546,TraderOne,Tick,946,976,-30,30,150100,149900,17340,-41640,-47640,OK
181.028946,TraderOne,Tick,946,976,-30,30,150100,149900,17340,-41640,-47640,OK
181.213163,TraderOne,Tick,946,976,-30,30,150100,149900,17340,-41640,-47640,OK
181.483005,TraderOne,Tick,956,976,-20,20,149700,149900,17190,-45490,-41490,OK
181.758788,TraderOne,Tick,956,976,-20,20,149700,149900,17190,-45490,-41490,OK
181.993532,TraderOne,Tick,956,976,-20,20,149700,149900,17190,-45490,-41490,OK
182.25401,TraderOne,Tick,956,976,-20,20,149700,149900,17190,-45490,-41490,OK
182.519881,TraderOne,Tick,956,976,-20,20,149700,149900,17190,-45490,-41490,OK
182.707783,TraderOne,Tick,956,976,-20,20,149700,149900,17190,-45490,-41490,OK
182.962938,TraderOne,Tick,956,976,-20,20,149700,149900,17190,-45490,-41490,OK
183.258192,TraderOne,Tick,956,976,-20,20,149700,149900,17190,-45490,-41490,OK
183.490773,TraderOne,Tick,956,976,-20,20,149700,150000,17190,-45490,-39490,OK
183.720591,TraderOne,Tick,966,976,-10,10,150100,150000,17040,-47340,-48340,OK
183.968416,TraderOne,Tick,969,976,-7,7,150100,150000,16995,-47595,-48295,OK
184.271602,TraderOne,Tick,969,976,-7,7,150100,149700,16995,-47595,-48995,OK
184.547994,TraderOne,Tick,969,976,-7,7,150100,149700,16995,-47595,-48995,OK
184.757779,TraderOne,Tick,979,976,3,-3,149700,149700,16845,-47445,-47445,OK
184.964915,TraderOne,Tick,989,976,13,-13,149700,150000,17144,-46744,-50644,OK
185.239413,TraderOne,Tick,989,976,13,-13,149700,150000,17144,-46744,-50644,OK
185.463928,TraderOne,Tick,999,976,23,-23,149700,150000,17443,-46043,-52943,OK
185.757072,TraderOne,Tick,999,976,23,-23,149700,150000,17443,-46043,-52943,OK
186.028501,TraderOne,Tick,999,976,23,-23,149700,150000,17443,-46043,-52943,OK
186.255055,TraderOne,Tick,999,976,23,-23,149600,149800,17443,-46043,-50643,OK
186.52242,TraderOne,Tick,999,986,13,-13,149600,149800,17742,-48342,-50942,OK
186.779772,TraderOne,Tick,999,986,13,-13,149600,149800,17742,-48342,-50942,OK
186.957991,TraderOne,Tick,1009,986,23,-23,149700,149800,18041,-47641,-49941,OK
187.236785,TraderOne,Tick,1009,986,23,-23,149700,149800,18041,-47641,-49941,OK
187.470821,TraderOne,Tick,1009,986,23,-23,149700,149800,18041,-47641,-49941,OK
187.792113,TraderOne,Tick,1009,986,23,-23,149700,150000,18041,-47641,-54541,OK
188.02019,TraderOne,Tick,1019,986,33,-33,149700,150000,18340,-44940,-54840,OK
188.299676,TraderOne,Tick,1029,986,43,-43,149700,150100,18639,-42239,-55139,OK
188.499481,TraderOne,Tick,1029,986,43,-43,149700,150100,18639,-42239,-55139,OK
188.75655,TraderOne,Tick,1029,986,43,-43,149700,150100,18639,-42239,-55139,OK
189.048914,TraderOne,Tick,1029,986,43,-43,149700,150200,18639,-42239,-55139,OK
189.223995,TraderOne,Tick,1029,986,43,-43,149700,150200,18639,-42239,-55139,OK
189.495182,TraderOne,Tick,1029,986,43,-43,149700,150200,18639,-42239,-55139,OK
189.77807,TraderOne,Tick,1039,986,53,-53,150000,150200,18489,-39089,-49689,OK
189.967601,TraderOne,Tick,1039,986,53,-53,150000,150200,18489,-39089,-49689,OK
190.230365,TraderOne,Tick,1039,986,53,-53,150000,150300,18489,-39089,-54989,OK
190.48415,TraderOne,Tick,1039,986,53,-53,150000,150300,18489,-39089,-54989,OK
190.722691,TraderOne,Tick,1039,986,53,-53,150000,150300,18489,-39089,-54989,OK
190.953376,TraderOne,Tick,1039,986,53,-53,150000,150300,18489,-39089,-54989,OK
191.253096,TraderOne,Tick,1039,986,53,-53,149500,150400,18489,-39089,-54989,OK
191.523826,TraderOne,Tick,1049,986,63,-63,150000,150700,18789,-33389,-52289,OK
191.761944,TraderOne,Tick,1049,986,63,-63,150000,150800,18789,-33389,-52289,OK
192.040764,TraderOne,Tick,1049,996,53,-53,150200,150800,19089,-39689,-55589,OK
192.211683,TraderOne,Tick,1049,996,53,-53,150200,150700,19089,-39689,-55589,OK
192.460716,TraderOne,Tick,1049,996,53,-53,150200,150700,19089,-39689,-55589,OK
192.770947,TraderOne,Tick,1059,996,63,-63,150300,150700,19389,-34989,-53889,OK
193.000526,TraderOne,Tick,1059,996,63,-63,150200,150500,19389,-34989,-53889,OK
193.244285,TraderOne,Tick,1059,1006,53,-53,150200,150500,19689,-40289,-56189,OK
193.534295,TraderOne,Tick,1059,1006,53,-53,150200,150500,19689,-40289,-56189,OK
193.792314,TraderOne,Tick,1059,1006,53,-53,150200,150500,19689,-40289,-56189,OK
194.021726,TraderOne,Tick,1059,1016,43,-43,150000,150500,19539,-50139,-63039,OK
194.249475,TraderOne,Tick,1059,1016,43,-43,150000,150500,19539,-50139,-63039,OK
194.468566,TraderOne,Tick,1059,1016,43,-43,150000,150500,19539,-50139,-63039,OK
194.73846,TraderOne,Tick,1059,1016,43,-43,150000,150500,19539,-50139,-63039,OK
195.049508,TraderOne,Tick,1059,1016,43,-43,150000,150600,19539,-50139,-63039,OK
195.26666,TraderOne,Tick,1059,1016,43,-43,150000,150600,19539,-50139,-63039,OK
195.523262,TraderOne,Tick,1059,1016,43,-43,150000,150600,19539,-50139,-63039,OK
195.795984,TraderOne,Tick,1059,1016,43,-43,150000,150600,19539,-50139,-63039,OK
195.969845,TraderOne,Tick,1059,1016,43,-43,150000,150600,19539,-50139,-63039,OK
196.212779,TraderOne,Tick,1059,1016,43,-43,150000,150600,19539,-50139,-63039,OK
196.533923,TraderOne,Tick,1059,1016,43,-43,149800,150600,19539,-50139,-63039,OK
196.768462,TraderOne,Tick,1059,1016,43,-43,149800,150100,19539,-50139,-63039,OK
196.969028,TraderOne,Tick,1059,1016,43,-43,149800,150000,19539,-50139,-58739,OK
197.291808,TraderOne,Tick,1059,1016,43,-43,149800,150000,19539,-50139,-58739,OK
197.542209,TraderOne,Tick,1059,1026,33,-33,149500,150000,19838,-54438,-64338,OK
197.769053,TraderOne,Tick,1059,1026,33,-33,149500,149800,19838,-54438,-64338,OK
197.972717,TraderOne,Tick,1059,1026,33,-33,149500,149600,19838,-54438,-57738,OK
198.293815,TraderOne,Tick,1059,1036,23,-23,149500,149700,20137,-56737,-61337,OK
198.528095,TraderOne,Tick,1059,1046,13,-13,149500,149500,20436,-59036,-59036,OK
198.73638,TraderOne,Tick,1059,1046,13,-13,149500,149500,20436,-59036,-59036,OK
199.005869,TraderOne,Tick,1059,1056,3,-3,149500,149500,20735,-60335,-60335,OK
199.232487,TraderOne,Tick,1059,1056,3,-3,149500,149500,20735,-60335,-60335,OK
199.496841,TraderOne,Tick,1059,1056,3,-3,149500,149500,20735,-60335,-60335,OK
199.706746,TraderOne,Tick,1059,1056,3,-3,149500,149500,20735,-60335,-60335,OK
199.986896,TraderOne,Tick,1059,1056,3,-3,149500,149500,20735,-60335,-60335,OK
200.232685,TraderOne,Tick,1059,1056,3,-3,149500,149600,20735,-60335,-60635,OK
200.50779,TraderOne,Tick,1059,1060,-1,1,149700,149600,20675,-60275,-60375,OK
200.723337,TraderOne,Tick,1059,1060,-1,1,149700,149600,20675,-60275,-60375,OK
201.043833,TraderOne,Tick,1059,1060,-1,1,149700,149600,20675,-60275,-60375,OK
201.244807,TraderOne,Tick,1059,1061,-2,2,150000,149600,20660,-60060,-60460,OK
201.529352,TraderOne,Tick,1059,1061,-2,2,150000,149800,20660,-60060,-60460,OK
201.789966,TraderOne,Tick,1069,1061,8,-8,149300,150000,20510,-58910,-61310,OK
202.019068,TraderOne,Tick,1069,1061,8,-8,149300,150000,20510,-58910,-61310,OK
202.261109,TraderOne,Tick,1069,1061,8,-8,149300,150200,20510,-58910,-61310,OK
202.529002,TraderOne,Tick,1069,1061,8,-8,149300,150200,20510,-58910,-61310,OK
202.720077,TraderOne,Tick,1079,1061,18,-18,150500,150600,20811,-59211,-61011,OK
203.011803,TraderOne,Tick,1089,1061,28,-28,150500,150600,21112,-58512,-61312,OK
203.265435,TraderOne,Tick,1089,1061,28,-28,150500,150600,21112,-58512,-61312,OK
203.526186,TraderOne,Tick,1089,1061,28,-28,150500,150600,21112,-58512,-61312,OK
203.770902,TraderOne,Tick,1089,1061,28,-28,150500,150600,21112,-58512,-61312,OK
204.028647,TraderOne,Tick,1099,1061,38,-38,150300,150600,20962,-57362,-68762,OK
204.201707,TraderOne,Tick,1099,1061,38,-38,150300,150600,20962,-57362,-68762,OK
204.451186,TraderOne,Tick,1099,1061,38,-38,150300,150600,20962,-57362,-68762,OK
204.762806,TraderOne,Tick,1099,1061,38,-38,150300,150600,20962,-57362,-68762,OK
205.020414,TraderOne,Tick,1108,1061,47,-47,149900,150100,20827,-56327,-65727,OK
205.225992,TraderOne,Tick,1108,1071,37,-37,149700,149700,21126,-58626,-58626,OK
205.467717,TraderOne,Tick,1108,1081,27,-27,150400,149700,20976,-60476,-55076,OK
205.778611,TraderOne,Tick,1108,1081,27,-27,150400,149700,20976,-60476,-55076,OK
205.954676,TraderOne,Tick,1108,1081,27,-27,150400,149800,20976,-60476,-52376,OK
206.275316,TraderOne,Tick,1108,1091,17,-17,150300,149800,20826,-62326,-57226,OK
206.491506,TraderOne,Tick,1108,1091,17,-17,150300,149800,20826,-62326,-57226,OK
206.786624,TraderOne,Tick,1108,1091,17,-17,150300,149800,20826,-62326,-57226,OK
207.026124,TraderOne,Tick,1108,1091,17,-17,150300,149800,20826,-62326,-57226,OK
207.206341,TraderOne,Tick,1108,1091,17,-17,150300,149800,20826,-62326,-57226,OK
207.546912,TraderOne,Tick,1108,1091,17,-17,150300,149800,20826,-62326,-57226,OK
207.782149,TraderOne,Tick,1108,1091,17,-17,150300,149800,20826,-62326,-57226,OK
207.999372,TraderOne,Tick,1108,1091,17,-17,150300,149800,20826,-62326,-57226,OK
208.261173,TraderOne,Tick,1118,1101,17,-17,149200,149800,20975,-62475,-67575,OK
208.509625,TraderOne,Tick,1118,1111,7,-7,149800,149800,20825,-63325,-63325,OK
208.718061,TraderOne,Tick,1118,1111,7,-7,149800,149800,20825,-63325,-63325,OK
209.022762,TraderOne,Tick,1118,1111,7,-7,149800,149800,20825,-63325,-63325,OK
209.216547,TraderOne,Tick,1118,1111,7,-7,149800,149800,20825,-63325,-63325,OK
209.516155,TraderOne,Tick,1118,1111,7,-7,149800,149800,20825,-63325,-63325,OK
209.707491,TraderOne,Tick,1118,1121,-3,3,150300,149800,20675,-63175,-64075,OK
210.035451,TraderOne,Tick,1118,1121,-3,3,150300,149800,20675,-63175,-64075,OK
210.294062,TraderOne,Tick,1118,1121,-3,3,150300,149800,20675,-63175,-64075,OK
210.543328,TraderOne,Tick,1118,1121,-3,3,150300,149800,20675,-63175,-64075,OK
210.706932,TraderOne,Tick,1118,1121,-3,3,150300,149800,20675,-63175,-64075,OK
211.003498,TraderOne,Tick,1118,1131,-13,13,150400,149900,20525,-62025,-65925,OK
211.26411,TraderOne,Tick,1118,1140,-22,22,150200,149900,20795,-59595,-66195,OK
211.512847,TraderOne,Tick,1118,1140,-22,22,150200,149900,20795,-59595,-66195,OK
211.793204,TraderOne,Tick,1128,1140,-12,12,149900,149600,20645,-64445,-66845,OK
211.98053,TraderOne,Tick,1138,1140,-2,2,149100,149600,20495,-66295,-65895,OK
212.252675,TraderOne,Tick,1138,1140,-2,2,149100,149700,20495,-66295,-65895,OK
212.522834,TraderOne,Tick,1138,1140,-2,2,149100,149700,20495,-66295,-65895,OK
212.790979,TraderOne,Tick,1138,1150,-12,12,150200,149700,20345,-63145,-65545,OK
213.03395,TraderOne,Tick,1138,1150,-12,12,150200,149700,20345,-63145,-65545,OK
213.285787,TraderOne,Tick,1138,1150,-12,12,150200,149300,20345,-63145,-65545,OK
213.461839,TraderOne,Tick,1138,1150,-12,12,150200,149300,20345,-63145,-65545,OK
213.734706,TraderOne,Tick,1138,1150,-12,12,150200,149300,20345,-63145,-65545,OK
214.038945,TraderOne,Tick,1138,1150,-12,12,150200,149300,20345,-63145,-65545,OK
214.22099,TraderOne,Tick,1138,1150,-12,12,150200,149300,20345,-63145,-65545,OK
214.518161,TraderOne,Tick,1138,1150,-12,12,150200,149600,20345,-63145,-65545,OK
214.704281,TraderOne,Tick,1138,1150,-12,12,150200,149600,20345,-63145,-65545,OK
214.963696,TraderOne,Tick,1138,1150,-12,12,150200,149600,20345,-63145,-65545,OK
215.243724,TraderOne,Tick,1138,1150,-12,12,150200,149600,20345,-63145,-65545,OK
215.496766,TraderOne,Tick,1138,1150,-12,12,150200,149600,20345,-63145,-65545,OK
215.770385,TraderOne,Tick,1138,1150,-12,12,150200,149600,20345,-63145,-65545,OK
215.962678,TraderOne,Tick,1144,1150,-6,6,149500,149600,20255,-64255,-63655,OK
216.20401,TraderOne,Tick,1144,1150,-6,6,149500,149600,20255,-64255,-63655,OK
216.552032,TraderOne,Tick,1144,1150,-6,6,149500,149700,20255,-64255,-63055,OK
216.752533,TraderOne,Tick,1154,1150,4,-4,149700,149700,20554,-63554,-63554,OK
217.030997,TraderOne,Tick,1164,1150,14,-14,149100,150000,20539,-62939,-67139,OK
217.244132,TraderOne,Tick,1174,1150,24,-24,149500,150000,20838,-59238,-66438,OK
217.539492,TraderOne,Tick,1184,1150,34,-34,149500,150100,21137,-55537,-65737,OK
217.713648,TraderOne,Tick,1184,1150,34,-34,149500,150100,21137,-55537,-65737,OK
217.97604,TraderOne,Tick,1184,1150,34,-34,149500,149900,21137,-55537,-65737,OK
218.232354,TraderOne,Tick,1184,1150,34,-34,149500,149900,21137,-55537,-65737,OK
218.452677,TraderOne,Tick,1184,1150,34,-34,149500,149900,21137,-55537,-65737,OK
218.723336,TraderOne,Tick,1184,1150,34,-34,149500,149900,21137,-55537,-65737,OK
219.011372,TraderOne,Tick,1184,1150,34,-34,149500,149900,21137,-55537,-65737,OK
219.295633,TraderOne,Tick,1184,1160,24,-24,150500,149900,20987,-58387,-51187,OK
219.460142,TraderOne,Tick,1184,1170,14,-14,150400,149900,20837,-60237,-56037,OK
219.763659,TraderOne,Tick,1184,1170,14,-14,150400,149900,20837,-60237,-56037,OK
220.045823,TraderOne,Tick,1184,1180,4,-4,150500,149900,20687,-61087,-59887,OK
220.247668,TraderOne,Tick,1184,1180,4,-4,150500,149900,20687,-61087,-59887,OK
220.502692,TraderOne,Tick,1184,1180,4,-4,150500,149900,20687,-61087,-59887,OK
220.780998,TraderOne,Tick,1184,1180,4,-4,150500,149900,20687,-61087,-59887,OK
220.992198,TraderOne,Tick,1184,1190,-6,6,150500,150000,20537,-60937,-62737,OK
221.250141,TraderOne,Tick,1184,1190,-6,6,150500,150000,20537,-60937,-62737,OK
221.478138,TraderOne,Tick,1184,1190,-6,6,150500,150100,20537,-60937,-62737,OK
221.728928,TraderOne,Tick,1184,1190,-6,6,150500,150100,20537,-60937,-62737,OK
222.042278,TraderOne,Tick,1184,1190,-6,6,150500,150100,20537,-60937,-62737,OK
222.249605,TraderOne,Tick,1184,1190,-6,6,150500,150100,20537,-60937,-62737,OK
222.487102,TraderOne,Tick,1184,1190,-6,6,150500,150100,20537,-60937,-62737,OK
222.726683,TraderOne,Tick,1194,1190,4,-4,149500,150100,20387,-61787,-62987,OK
222.995962,TraderOne,Tick,1194,1190,4,-4,149500,150000,20387,-61787,-62987,OK
223.241451,TraderOne,Tick,1194,1200,-6,6,150100,150000,20687,-62087,-62687,OK
223.542014,TraderOne,Tick,1194,1200,-6,6,150100,150000,20687,-62087,-62687,OK
223.72757,TraderOne,Tick,1194,1210,-16,16,150100,150000,20987,-62387,-63987,OK
223.999886,TraderOne,Tick,1194,1220,-26,26,150400,150000,21288,-60688,-68488,OK
224.211098,TraderOne,Tick,1194,1230,-36,36,150400,150000,21589,-56989,-67789,OK
224.456507,TraderOne,Tick,1194,1236,-42,42,150400,150000,21769,-54769,-67369,OK
224.738123,TraderOne,Tick,1194,1236,-42,42,150400,149800,21769,-54769,-67369,OK
225.024458,TraderOne,Tick,1204,1236,-32,32,150100,149400,21619,-62619,-69019,OK
225.217554,TraderOne,Tick,1204,1236,-32,32,150100,149500,21619,-62619,-69019,OK
225.535102,TraderOne,Tick,1204,1236,-32,32,150100,149500,21619,-62619,-69019,OK
225.781289,TraderOne,Tick,1204,1236,-32,32,150100,149500,21619,-62619,-69019,OK
225.987872,TraderOne,Tick,1204,1236,-32,32,150100,149500,21619,-62619,-69019,OK
226.255335,TraderOne,Tick,1214,1236,-22,22,149300,149500,21469,-67469,-63069,OK
226.525359,TraderOne,Tick,1214,1236,-22,22,149300,149500,21469,-67469,-63069,OK
226.722715,TraderOne,Tick,1214,1246,-32,32,150300,149500,21319,-65319,-71719,OK
226.966098,TraderOne,Tick,1214,1246,-32,32,150300,149500,21319,-65319,-71719,OK
227.211684,TraderOne,Tick,1214,1246,-32,32,150300,149500,21319,-65319,-71719,OK
227.465569,TraderOne,Tick,1224,1246,-22,22,150400,150200,21620,-69620,-74020,OK
227.754632,TraderOne,Tick,1229,1246,-17,17,150500,150600,21770,-70770,-69070,OK
228.018672,TraderOne,Tick,1239,1246,-7,7,150600,150800,22071,-70071,-68671,OK
228.281304,TraderOne,Tick,1249,1246,3,-3,150600,150600,22372,-69372,-69372,OK
228.522631,TraderOne,Tick,1259,1246,13,-13,150600,150600,22673,-68673,-68673,OK
228.798533,TraderOne,Tick,1259,1246,13,-13,150600,150600,22673,-68673,-68673,OK
229.025673,TraderOne,Tick,1263,1246,17,-17,150500,150600,22613,-67813,-69513,OK
229.283979,TraderOne,Tick,1273,1246,27,-27,150600,150600,22914,-67114,-67114,OK
229.50658,TraderOne,Tick,1273,1246,27,-27,150600,150600,22914,-67114,-67114,OK
229.755447,TraderOne,Tick,1273,1246,27,-27,150600,150600,22914,-67114,-67114,OK
229.969446,TraderOne,Tick,1273,1246,27,-27,150600,150600,22914,-67114,-67114,OK
230.276045,TraderOne,Tick,1273,1246,27,-27,150600,150700,22914,-67114,-69814,OK
230.468736,TraderOne,Tick,1273,1246,27,-27,150600,150700,22914,-67114,-69814,OK
230.774255,TraderOne,Tick,1273,1246,27,-27,150600,150700,22914,-67114,-69814,OK
230.991283,TraderOne,Tick,1273,1246,27,-27,150600,150700,22914,-67114,-69814,OK
231.300506,TraderOne,Tick,1273,1246,27,-27,150600,150700,22914,-67114,-69814,OK
231.516496,TraderOne,Tick,1273,1246,27,-27,150600,150700,22914,-67114,-69814,OK
231.701842,TraderOne,Tick,1273,1246,27,-27,150600,150700,22914,-67114,-69814,OK
231.994453,TraderOne,Tick,1273,1246,27,-27,150600,150700,22914,-67114,-69814,OK
232.212364,TraderOne,Tick,1273,1246,27,-27,150600,150700,22914,-67114,-69814,OK
232.505075,TraderOne,Tick,1273,1246,27,-27,150600,150700,22914,-67114,-69814,OK
232.731641,TraderOne,Tick,1283,1246,37,-37,150600,150700,23215,-65415,-69115,OK
233.004209,TraderOne,Tick,1288,1246,42,-42,150600,150700,23366,-64566,-68766,OK
233.261879,TraderOne,Tick,1288,1246,42,-42,150600,151100,23366,-64566,-77166,OK
233.469422,TraderOne,Tick,1288,1246,42,-42,150600,151100,23366,-64566,-77166,OK
233.710919,TraderOne,Tick,1288,1246,42,-42,150600,151100,23366,-64566,-77166,OK
233.997836,TraderOne,Tick,1288,1246,42,-42,150600,151100,23366,-64566,-77166,OK
234.2286,TraderOne,Tick,1288,1246,42,-42,150600,151100,23366,-64566,-77166,OK
234.54334,TraderOne,Tick,1288,1246,42,-42,150700,151200,23366,-64566,-77166,OK
234.734177,TraderOne,Tick,1298,1246,52,-52,150800,151200,23668,-60868,-76468,OK
235.017178,TraderOne,Tick,1298,1246,52,-52,150800,151200,23668,-60868,-76468,OK
235.233151,TraderOne,Tick,1298,1256,42,-42,150900,151500,23517,-68717,-81317,OK
235.507303,TraderOne,Tick,1299,1256,43,-43,151100,151500,23547,-68347,-81247,OK
235.711673,TraderOne,Tick,1299,1256,43,-43,151100,151600,23547,-68347,-81247,OK
236.011623,TraderOne,Tick,1309,1256,53,-53,151200,151600,23849,-64649,-80549,OK
236.273356,TraderOne,Tick,1309,1256,53,-53,151200,151600,23849,-64649,-80549,OK
236.507407,TraderOne,Tick,1309,1256,53,-53,151000,151600,23849,-64649,-80549,OK
236.745742,TraderOne,Tick,1309,1266,43,-43,151300,151600,23698,-70498,-83398,OK
236.991285,TraderOne,Tick,1319,1266,53,-53,151000,151600,23547,-66347,-82247,OK
237.264222,TraderOne,Tick,1319,1266,53,-53,151000,151600,23547,-66347,-82247,OK
237.478246,TraderOne,Tick,1319,1266,53,-53,151000,151700,23547,-66347,-82247,OK
237.765111,TraderOne,Tick,1319,1266,53,-53,151000,151700,23547,-66347,-82247,OK
238.044909,TraderOne,Tick,1319,1266,53,-53,151000,151700,23547,-66347,-82247,OK
238.27048,TraderOne,Tick,1319,1266,53,-53,151000,151700,23547,-66347,-82247,OK
238.455823,TraderOne,Tick,1319,1266,53,-53,151000,151700,23547,-66347,-82247,OK
238.744451,TraderOne,Tick,1319,1266,53,-53,151000,151700,23547,-66347,-82247,OK
238.973917,TraderOne,Tick,1319,1266,53,-53,151000,151700,23547,-66347,-82247,OK
239.282018,TraderOne,Tick,1319,1266,53,-53,151000,151500,23547,-66347,-82247,OK
239.524914,TraderOne,Tick,1319,1276,43,-43,151300,151500,23396,-71196,-79796,OK
239.746744,TraderOne,Tick,1319,1276,43,-43,151300,151500,23396,-71196,-79796,OK
240.005598,TraderOne,Tick,1319,1276,43,-43,151300,151500,23396,-71196,-79796,OK
240.28214,TraderOne,Tick,1319,1276,43,-43,151300,151400,23396,-71196,-75496,OK
240.484595,TraderOne,Tick,1319,1286,33,-33,151400,151400,23245,-75045,-75045,OK
240.765633,TraderOne,Tick,1319,1286,33,-33,151400,151500,23245,-75045,-78345,OK
241.048819,TraderOne,Tick,1319,1286,33,-33,151400,151500,23245,-75045,-78345,OK
241.216845,TraderOne,Tick,1319,1286,33,-33,151400,151500,23245,-75045,-78345,OK
241.550219,TraderOne,Tick,1319,1286,33,-33,151400,151500,23245,-75045,-78345,OK
241.76129,TraderOne,Tick,1319,1286,33,-33,151400,151500,23245,-75045,-78345,OK
242.013846,TraderOne,Tick,1329,1286,43,-43,150900,151300,23094,-71894,-84794,OK
242.264162,TraderOne,Tick,1339,1286,53,-53,150800,151300,22943,-68743,-84643,OK
242.512707,TraderOne,Tick,1339,1296,43,-43,150800,151300,23245,-74045,-86945,OK
242.763184,TraderOne,Tick,1339,1296,43,-43,150800,151300,23245,-74045,-86945,OK
243.026014,TraderOne,Tick,1339,1296,43,-43,150800,151300,23245,-74045,-86945,OK
243.28481,TraderOne,Tick,1349,1296,53,-53,150800,151300,23094,-69894,-85794,OK
243.466187,TraderOne,Tick,1349,1296,53,-53,150800,151300,23094,-69894,-85794,OK
243.712103,TraderOne,Tick,1349,1296,53,-53,150800,151300,23094,-69894,-85794,OK
244.014886,TraderOne,Tick,1349,1296,53,-53,150800,151500,23094,-69894,-85794,OK
244.249275,TraderOne,Tick,1349,1296,53,-53,150800,151500,23094,-69894,-85794,OK
244.482329,TraderOne,Tick,1349,1296,53,-53,150800,151500,23094,-69894,-85794,OK
244.728635,TraderOne,Tick,1349,1296,53,-53,150800,151500,23094,-69894,-85794,OK
245.034884,TraderOne,Tick,1349,1296,53,-53,150800,151500,23094,-69894,-85794,OK
245.280908,TraderOne,Tick,1349,1296,53,-53,150800,151400,23094,-69894,-85794,OK
245.479635,TraderOne,Tick,1349,1296,53,-53,150800,151600,23094,-69894,-85794,OK
245.783044,TraderOne,Tick,1349,1306,43,-43,151400,151800,22943,-75743,-88643,OK
245.956117,TraderOne,Tick,1349,1306,43,-43,151400,151800,22943,-75743,-88643,OK
246.276354,TraderOne,Tick,1349,1306,43,-43,151400,151800,22943,-75743,-88643,OK
246.454947,TraderOne,Tick,1349,1306,43,-43,151400,151800,22943,-75743,-88643,OK
246.774728,TraderOne,Tick,1349,1306,43,-43,151400,151800,22943,-75743,-88643,OK
247.011754,TraderOne,Tick,1349,1306,43,-43,151400,152100,22943,-75743,-88643,OK
247.273624,TraderOne,Tick,1359,1306,53,-53,151700,152100,23246,-69046,-84946,OK
247.482794,TraderOne,Tick,1359,1306,53,-53,151700,152100,23246,-69046,-84946,OK
247.75995,TraderOne,Tick,1359,1306,53,-53,151400,152100,23246,-69046,-84946,OK
247.954689,TraderOne,Tick,1359,1306,53,-53,151400,152100,23246,-69046,-84946,OK
248.278465,TraderOne,Tick,1369,1306,63,-63,151500,152100,23094,-63894,-82794,OK
248.531078,TraderOne,Tick,1369,1316,53,-53,151500,152100,23397,-71197,-87097,OK
248.731625,TraderOne,Tick,1369,1316,53,-53,151500,152100,23397,-71197,-87097,OK
248.972889,TraderOne,Tick,1369,1316,53,-53,151800,152100,23397,-71197,-87097,OK
249.284568,TraderOne,Tick,1369,1326,43,-43,152000,152700,23245,-82045,-94945,OK
249.453405,TraderOne,Tick,1379,1326,53,-53,152100,152900,23549,-75349,-91249,OK
249.760714,TraderOne,Tick,1389,1326,63,-63,152400,152700,23853,-67653,-86553,OK
250.045755,TraderOne,Tick,1389,1336,53,-53,152400,152700,24158,-70958,-86858,OK
250.250079,TraderOne,Tick,1389,1336,53,-53,152400,152700,24158,-70958,-86858,OK
250.547329,TraderOne,Tick,1389,1346,43,-43,152600,152700,24006,-75806,-80106,OK
250.763665,TraderOne,Tick,1389,1346,43,-43,152600,152700,24006,-75806,-80106,OK
250.971054,TraderOne,Tick,1389,1346,43,-43,152600,152700,24006,-75806,-80106,OK
251.203516,TraderOne,Tick,1399,1346,53,-53,152000,152500,23854,-71654,-87554,OK
251.486667,TraderOne,Tick,1399,1346,53,-53,152000,152600,23854,-71654,-87554,OK
251.766717,TraderOne,Tick,1399,1346,53,-53,152000,152500,23854,-71654,-87554,OK
252.034047,TraderOne,Tick,1399,1346,53,-53,152000,152500,23854,-71654,-87554,OK
252.253949,TraderOne,Tick,1399,1346,53,-53,152000,152500,23854,-71654,-87554,OK
252.543942,TraderOne,Tick,1399,1346,53,-53,152000,152500,23854,-71654,-87554,OK
252.724143,TraderOne,Tick,1399,1356,43,-43,152600,152500,23702,-76502,-72202,OK
252.964868,TraderOne,Tick,1399,1356,43,-43,152600,152500,23702,-76502,-72202,OK
253.201819,TraderOne,Tick,1399,1356,43,-43,152600,152500,23702,-76502,-72202,OK
253.479656,TraderOne,Tick,1399,1356,43,-43,152600,152500,23702,-76502,-72202,OK
253.712364,TraderOne,Tick,1399,1356,43,-43,152600,152500,23702,-76502,-72202,OK
253.97063,TraderOne,Tick,1399,1356,43,-43,152600,152500,23702,-76502,-72202,OK
254.218612,TraderOne,Tick,1399,1356,43,-43,152600,152500,23702,-76502,-72202,OK
254.488343,TraderOne,Tick,1399,1366,33,-33,152200,152500,23550,-80350,-90250,OK
254.772298,TraderOne,Tick,1399,1366,33,-33,152200,152500,23550,-80350,-90250,OK
254.996359,TraderOne,Tick,1399,1366,33,-33,152200,152500,23550,-80350,-90250,OK
255.269674,TraderOne,Tick,1399,1366,33,-33,152200,152500,23550,-80350,-90250,OK
255.457874,TraderOne,Tick,1399,1366,33,-33,152200,152500,23550,-80350,-90250,OK
255.771133,TraderOne,Tick,1399,1366,33,-33,152200,152500,23550,-80350,-90250,OK
255.973604,TraderOne,Tick,1399,1366,33,-33,152200,152200,23550,-80350,-80350,OK
256.233514,TraderOne,Tick,1399,1366,33,-33,152200,152200,23550,-80350,-80350,OK
256.485573,TraderOne,Tick,1399,1366,33,-33,152200,152000,23550,-80350,-73750,OK
256.756763,TraderOne,Tick,1399,1366,33,-33,152200,152000,23550,-80350,-73750,OK
256.955016,TraderOne,Tick,1399,1366,33,-33,152200,152000,23550,-80350,-73750,OK
257.290133,TraderOne,Tick,1409,1366,43,-43,151400,152000,23398,-77198,-90098,OK
257.543568,TraderOne,Tick,1409,1366,43,-43,151400,152000,23398,-77198,-90098,OK
257.782418,TraderOne,Tick,1409,1366,43,-43,151400,152000,23398,-77198,-90098,OK
257.956156,TraderOne,Tick,1409,1366,43,-43,151400,152000,23398,-77198,-90098,OK
258.298351,TraderOne,Tick,1409,1376,33,-33,151700,151900,23246,-80046,-86646,OK
258.52439,TraderOne,Tick,1409,1376,33,-33,151700,151800,23246,-80046,-83346,OK
258.779377,TraderOne,Tick,1409,1376,33,-33,151700,151700,23246,-80046,-80046,OK
258.997976,TraderOne,Tick,1409,1386,23,-23,151700,151700,23094,-82894,-82894,OK
259.268079,TraderOne,Tick,1409,1386,23,-23,151700,151600,23094,-82894,-80594,OK
259.507118,TraderOne,Tick,1409,1386,23,-23,151700,151600,23094,-82894,-80594,OK
259.79165,TraderOne,Tick,1409,1386,23,-23,151700,151600,23094,-82894,-80594,OK
260.028304,TraderOne,Tick,1409,1386,23,-23,151700,151600,23094,-82894,-80594,OK
260.252008,TraderOne,Tick,1419,1386,33,-33,151300,151600,22943,-80743,-90643,OK
260.500904,TraderOne,Tick,1419,1386,33,-33,151300,151600,22943,-80743,-90643,OK
260.756366,TraderOne,Tick,1419,1396,23,-23,151300,151800,23246,-84046,-90946,OK
260.957226,TraderOne,Tick,1419,1396,23,-23,151300,151800,23246,-84046,-90946,OK
261.210113,TraderOne,Tick,1419,1396,23,-23,151300,151800,23246,-84046,-90946,OK
261.456002,TraderOne,Tick,1419,1396,23,-23,151300,151800,23246,-84046,-90946,OK
261.708092,TraderOne,Tick,1419,1406,13,-13,152000,151800,23094,-85894,-83294,OK
261.980868,TraderOne,Tick,1429,1406,23,-23,151700,151800,22942,-85742,-88042,OK
262.252287,TraderOne,Tick,1439,1406,33,-33,151600,151800,23245,-84045,-90645,OK
262.474616,TraderOne,Tick,1439,1406,33,-33,151600,151800,23245,-84045,-90645,OK
262.741903,TraderOne,Tick,1439,1406,33,-33,151600,151800,23245,-84045,-90645,OK
262.984231,TraderOne,Tick,1439,1406,33,-33,151600,151800,23245,-84045,-90645,OK
263.213597,TraderOne,Tick,1449,1406,43,-43,151600,152200,23548,-80348,-93248,OK
263.517871,TraderOne,Tick,1458,1406,52,-52,151600,152200,23821,-76121,-91721,OK
263.755034,TraderOne,Tick,1458,1416,42,-42,151500,152200,24124,-81424,-94024,OK
263.993099,TraderOne,Tick,1458,1416,42,-42,151500,152200,24124,-81424,-94024,OK
264.297099,TraderOne,Tick,1458,1416,42,-42,151500,152200,24124,-81424,-94024,OK
264.465012,TraderOne,Tick,1458,1416,42,-42,151500,152200,24124,-81424,-94024,OK
264.743978,TraderOne,Tick,1458,1416,42,-42,151500,151800,24124,-81424,-94024,OK
264.952121,TraderOne,Tick,1458,1416,42,-42,151500,151800,24124,-81424,-94024,OK
265.255553,TraderOne,Tick,1458,1416,42,-42,151500,151800,24124,-81424,-94024,OK
265.491183,TraderOne,Tick,1458,1416,42,-42,151500,151800,24124,-81424,-94024,OK
265.713392,TraderOne,Tick,1458,1416,42,-42,151500,151800,24124,-81424,-94024,OK
265.992305,TraderOne,Tick,1458,1426,32,-32,152100,151800,23972,-87272,-77672,OK
266.26635,TraderOne,Tick,1458,1426,32,-32,152100,151800,23972,-87272,-77672,OK
266.516211,TraderOne,Tick,1458,1432,26,-26,151800,151800,23881,-88981,-88981,OK
266.78966,TraderOne,Tick,1458,1432,26,-26,151800,151800,23881,-88981,-88981,OK
266.986086,TraderOne,Tick,1458,1432,26,-26,151800,152200,23881,-88981,-96781,OK
267.276487,TraderOne,Tick,1458,1432,26,-26,151800,152200,23881,-88981,-96781,OK
267.47139,TraderOne,Tick,1458,1432,26,-26,152100,152200,23881,-88981,-91581,OK
267.746255,TraderOne,Tick,1458,1432,26,-26,152100,152200,23881,-88981,-91581,OK
268.018489,TraderOne,Tick,1458,1432,26,-26,152100,152200,23881,-88981,-91581,OK
268.27457,TraderOne,Tick,1468,1432,36,-36,152200,152200,24185,-86285,-86285,OK
268.466611,TraderOne,Tick,1471,1432,39,-39,152200,152200,24276,-85476,-85476,OK
268.735813,TraderOne,Tick,1471,1432,39,-39,152200,152600,24276,-85476,-97176,OK
268.986454,TraderOne,Tick,1471,1432,39,-39,152200,152600,24276,-85476,-97176,OK
269.252088,TraderOne,Tick,1471,1432,39,-39,152200,152600,24276,-85476,-97176,OK
269.465718,TraderOne,Tick,1471,1432,39,-39,152200,153000,24276,-85476,-97176,OK
269.791412,TraderOne,Tick,1481,1432,49,-49,152300,153000,24581,-82781,-97481,OK
269.961035,TraderOne,Tick,1491,1432,59,-59,152100,153000,24657,-78857,-96557,OK
270.207941,TraderOne,Tick,1491,1432,59,-59,152100,153000,24657,-78857,-96557,OK
270.523757,TraderOne,Tick,1491,1432,59,-59,152100,152900,24657,-78857,-96557,OK
270.775338,TraderOne,Tick,1491,1432,59,-59,152100,152900,24657,-78857,-96557,OK
271.025306,TraderOne,Tick,1491,1432,59,-59,152100,153000,24657,-78857,-96557,OK
271.256971,TraderOne,Tick,1491,1432,59,-59,152100,153300,24657,-78857,-96557,OK
271.477847,TraderOne,Tick,1501,1432,69,-69,152700,153300,24962,-72162,-92862,OK
271.705845,TraderOne,Tick,1501,1442,59,-59,153000,153700,24809,-82009,-99709,OK
272.015846,TraderOne,Tick,1501,1442,59,-59,153100,153600,24809,-82009,-99709,OK
272.268943,TraderOne,Tick,1501,1442,59,-59,153100,153600,24809,-82009,-99709,OK
272.516608,TraderOne,Tick,1501,1452,49,-49,153600,153600,25115,-86315,-86315,OK
272.709022,TraderOne,Tick,1511,1452,59,-59,152800,153600,24962,-83162,-100862,OK
273.019068,TraderOne,Tick,1511,1452,59,-59,152800,153600,24962,-83162,-100862,OK
273.285563,TraderOne,Tick,1511,1452,59,-59,152800,153600,24962,-83162,-100862,OK
273.503932,TraderOne,Tick,1521,1452,69,-69,152600,153600,24809,-78009,-98709,OK
273.760563,TraderOne,Tick,1521,1462,59,-59,152700,153600,25114,-84314,-102014,OK
274.048025,TraderOne,Tick,1521,1472,49,-49,153800,153600,25419,-89619,-79819,OK
274.281454,TraderOne,Tick,1521,1472,49,-49,153800,153600,25419,-89619,-79819,OK
274.522752,TraderOne,Tick,1521,1472,49,-49,153800,152900,25419,-89619,-74919,OK
274.735694,TraderOne,Tick,1521,1482,39,-39,152500,152900,25724,-93924,-105624,OK
274.976517,TraderOne,Tick,1521,1482,39,-39,152500,152900,25724,-93924,-105624,OK
275.277846,TraderOne,Tick,1531,1492,39,-39,152300,152700,25877,-92077,-103777,OK
275.47129,TraderOne,Tick,1531,1501,30,-30,152600,152700,25740,-95540,-98540,OK
275.721716,TraderOne,Tick,1531,1501,30,-30,152600,152700,25740,-95540,-98540,OK
276.029674,TraderOne,Tick,1531,1501,30,-30,152600,152700,25740,-95540,-98540,OK
276.278957,TraderOne,Tick,1531,1501,30,-30,152600,153000,25740,-95540,-104540,OK
276.477714,TraderOne,Tick,1531,1501,30,-30,152600,153100,25740,-95540,-104540,OK
276.749517,TraderOne,Tick,1531,1501,30,-30,152600,153100,25740,-95540,-104540,OK
276.965388,TraderOne,Tick,1541,1501,40,-40,152400,153100,25587,-93387,-105387,OK
277.286366,TraderOne,Tick,1541,1501,40,-40,152400,153100,25587,-93387,-105387,OK
277.483068,TraderOne,Tick,1541,1501,40,-40,152400,153100,25587,-93387,-105387,OK
277.759557,TraderOne,Tick,1541,1501,40,-40,152400,152900,25587,-93387,-105387,OK
277.989448,TraderOne,Tick,1541,1501,40,-40,152400,152900,25587,-93387,-105387,OK
278.237731,TraderOne,Tick,1541,1501,40,-40,152400,152900,25587,-93387,-105387,OK
278.501224,TraderOne,Tick,1541,1501,40,-40,152400,153000,25587,-93387,-105387,OK
278.733988,TraderOne,Tick,1541,1511,30,-30,152700,153200,25434,-100234,-109234,OK
279.001006,TraderOne,Tick,1541,1511,30,-30,152700,153200,25434,-100234,-109234,OK
279.266035,TraderOne,Tick,1541,1511,30,-30,152700,153200,25434,-100234,-109234,OK
279.493953,TraderOne,Tick,1541,1511,30,-30,152700,153200,25434,-100234,-109234,OK
279.72443,TraderOne,Tick,1541,1511,30,-30,152700,153200,25434,-100234,-109234,OK
279.991827,TraderOne,Tick,1541,1511,30,-30,152700,153200,25434,-100234,-109234,OK
280.290008,TraderOne,Tick,1541,1511,30,-30,152700,153000,25434,-100234,-109234,OK
280.54807,TraderOne,Tick,1541,1521,20,-20,152800,152800,25740,-100540,-100540,OK
280.742619,TraderOne,Tick,1541,1531,10,-10,152800,152800,26046,-100846,-100846,OK
280.99349,TraderOne,Tick,1541,1541,0,0,152800,152600,26352,-102152,-102152,OK
281.251671,TraderOne,Tick,1541,1551,-10,10,152800,152700,26658,-101458,-102458,OK
281.503225,TraderOne,Tick,1541,1551,-10,10,152800,152700,26658,-101458,-102458,OK
281.796999,TraderOne,Tick,1541,1551,-10,10,152800,152700,26658,-101458,-102458,OK
281.995517,TraderOne,Tick,1541,1551,-10,10,152800,152700,26658,-101458,-102458,OK
282.274254,TraderOne,Tick,1551,1551,0,0,152300,152700,26505,-102305,-102305,OK
282.519549,TraderOne,Tick,1551,1551,0,0,152300,152700,26505,-102305,-102305,OK
282.755624,TraderOne,Tick,1551,1551,0,0,152300,152800,26505,-102305,-102305,OK
282.969338,TraderOne,Tick,1551,1551,0,0,152300,152800,26505,-102305,-102305,OK
283.268945,TraderOne,Tick,1551,1551,0,0,152300,152800,26505,-102305,-102305,OK
283.470313,TraderOne,Tick,1551,1551,0,0,152300,152800,26505,-102305,-102305,OK
283.787938,TraderOne,Tick,1561,1551,10,-10,152300,152800,26352,-102152,-105152,OK
284.050591,TraderOne,Tick,1561,1551,10,-10,152300,152800,26352,-102152,-105152,OK
284.220964,TraderOne,Tick,1561,1561,0,0,153400,152800,26199,-103999,-103999,OK
284.471236,TraderOne,Tick,1561,1561,0,0,153400,152800,26199,-103999,-103999,OK
284.762337,TraderOne,Tick,1571,1561,10,-10,152400,152800,26046,-103846,-106846,OK
284.983305,TraderOne,Tick,1571,1561,10,-10,152400,153100,26046,-103846,-106846,OK
285.266184,TraderOne,Tick,1580,1561,19,-19,153000,153500,25908,-100108,-105808,OK
285.457256,TraderOne,Tick,1580,1571,9,-9,153900,153500,25755,-104955,-102255,OK
285.785208,TraderOne,Tick,1580,1571,9,-9,153900,153500,25755,-104955,-102255,OK
285.954417,TraderOne,Tick,1580,1571,9,-9,153900,153900,25755,-104955,-104955,OK
286.266573,TraderOne,Tick,1586,1571,15,-15,153800,153600,25940,-105140,-102140,OK
286.487546,TraderOne,Tick,1586,1571,15,-15,153800,153600,25940,-105140,-102140,OK
286.709165,TraderOne,Tick,1586,1571,15,-15,153800,153600,25940,-105140,-102140,OK
287.027782,TraderOne,Tick,1586,1581,5,-5,153900,153600,25787,-105987,-104487,OK
287.207677,TraderOne,Tick,1586,1581,5,-5,153900,153500,25787,-105987,-104487,OK
287.50109,TraderOne,Tick,1591,1581,10,-10,153500,153500,25710,-105910,-105910,OK
287.723667,TraderOne,Tick,1591,1581,10,-10,153500,153600,25710,-105910,-106910,OK
288.014098,TraderOne,Tick,1591,1581,10,-10,153500,153600,25710,-105910,-106910,OK
288.265422,TraderOne,Tick,1591,1581,10,-10,153500,153400,25710,-105910,-104910,OK
288.476092,TraderOne,Tick,1591,1581,10,-10,153500,153400,25710,-105910,-104910,OK
288.745026,TraderOne,Tick,1591,1581,10,-10,153500,153400,25710,-105910,-104910,OK
288.984216,TraderOne,Tick,1591,1581,10,-10,153500,153400,25710,-105910,-104910,OK
289.212044,TraderOne,Tick,1591,1581,10,-10,153500,153400,25710,-105910,-104910,OK
289.499137,TraderOne,Tick,1591,1581,10,-10,153500,153400,25710,-105910,-104910,OK
289.715869,TraderOne,Tick,1591,1581,10,-10,153500,153400,25710,-105910,-104910,OK
290.034859,TraderOne,Tick,1591,1591,0,0,153400,153400,26017,-107217,-107217,OK
290.222691,TraderOne,Tick,1591,1591,0,0,153400,153500,26017,-107217,-107217,OK
290.529075,TraderOne,Tick,1591,1591,0,0,153400,153500,26017,-107217,-107217,OK
290.746624,TraderOne,Tick,1591,1591,0,0,153400,153500,26017,-107217,-107217,OK
291.025089,TraderOne,Tick,1601,1601,0,0,153100,153500,25710,-106910,-106910,OK
291.209982,TraderOne,Tick,1601,1601,0,0,153100,153500,25710,-106910,-106910,OK
291.487221,TraderOne,Tick,1601,1611,-10,10,153900,153500,25556,-106756,-109756,OK
291.758586,TraderOne,Tick,1601,1611,-10,10,153900,153500,25556,-106756,-109756,OK
291.98558,TraderOne,Tick,1601,1611,-10,10,153900,153500,25556,-106756,-109756,OK
292.210978,TraderOne,Tick,1601,1611,-10,10,153900,153500,25556,-106756,-109756,OK
292.49886,TraderOne,Tick,1601,1621,-20,20,153900,153500,25402,-104602,-110602,OK
292.793326,TraderOne,Tick,1601,1631,-30,30,153900,153600,25710,-101910,-110910,OK
293.045389,TraderOne,Tick,1601,1641,-40,40,153900,153600,26018,-99218,-111218,OK
293.237557,TraderOne,Tick,1601,1641,-40,40,153900,153600,26018,-99218,-111218,OK
293.468515,TraderOne,Tick,1601,1641,-40,40,153900,153400,26018,-99218,-111218,OK
293.79362,TraderOne,Tick,1601,1641,-40,40,153900,153400,26018,-99218,-111218,OK
293.966426,TraderOne,Tick,1601,1651,-50,50,153900,153400,26326,-95526,-110526,OK
294.245597,TraderOne,Tick,1601,1651,-50,50,153900,153400,26326,-95526,-110526,OK
294.51592,TraderOne,Tick,1601,1651,-50,50,154000,153400,26326,-95526,-110526,OK
294.714221,TraderOne,Tick,1601,1651,-50,50,154000,153400,26326,-95526,-110526,OK
294.960307,TraderOne,Tick,1601,1651,-50,50,154000,153500,26326,-95526,-110526,OK
295.237851,TraderOne,Tick,1611,1651,-40,40,154000,153500,26634,-100834,-112834,OK
295.460015,TraderOne,Tick,1611,1651,-40,40,154000,153500,26634,-100834,-112834,OK
295.792636,TraderOne,Tick,1620,1651,-31,31,153900,153500,26495,-104295,-113595,OK
296.01721,TraderOne,Tick,1620,1651,-31,31,153900,153500,26495,-104295,-113595,OK
296.285209,TraderOne,Tick,1620,1651,-31,31,153900,153500,26495,-104295,-113595,OK
296.545794,TraderOne,Tick,1620,1651,-31,31,153900,153400,26495,-104295,-113595,OK
296.799812,TraderOne,Tick,1620,1651,-31,31,153900,153400,26495,-104295,-113595,OK
297.020134,TraderOne,Tick,1620,1651,-31,31,153900,153400,26495,-104295,-113595,OK
297.284042,TraderOne,Tick,1620,1661,-41,41,153800,153200,26803,-100603,-112903,OK
297.475618,TraderOne,Tick,1620,1661,-41,41,153800,153300,26803,-100603,-112903,OK
297.734959,TraderOne,Tick,1620,1661,-41,41,153800,153300,26803,-100603,-112903,OK
297.96285,TraderOne,Tick,1630,1661,-31,31,153800,153500,27111,-104911,-114211,OK
298.244871,TraderOne,Tick,1640,1661,-21,21,153100,153600,26957,-107757,-101457,OK
298.499085,TraderOne,Tick,1650,1661,-11,11,153100,153600,27263,-103063,-99763,OK
298.762146,TraderOne,Tick,1660,1661,-1,1,153100,153600,27569,-98369,-98069,OK
298.95713,TraderOne,Tick,1670,1661,9,-9,153100,153600,27875,-94675,-97375,OK
299.214115,TraderOne,Tick,1671,1661,10,-10,153100,153400,27906,-94306,-97306,OK
299.479903,TraderOne,Tick,1671,1661,10,-10,153100,153400,27906,-94306,-97306,OK
299.753085,TraderOne,Tick,1671,1661,10,-10,153100,153500,27906,-94306,-97306,OK
299.951245,TraderOne,Tick,1671,1661,10,-10,153100,153700,27906,-94306,-97306,OK
300.252167,TraderOne,Tick,1671,1661,10,-10,153100,153700,27906,-94306,-97306,OK
300.482905,TraderOne,Tick,1671,1661,10,-10,153100,153600,27906,-94306,-97306,OK
300.730507,TraderOne,Tick,1671,1661,10,-10,153100,153600,27906,-94306,-97306,OK
300.981346,TraderOne,Tick,1671,1661,10,-10,153100,153600,27906,-94306,-97306,OK
301.221283,TraderOne,Tick,1671,1661,10,-10,153100,153700,27906,-94306,-97306,OK
301.550811,TraderOne,Tick,1671,1661,10,-10,153100,153600,27906,-94306,-97306,OK
301.793458,TraderOne,Tick,1671,1661,10,-10,153100,153600,27906,-94306,-97306,OK
301.957157,TraderOne,Tick,1671,1661,10,-10,153100,153600,27906,-94306,-97306,OK
302.279809,TraderOne,Tick,1671,1661,10,-10,153100,153600,27906,-94306,-97306,OK
302.471429,TraderOne,Tick,1671,1661,10,-10,153100,153600,27906,-94306,-97306,OK
302.79452,TraderOne,Tick,1681,1671,10,-10,153700,153600,27598,-92998,-91998,OK
302.967396,TraderOne,Tick,1681,1681,0,0,153700,153500,27905,-93305,-93305,OK
303.245726,TraderOne,Tick,1691,1691,0,0,153000,153300,28059,-92459,-92459,OK
303.464876,TraderOne,Tick,1691,1691,0,0,153000,153300,28059,-92459,-92459,OK
303.796345,TraderOne,Tick,1691,1691,0,0,153000,153400,28059,-92459,-92459,OK
304.023576,TraderOne,Tick,1691,1691,0,0,153000,153400,28059,-92459,-92459,OK
304.223027,TraderOne,Tick,1691,1701,-10,10,154000,153200,27905,-90305,-93305,OK
304.548507,TraderOne,Tick,1691,1701,-10,10,154000,153100,27905,-90305,-93305,OK
304.757878,TraderOne,Tick,1691,1701,-10,10,154000,153100,27905,-90305,-93305,OK
304.981816,TraderOne,Tick,1701,1711,-10,10,153700,152900,27599,-89999,-92999,OK
305.222375,TraderOne,Tick,1701,1711,-10,10,152500,152900,27599,-89999,-86999,OK
305.538704,TraderOne,Tick,1701,1711,-10,10,152500,152900,27599,-89999,-86999,OK
305.729346,TraderOne,Tick,1701,1711,-10,10,152500,152800,27599,-89999,-86999,OK
306.012436,TraderOne,Tick,1701,1711,-10,10,152500,152800,27599,-89999,-86999,OK
306.260153,TraderOne,Tick,1701,1711,-10,10,152500,152800,27599,-89999,-86999,OK
306.453562,TraderOne,Tick,1701,1711,-10,10,152500,152600,27599,-89999,-88999,OK
306.746453,TraderOne,Tick,1711,1711,0,0,152500,152600,27446,-91846,-91846,OK
306.957181,TraderOne,Tick,1711,1711,0,0,152500,152600,27446,-91846,-91846,OK
307.207243,TraderOne,Tick,1711,1711,0,0,152500,152900,27446,-91846,-91846,OK
307.544287,TraderOne,Tick,1711,1711,0,0,152500,152900,27446,-91846,-91846,OK
307.70496,TraderOne,Tick,1711,1711,0,0,152500,152900,27446,-91846,-91846,OK
307.973579,TraderOne,Tick,1711,1711,0,0,152500,152900,27446,-91846,-91846,OK
308.288541,TraderOne,Tick,1711,1711,0,0,152500,152900,27446,-91846,-91846,OK
308.483942,TraderOne,Tick,1711,1711,0,0,152500,152900,27446,-91846,-91846,OK
308.745753,TraderOne,Tick,1711,1711,0,0,152500,152900,27446,-91846,-91846,OK
308.982961,TraderOne,Tick,1711,1711,0,0,152500,152900,27446,-91846,-91846,OK
309.282779,TraderOne,Tick,1711,1711,0,0,152500,152900,27446,-91846,-91846,OK
309.521601,TraderOne,Tick,1721,1721,0,0,152600,153200,27140,-90540,-90540,OK
309.736444,TraderOne,Tick,1721,1721,0,0,152600,153200,27140,-90540,-90540,OK
310.041293,TraderOne,Tick,1721,1721,0,0,152600,153400,27140,-90540,-90540,OK
310.215008,TraderOne,Tick,1721,1728,-7,7,153500,153400,27033,-92533,-93233,OK
310.513901,TraderOne,Tick,1731,1728,3,-3,153800,154200,27341,-90841,-91741,OK
310.774908,TraderOne,Tick,1741,1728,13,-13,153800,154200,27649,-88149,-92049,OK
311.036649,TraderOne,Tick,1751,1738,13,-13,154100,154200,27803,-87303,-88603,OK
311.295535,TraderOne,Tick,1751,1738,13,-13,154100,154200,27803,-87303,-88603,OK
311.521332,TraderOne,Tick,1751,1738,13,-13,154100,154200,27803,-87303,-88603,OK
311.756846,TraderOne,Tick,1751,1738,13,-13,154100,154200,27803,-87303,-88603,OK
311.951363,TraderOne,Tick,1751,1738,13,-13,154100,154200,27803,-87303,-88603,OK
312.271251,TraderOne,Tick,1751,1738,13,-13,154100,154200,27803,-87303,-88603,OK
312.457758,TraderOne,Tick,1751,1738,13,-13,154100,154200,27803,-87303,-88603,OK
312.738938,TraderOne,Tick,1761,1738,23,-23,153600,154200,28111,-86611,-93511,OK
312.997364,TraderOne,Tick,1761,1738,23,-23,153600,154200,28111,-86611,-93511,OK
313.286532,TraderOne,Tick,1761,1738,23,-23,153600,154300,28111,-86611,-93511,OK
313.462938,TraderOne,Tick,1761,1748,13,-13,154500,154300,27957,-87457,-84857,OK
313.775523,TraderOne,Tick,1761,1748,13,-13,154500,154300,27957,-87457,-84857,OK
314.007632,TraderOne,Tick,1761,1748,13,-13,154500,154300,27957,-87457,-84857,OK
314.226983,TraderOne,Tick,1761,1748,13,-13,154500,154300,27957,-87457,-84857,OK
314.472568,TraderOne,Tick,1761,1748,13,-13,154500,154300,27957,-87457,-84857,OK
314.753959,TraderOne,Tick,1761,1758,3,-3,154500,154300,27803,-88303,-87703,OK
315.001899,TraderOne,Tick,1761,1758,3,-3,154500,154300,27803,-88303,-87703,OK
315.251647,TraderOne,Tick,1761,1758,3,-3,154500,154300,27803,-88303,-87703,OK
315.508874,TraderOne,Tick,1761,1758,3,-3,154500,154300,27803,-88303,-87703,OK
315.771502,TraderOne,Tick,1761,1758,3,-3,154500,154300,27803,-88303,-87703,OK
316.037199,TraderOne,Tick,1761,1758,3,-3,154500,154300,27803,-88303,-87703,OK
316.291702,TraderOne,Tick,1761,1758,3,-3,154500,154300,27803,-88303,-87703,OK
316.508201,TraderOne,Tick,1761,1758,3,-3,154500,154300,27803,-88303,-87703,OK
316.729807,TraderOne,Tick,1761,1758,3,-3,154500,154300,27803,-88303,-87703,OK
317.048941,TraderOne,Tick,1771,1768,3,-3,154300,154200,27495,-87995,-87695,OK
317.3004,TraderOne,Tick,1771,1778,-7,7,154300,154200,27804,-88304,-89004,OK
317.529234,TraderOne,Tick,1771,1788,-17,17,154500,154200,28113,-87613,-92713,OK
317.784901,TraderOne,Tick,1771,1788,-17,17,154500,154200,28113,-87613,-92713,OK
318.025458,TraderOne,Tick,1771,1798,-27,27,154300,154200,28422,-84922,-87622,OK
318.261676,TraderOne,Tick,1771,1798,-27,27,154300,154200,28422,-84922,-87622,OK
318.538722,TraderOne,Tick,1771,1808,-37,37,154400,153800,28731,-81231,-92331,OK
318.759675,TraderOne,Tick,1771,1818,-47,47,154300,153800,29040,-77540,-91640,OK
319.019324,TraderOne,Tick,1771,1818,-47,47,154300,153800,29040,-77540,-91640,OK
319.239662,TraderOne,Tick,1771,1818,-47,47,154300,153800,29040,-77540,-91640,OK
319.545064,TraderOne,Tick,1771,1818,-47,47,154300,153800,29040,-77540,-91640,OK
319.784839,TraderOne,Tick,1771,1818,-47,47,154300,153700,29040,-77540,-91640,OK
320.028209,TraderOne,Tick,1771,1828,-57,57,154400,153700,28932,-72432,-89532,OK
320.236544,TraderOne,Tick,1771,1828,-57,57,154400,153700,28932,-72432,-89532,OK
320.455147,TraderOne,Tick,1771,1828,-57,57,154400,153900,28932,-72432,-89532,OK
320.728945,TraderOne,Tick,1781,1828,-47,47,154400,153900,29241,-78741,-92841,OK
320.969585,TraderOne,Tick,1781,1828,-47,47,154400,153900,29241,-78741,-92841,OK
321.207033,TraderOne,Tick,1781,1828,-47,47,154400,153900,29241,-78741,-92841,OK
321.498189,TraderOne,Tick,1781,1831,-50,50,154400,153900,29195,-77195,-92195,OK
321.713025,TraderOne,Tick,1791,1831,-40,40,154400,153800,29504,-83504,-95504,OK
321.970303,TraderOne,Tick,1791,1841,-50,50,154200,153800,29812,-78812,-93812,OK
322.220015,TraderOne,Tick,1791,1841,-50,50,154200,153800,29812,-78812,-93812,OK
322.50133,TraderOne,Tick,1791,1851,-60,60,154200,153800,30120,-75120,-93120,OK
322.775547,TraderOne,Tick,1801,1851,-50,50,154200,153800,30428,-81428,-96428,OK
323.020749,TraderOne,Tick,1801,1851,-50,50,154200,153800,30428,-81428,-96428,OK
323.297592,TraderOne,Tick,1801,1861,-60,60,154400,153800,30274,-76274,-94274,OK
323.528744,TraderOne,Tick,1801,1861,-60,60,154400,153800,30274,-76274,-94274,OK
323.729612,TraderOne,Tick,1811,1861,-50,50,154400,153800,30120,-83120,-98120,OK
323.965894,TraderOne,Tick,1811,1861,-50,50,154400,153800,30120,-83120,-98120,OK
324.284572,TraderOne,Tick,1811,1861,-50,50,154400,153800,30120,-83120,-98120,OK
324.466496,TraderOne,Tick,1821,1861,-40,40,153900,153800,29966,-88966,-92966,OK
324.747517,TraderOne,Tick,1821,1861,-40,40,153900,153800,29966,-88966,-92966,OK
325.024384,TraderOne,Tick,1821,1861,-40,40,153900,153800,29966,-88966,-92966,OK
325.269718,TraderOne,Tick,1821,1861,-40,40,153900,153600,29966,-88966,-100966,OK
325.519739,TraderOne,Tick,1821,1861,-40,40,153900,153600,29966,-88966,-100966,OK
325.757324,TraderOne,Tick,1821,1861,-40,40,153900,153600,29966,-88966,-100966,OK
325.997103,TraderOne,Tick,1831,1861,-30,30,153000,153600,29812,-92812,-83812,OK
326.213803,TraderOne,Tick,1831,1861,-30,30,153000,153600,29812,-92812,-83812,OK
326.47514,TraderOne,Tick,1831,1861,-30,30,153000,153500,29812,-92812,-83812,OK
326.728982,TraderOne,Tick,1831,1861,-30,30,153000,153500,29812,-92812,-83812,OK
327.048494,TraderOne,Tick,1831,1861,-30,30,153000,153400,29812,-92812,-83812,OK
327.238224,TraderOne,Tick,1831,1861,-30,30,153000,153400,29812,-92812,-83812,OK
327.543613,TraderOne,Tick,1831,1870,-39,39,153800,153400,29674,-89974,-101674,OK
327.79837,TraderOne,Tick,1831,1880,-49,49,154000,153400,29520,-84820,-99520,OK
328.003986,TraderOne,Tick,1831,1890,-59,59,154000,153400,29366,-79666,-97366,OK
328.297903,TraderOne,Tick,1841,1890,-49,49,152900,153400,29212,-85512,-70812,OK
328.511615,TraderOne,Tick,1851,1890,-39,39,154000,153400,29520,-90820,-102520,OK
328.757866,TraderOne,Tick,1851,1890,-39,39,154000,153400,29520,-90820,-102520,OK
329.045531,TraderOne,Tick,1851,1890,-39,39,154000,153400,29520,-90820,-102520,OK
329.249506,TraderOne,Tick,1851,1890,-39,39,154000,153400,29520,-90820,-102520,OK
329.494336,TraderOne,Tick,1851,1890,-39,39,154000,153400,29520,-90820,-102520,OK
329.743845,TraderOne,Tick,1851,1890,-39,39,154000,153400,29520,-90820,-102520,OK
329.985077,TraderOne,Tick,1851,1890,-39,39,154000,153400,29520,-90820,-102520,OK
330.201875,TraderOne,Tick,1851,1890,-39,39,154000,153400,29520,-90820,-102520,OK
330.522718,TraderOne,Tick,1851,1900,-49,49,154000,153500,29366,-87666,-102366,OK
330.718061,TraderOne,Tick,1851,1900,-49,49,154000,153500,29366,-87666,-102366,OK
331.049019,TraderOne,Tick,1851,1900,-49,49,154000,153500,29366,-87666,-102366,OK
331.201676,TraderOne,Tick,1851,1900,-49,49,154000,153400,29366,-87666,-102366,OK
331.460976,TraderOne,Tick,1851,1900,-49,49,154000,153400,29366,-87666,-102366,OK
331.761739,TraderOne,Tick,1861,1900,-39,39,152900,153400,29212,-92512,-80812,OK
331.972814,TraderOne,Tick,1861,1900,-39,39,152900,153400,29212,-92512,-80812,OK
332.230799,TraderOne,Tick,1861,1900,-39,39,152900,153400,29212,-92512,-80812,OK
332.4583,TraderOne,Tick,1861,1910,-49,49,154000,153400,29058,-87358,-102058,OK
332.767628,TraderOne,Tick,1861,1910,-49,49,154000,153400,29058,-87358,-102058,OK
333.047883,TraderOne,Tick,1861,1910,-49,49,154000,153400,29058,-87358,-102058,OK
333.269937,TraderOne,Tick,1861,1910,-49,49,154000,153400,29058,-87358,-102058,OK
333.464561,TraderOne,Tick,1861,1910,-49,49,154000,153400,29058,-87358,-102058,OK
333.796247,TraderOne,Tick,1861,1910,-49,49,154000,153400,29058,-87358,-102058,OK
334.010698,TraderOne,Tick,1861,1910,-49,49,154000,153200,29058,-87358,-102058,OK
334.268874,TraderOne,Tick,1861,1910,-49,49,154000,153200,29058,-87358,-102058,OK
334.503604,TraderOne,Tick,1861,1910,-49,49,154000,153200,29058,-87358,-102058,OK
334.748059,TraderOne,Tick,1861,1910,-49,49,154000,153200,29058,-87358,-102058,OK
335.001657,TraderOne,Tick,1861,1910,-49,49,154000,153200,29058,-87358,-102058,OK
335.257277,TraderOne,Tick,1861,1910,-49,49,154000,153200,29058,-87358,-102058,OK
335.489106,TraderOne,Tick,1861,1920,-59,59,154000,153200,28904,-82204,-99904,OK
335.738458,TraderOne,Tick,1871,1920,-49,49,152800,153200,28750,-89050,-74350,OK
335.967568,TraderOne,Tick,1871,1920,-49,49,152800,153200,28750,-89050,-74350,OK
336.284539,TraderOne,Tick,1871,1920,-49,49,152800,153200,28750,-89050,-74350,OK
336.462143,TraderOne,Tick,1871,1920,-49,49,153800,153300,28750,-89050,-103750,OK
336.768918,TraderOne,Tick,1881,1920,-39,39,153800,153300,29058,-94358,-106058,OK
336.95637,TraderOne,Tick,1881,1920,-39,39,153800,153300,29058,-94358,-106058,OK
337.279952,TraderOne,Tick,1881,1920,-39,39,153800,153300,29058,-94358,-106058,OK
337.47905,TraderOne,Tick,1881,1920,-39,39,153800,153300,29058,-94358,-106058,OK
337.765372,TraderOne,Tick,1881,1920,-39,39,153800,153300,29058,-94358,-106058,OK
337.995767,TraderOne,Tick,1881,1920,-39,39,153800,153300,29058,-94358,-106058,OK
338.264994,TraderOne,Tick,1881,1920,-39,39,153800,153300,29058,-94358,-106058,OK
338.464068,TraderOne,Tick,1881,1920,-39,39,153800,153300,29058,-94358,-106058,OK
338.750963,TraderOne,Tick,1881,1920,-39,39,153800,153300,29058,-94358,-106058,OK
339.048191,TraderOne,Tick,1881,1930,-49,49,154000,153300,28904,-90204,-104904,OK
339.285419,TraderOne,Tick,1881,1930,-49,49,154000,153300,28904,-90204,-104904,OK
339.464702,TraderOne,Tick,1891,1930,-39,39,153900,153500,28750,-94050,-105750,OK
339.721414,TraderOne,Tick,1900,1930,-30,30,153800,153500,29027,-97027,-106027,OK
340.043003,TraderOne,Tick,1900,1930,-30,30,153800,153500,29027,-97027,-106027,OK
340.23604,TraderOne,Tick,1900,1930,-30,30,153800,153500,29027,-97027,-106027,OK
340.469895,TraderOne,Tick,1900,1930,-30,30,153800,153500,29027,-97027,-106027,OK
340.711657,TraderOne,Tick,1900,1940,-40,40,153800,153300,28873,-93873,-105873,OK
340.996853,TraderOne,Tick,1900,1940,-40,40,153800,153300,28873,-93873,-105873,OK
341.218855,TraderOne,Tick,1900,1940,-40,40,153800,153300,28873,-93873,-105873,OK
341.541686,TraderOne,Tick,1900,1940,-40,40,153800,153300,28873,-93873,-105873,OK
341.762563,TraderOne,Tick,1900,1950,-50,50,154100,153300,28719,-89719,-104719,OK
342.042397,TraderOne,Tick,1900,1950,-50,50,154100,153300,28719,-89719,-104719,OK
342.270961,TraderOne,Tick,1900,1950,-50,50,154100,153300,28719,-89719,-104719,OK
342.502852,TraderOne,Tick,1900,1950,-50,50,154100,153300,28719,-89719,-104719,OK
342.718724,TraderOne,Tick,1910,1950,-40,40,154000,153300,28565,-95565,-107565,OK
342.997442,TraderOne,Tick,1910,1950,-40,40,154000,153300,28565,-95565,-107565,OK
343.211233,TraderOne,Tick,1910,1950,-40,40,154000,153300,28565,-95565,-107565,OK
343.49157,TraderOne,Tick,1910,1960,-50,50,153700,153300,28872,-91472,-106472,OK
343.766116,TraderOne,Tick,1910,1960,-50,50,153700,153300,28872,-91472,-106472,OK
343.957942,TraderOne,Tick,1920,1960,-40,40,152800,153300,28718,-95318,-83318,OK
344.204878,TraderOne,Tick,1920,1960,-40,40,152800,153000,28718,-95318,-87318,OK
344.499254,TraderOne,Tick,1920,1960,-40,40,152800,153000,28718,-95318,-87318,OK
344.774841,TraderOne,Tick,1930,1960,-30,30,152500,152900,28565,-99165,-90165,OK
344.966757,TraderOne,Tick,1930,1960,-30,30,152500,152900,28565,-99165,-90165,OK
345.243798,TraderOne,Tick,1930,1960,-30,30,152500,152900,28565,-99165,-90165,OK
345.53938,TraderOne,Tick,1930,1960,-30,30,152500,152900,28565,-99165,-90165,OK
345.784326,TraderOne,Tick,1930,1960,-30,30,152500,152700,28565,-99165,-93165,OK
345.970477,TraderOne,Tick,1930,1963,-33,33,153100,152700,28519,-97919,-107819,OK
346.257843,TraderOne,Tick,1930,1963,-33,33,153100,152700,28519,-97919,-107819,OK
346.478661,TraderOne,Tick,1930,1963,-33,33,153100,152600,28519,-97919,-107819,OK
346.795779,TraderOne,Tick,1930,1963,-33,33,153100,152800,28519,-97919,-107819,OK
347.049727,TraderOne,Tick,1930,1963,-33,33,153100,152700,28519,-97919,-107819,OK
347.279373,TraderOne,Tick,1930,1963,-33,33,153100,152700,28519,-97919,-107819,OK
347.547676,TraderOne,Tick,1930,1963,-33,33,153100,152700,28519,-97919,-107819,OK
347.788125,TraderOne,Tick,1940,1963,-23,23,152500,152700,28366,-101766,-97166,OK
347.957217,TraderOne,Tick,1950,1963,-13,13,152800,152700,28672,-104072,-105372,OK
348.200246,TraderOne,Tick,1960,1963,-3,3,152000,152700,28978,-106378,-105478,OK
348.513923,TraderOne,Tick,1970,1963,7,-7,152700,152700,28825,-107225,-107225,OK
348.780883,TraderOne,Tick,1970,1963,7,-7,152700,152600,28825,-107225,-106525,OK
348.968194,TraderOne,Tick,1970,1963,7,-7,152700,152600,28825,-107225,-106525,OK
349.263247,TraderOne,Tick,1970,1963,7,-7,152700,152600,28825,-107225,-106525,OK
349.458371,TraderOne,Tick,1970,1963,7,-7,152700,152600,28825,-107225,-106525,OK
349.798117,TraderOne,Tick,1970,1963,7,-7,152700,152600,28825,-107225,-106525,OK
349.975937,TraderOne,Tick,1970,1963,7,-7,152700,152600,28825,-107225,-106525,OK
350.267044,TraderOne,Tick,1970,1963,7,-7,152700,152600,28825,-107225,-106525,OK
350.488209,TraderOne,Tick,1970,1963,7,-7,152700,152600,28825,-107225,-106525,OK
350.788162,TraderOne,Tick,1970,1963,7,-7,152700,152600,28825,-107225,-106525,OK
351.002266,TraderOne,Tick,1970,1963,7,-7,152700,152600,28825,-107225,-106525,OK
351.289211,TraderOne,Tick,1970,1963,7,-7,152700,152500,28825,-107225,-105825,OK
351.489552,TraderOne,Tick,1970,1963,7,-7,152700,152500,28825,-107225,-105825,OK
351.738696,TraderOne,Tick,1970,1973,-3,3,152700,152500,28673,-107073,-107673,OK
352.043798,TraderOne,Tick,1970,1983,-13,13,152700,152300,28978,-105378,-109278,OK
352.299483,TraderOne,Tick,1970,1993,-23,23,152700,152300,29283,-102683,-109583,OK
352.485113,TraderOne,Tick,1970,1993,-23,23,152700,152300,29283,-102683,-109583,OK
352.703319,TraderOne,Tick,1970,1993,-23,23,152700,152300,29283,-102683,-109583,OK
352.957528,TraderOne,Tick,1970,2003,-33,33,152700,152300,29588,-98988,-108888,OK
353.216202,TraderOne,Tick,1970,2013,-43,43,152700,152300,29893,-95293,-108193,OK
353.452327,TraderOne,Tick,1970,2013,-43,43,152700,152100,29893,-95293,-108193,OK
353.742933,TraderOne,Tick,1970,2013,-43,43,152700,152100,29893,-95293,-108193,OK
353.951941,TraderOne,Tick,1970,2013,-43,43,152700,152100,29893,-95293,-108193,OK
354.261956,TraderOne,Tick,1970,2013,-43,43,152700,152100,29893,-95293,-108193,OK
354.490415,TraderOne,Tick,1970,2013,-43,43,152700,152100,29893,-95293,-108193,OK
354.730744,TraderOne,Tick,1970,2013,-43,43,152700,152100,29893,-95293,-108193,OK
355.034802,TraderOne,Tick,1980,2013,-33,33,152800,152100,30199,-99599,-109499,OK
355.236175,TraderOne,Tick,1980,2013,-33,33,152800,152100,30199,-99599,-109499,OK
355.52252,TraderOne,Tick,1980,2013,-33,33,153000,152100,30199,-99599,-109499,OK
355.75904,TraderOne,Tick,1980,2013,-33,33,153000,152500,30199,-99599,-109499,OK
356.017471,TraderOne,Tick,1980,2013,-33,33,153000,152500,30199,-99599,-109499,OK
356.202732,TraderOne,Tick,1980,2013,-33,33,153000,152500,30199,-99599,-109499,OK
356.450528,TraderOne,Tick,1980,2013,-33,33,153000,152400,30199,-99599,-109499,OK
356.789799,TraderOne,Tick,1980,2013,-33,33,153000,152400,30199,-99599,-109499,OK
357.046366,TraderOne,Tick,1980,2013,-33,33,153000,152400,30199,-99599,-109499,OK
357.251549,TraderOne,Tick,1980,2013,-33,33,153000,152400,30199,-99599,-109499,OK
357.50414,TraderOne,Tick,1980,2023,-43,43,153000,152400,30046,-96446,-109346,OK
357.735108,TraderOne,Tick,1980,2023,-43,43,153000,152400,30046,-96446,-109346,OK
357.962686,TraderOne,Tick,1980,2023,-43,43,153000,152400,30046,-96446,-109346,OK
358.236892,TraderOne,Tick,1990,2023,-33,33,152700,152400,29893,-101293,-111193,OK
358.482058,TraderOne,Tick,1998,2023,-25,25,152600,152100,30137,-103937,-111437,OK
358.711717,TraderOne,Tick,1998,2023,-25,25,152600,152100,30137,-103937,-111437,OK
359.039879,TraderOne,Tick,1998,2033,-35,35,152800,152100,29985,-98785,-109285,OK
359.275055,TraderOne,Tick,1998,2033,-35,35,152800,152100,29985,-98785,-109285,OK
359.545934,TraderOne,Tick,1998,2033,-35,35,152800,152100,29985,-98785,-109285,OK
359.709005,TraderOne,Tick,1998,2033,-35,35,152800,151800,29985,-98785,-109285,OK
359.954209,TraderOne,Tick,1998,2043,-45,45,152300,151400,30290,-94090,-107590,OK
360.27394,TraderOne,Tick,2008,2043,-35,35,152100,151400,30138,-100938,-111438,OK
360.515636,TraderOne,Tick,2008,2043,-35,35,152100,151800,30138,-100938,-111438,OK
360.787068,TraderOne,Tick,2008,2053,-45,45,152400,152000,29986,-95786,-109286,OK
361.047097,TraderOne,Tick,2018,2053,-35,35,152400,152300,30291,-100091,-103591,OK
361.211792,TraderOne,Tick,2018,2053,-35,35,152400,152300,30291,-100091,-103591,OK
361.521579,TraderOne,Tick,2018,2053,-35,35,152400,152300,30291,-100091,-103591,OK
361.791473,TraderOne,Tick,2018,2053,-35,35,152400,152300,30291,-100091,-103591,OK
361.977978,TraderOne,Tick,2018,2053,-35,35,152400,152300,30291,-100091,-103591,OK
362.231617,TraderOne,Tick,2018,2072,-54,54,152400,152300,30002,-91202,-96602,OK
362.466653,TraderOne,Tick,2028,2072,-44,44,152500,152300,29850,-94050,-102850,OK
362.718284,TraderOne,Tick,2028,2072,-44,44,152500,152100,29850,-94050,-107250,OK
363.011648,TraderOne,Tick,2038,2072,-34,34,152500,152100,29698,-100898,-111098,OK
363.239322,TraderOne,Tick,2038,2072,-34,34,152500,152100,29698,-100898,-111098,OK
363.478016,TraderOne,Tick,2038,2072,-34,34,152500,152100,29698,-100898,-111098,OK
363.789747,TraderOne,Tick,2038,2072,-34,34,152500,152100,29698,-100898,-111098,OK
363.993775,TraderOne,Tick,2038,2072,-34,34,152500,152100,29698,-100898,-111098,OK
364.23245,TraderOne,Tick,2038,2082,-44,44,152200,152100,29546,-96746,-101146,OK
364.451423,TraderOne,Tick,2038,2082,-44,44,152200,152100,29546,-96746,-101146,OK
364.713042,TraderOne,Tick,2048,2082,-34,34,151900,152100,29394,-102594,-95794,OK
365.025829,TraderOne,Tick,2048,2092,-44,44,151800,152100,29698,-98898,-85698,OK
365.235713,TraderOne,Tick,2048,2092,-44,44,151800,152100,29698,-98898,-85698,OK
365.531276,TraderOne,Tick,2048,2092,-44,44,151800,152100,29698,-98898,-85698,OK
365.721992,TraderOne,Tick,2048,2092,-44,44,151800,152100,29698,-98898,-85698,OK
365.965529,TraderOne,Tick,2048,2102,-54,54,152200,152100,29546,-92746,-98146,OK
366.224571,TraderOne,Tick,2058,2102,-44,44,151900,152100,29394,-98594,-89794,OK
366.464496,TraderOne,Tick,2058,2102,-44,44,152000,151500,29394,-98594,-111794,OK
366.719203,TraderOne,Tick,2068,2102,-34,34,152000,151500,29698,-103898,-114098,OK
367.049884,TraderOne,Tick,2068,2102,-34,34,152000,151500,29698,-103898,-114098,OK
367.295567,TraderOne,Tick,2078,2112,-34,34,152100,151500,29394,-104594,-114794,OK
367.482072,TraderOne,Tick,2078,2112,-34,34,152100,151500,29394,-104594,-114794,OK
367.703082,TraderOne,Tick,2078,2112,-34,34,152100,151800,29394,-104594,-114794,OK
367.970716,TraderOne,Tick,2078,2112,-34,34,152100,151800,29394,-104594,-114794,OK
368.219938,TraderOne,Tick,2078,2112,-34,34,152100,151800,29394,-104594,-114794,OK
368.545603,TraderOne,Tick,2078,2112,-34,34,152100,151800,29394,-104594,-114794,OK
368.780658,TraderOne,Tick,2078,2112,-34,34,152100,151800,29394,-104594,-114794,OK
369.013567,TraderOne,Tick,2078,2122,-44,44,152100,151700,29698,-100898,-114098,OK
369.219785,TraderOne,Tick,2078,2122,-44,44,152100,151700,29698,-100898,-114098,OK
369.485778,TraderOne,Tick,2078,2122,-44,44,152100,151700,29698,-100898,-114098,OK
369.759606,TraderOne,Tick,2078,2122,-44,44,152100,151700,29698,-100898,-114098,OK
369.961246,TraderOne,Tick,2078,2122,-44,44,152100,152000,29698,-100898,-105298,OK
370.295285,TraderOne,Tick,2088,2122,-34,34,152400,152000,30003,-105203,-115403,OK
370.456492,TraderOne,Tick,2088,2122,-34,34,152400,152000,30003,-105203,-115403,OK
370.799127,TraderOne,Tick,2098,2122,-24,24,152400,152000,30308,-109508,-116708,OK
371.046867,TraderOne,Tick,2108,2122,-14,14,152400,152000,30613,-112813,-117013,OK
371.237686,TraderOne,Tick,2108,2122,-14,14,152400,152000,30613,-112813,-117013,OK
371.452276,TraderOne,Tick,2108,2122,-14,14,152400,152000,30613,-112813,-117013,OK
371.737038,TraderOne,Tick,2108,2122,-14,14,152400,152000,30613,-112813,-117013,OK
372.043455,TraderOne,Tick,2118,2122,-4,4,152100,152000,30461,-113661,-114061,OK
372.223894,TraderOne,Tick,2128,2122,6,-6,151900,152000,30765,-111965,-112565,OK
372.482794,TraderOne,Tick,2138,2122,16,-16,151900,152000,31069,-111269,-112869,OK
372.761863,TraderOne,Tick,2148,2122,26,-26,151900,152000,31373,-110573,-113173,OK
373.025361,TraderOne,Tick,2148,2122,26,-26,151900,152000,31373,-110573,-113173,OK
373.274365,TraderOne,Tick,2148,2130,18,-18,151900,152000,31251,-111251,-113051,OK
373.545933,TraderOne,Tick,2148,2130,18,-18,151900,152000,31251,-111251,-113051,OK
373.734821,TraderOne,Tick,2148,2130,18,-18,151900,152000,31251,-111251,-113051,OK
374.000259,TraderOne,Tick,2148,2130,18,-18,151900,152000,31251,-111251,-113051,OK
374.279466,TraderOne,Tick,2148,2130,18,-18,151900,152000,31251,-111251,-113051,OK
374.497133,TraderOne,Tick,2148,2130,18,-18,151900,152000,31251,-111251,-113051,OK
374.73554,TraderOne,Tick,2148,2130,18,-18,151900,152000,31251,-111251,-113051,OK
374.971168,TraderOne,Tick,2148,2130,18,-18,151900,152000,31251,-111251,-113051,OK
375.225576,TraderOne,Tick,2148,2130,18,-18,151900,152000,31251,-111251,-113051,OK
375.549211,TraderOne,Tick,2148,2140,8,-8,152400,152000,31099,-111099,-108699,OK
375.725297,TraderOne,Tick,2148,2140,8,-8,152400,152000,31099,-111099,-108699,OK
376.006632,TraderOne,Tick,2148,2140,8,-8,152400,152000,31099,-111099,-108699,OK
376.252474,TraderOne,Tick,2148,2140,8,-8,152400,152000,31099,-111099,-108699,OK
376.530877,TraderOne,Tick,2148,2140,8,-8,152400,152000,31099,-111099,-108699,OK
376.731861,TraderOne,Tick,2148,2140,8,-8,152400,152000,31099,-111099,-108699,OK
376.960727,TraderOne,Tick,2158,2140,18,-18,151900,152000,30947,-111947,-113747,OK
377.239748,TraderOne,Tick,2158,2140,18,-18,151900,152000,30947,-111947,-113747,OK
377.515277,TraderOne,Tick,2158,2140,18,-18,151900,152300,30947,-111947,-117347,OK
377.704166,TraderOne,Tick,2158,2140,18,-18,151900,152300,30947,-111947,-117347,OK
377.953184,TraderOne,Tick,2158,2140,18,-18,151900,152300,30947,-111947,-117347,OK
378.241295,TraderOne,Tick,2158,2150,8,-8,152800,152300,30795,-112795,-110395,OK
378.52479,TraderOne,Tick,2168,2150,18,-18,151800,152300,30643,-112643,-118043,OK
378.740761,TraderOne,Tick,2168,2160,8,-8,152200,152300,30491,-113491,-114291,OK
379.016468,TraderOne,Tick,2178,2170,8,-8,151800,152300,30644,-109644,-112044,OK
379.24569,TraderOne,Tick,2178,2170,8,-8,151800,152300,30644,-109644,-112044,OK
379.471771,TraderOne,Tick,2178,2170,8,-8,151800,152300,30644,-109644,-112044,OK
379.743346,TraderOne,Tick,2178,2170,8,-8,151800,152300,30644,-109644,-112044,OK
379.953479,TraderOne,Tick,2178,2170,8,-8,151800,152300,30644,-109644,-112044,OK
380.203527,TraderOne,Tick,2186,2170,16,-16,152100,152300,30522,-109522,-112722,OK
380.492364,TraderOne,Tick,2186,2170,16,-16,152100,152300,30522,-109522,-112722,OK
380.755898,TraderOne,Tick,2196,2170,26,-26,151800,152300,30370,-108370,-116170,OK
380.986654,TraderOne,Tick,2196,2170,26,-26,151800,152300,30370,-108370,-116170,OK
381.250128,TraderOne,Tick,2196,2170,26,-26,151800,152300,30370,-108370,-116170,OK
381.53939,TraderOne,Tick,2196,2170,26,-26,151800,152300,30370,-108370,-116170,OK
381.705809,TraderOne,Tick,2196,2180,16,-16,152900,152300,30218,-110218,-105418,OK
381.979617,TraderOne,Tick,2203,2180,23,-23,152300,152500,30111,-109411,-114011,OK
382.262092,TraderOne,Tick,2203,2180,23,-23,152300,152500,30111,-109411,-114011,OK
382.507588,TraderOne,Tick,2203,2180,23,-23,152300,152500,30111,-109411,-114011,OK
382.744336,TraderOne,Tick,2203,2180,23,-23,152300,152500,30111,-109411,-114011,OK
382.957882,TraderOne,Tick,2203,2180,23,-23,152300,152500,30111,-109411,-114011,OK
383.244554,TraderOne,Tick,2203,2180,23,-23,152300,152500,30111,-109411,-114011,OK
383.504077,TraderOne,Tick,2203,2190,13,-13,152900,152500,29959,-113259,-109359,OK
383.779457,TraderOne,Tick,2203,2200,3,-3,152900,152500,30265,-110565,-109665,OK
384.025879,TraderOne,Tick,2203,2207,-4,4,152900,152500,30479,-109379,-110579,OK
384.259319,TraderOne,Tick,2203,2207,-4,4,152900,152500,30479,-109379,-110579,OK
384.504471,TraderOne,Tick,2203,2207,-4,4,152900,152500,30479,-109379,-110579,OK
384.707445,TraderOne,Tick,2203,2207,-4,4,152900,152500,30479,-109379,-110579,OK
385.006717,TraderOne,Tick,2203,2207,-4,4,152900,152500,30479,-109379,-110579,OK
385.239082,TraderOne,Tick,2203,2207,-4,4,152900,152500,30479,-109379,-110579,OK
385.515459,TraderOne,Tick,2213,2207,6,-6,152200,152500,30326,-110226,-112026,OK
385.741345,TraderOne,Tick,2213,2207,6,-6,152200,152500,30326,-110226,-112026,OK
386.045673,TraderOne,Tick,2213,2207,6,-6,152200,152500,30326,-110226,-112026,OK
386.265185,TraderOne,Tick,2213,2207,6,-6,152200,152500,30326,-110226,-112026,OK
386.512169,TraderOne,Tick,2223,2207,16,-16,151800,152500,30174,-110074,-114874,OK
386.775896,TraderOne,Tick,2223,2207,16,-16,151800,152500,30174,-110074,-114874,OK
386.985512,TraderOne,Tick,2223,2207,16,-16,151800,152500,30174,-110074,-114874,OK
387.214405,TraderOne,Tick,2223,2207,16,-16,151800,152300,30174,-110074,-114874,OK
387.473906,TraderOne,Tick,2223,2217,6,-6,152900,152300,30022,-109922,-108122,OK
387.735524,TraderOne,Tick,2223,2217,6,-6,152900,152300,30022,-109922,-108122,OK
387.968024,TraderOne,Tick,2223,2217,6,-6,152900,152300,30022,-109922,-108122,OK
388.245989,TraderOne,Tick,2223,2217,6,-6,152900,152300,30022,-109922,-108122,OK
388.507558,TraderOne,Tick,2233,2217,16,-16,151700,152200,29870,-108770,-113570,OK
388.724499,TraderOne,Tick,2233,2217,16,-16,151700,152200,29870,-108770,-113570,OK
389.025203,TraderOne,Tick,2233,2217,16,-16,151700,152200,29870,-108770,-113570,OK
389.255762,TraderOne,Tick,2233,2227,6,-6,152900,152400,29718,-110618,-108818,OK
389.532963,TraderOne,Tick,2233,2227,6,-6,152900,152400,29718,-110618,-108818,OK
389.718671,TraderOne,Tick,2233,2227,6,-6,152900,152400,29718,-110618,-108818,OK
390.023783,TraderOne,Tick,2233,2227,6,-6,152900,152200,29718,-110618,-108818,OK
390.236352,TraderOne,Tick,2233,2227,6,-6,152900,152200,29718,-110618,-108818,OK
390.490288,TraderOne,Tick,2233,2227,6,-6,152900,152200,29718,-110618,-108818,OK
390.717238,TraderOne,Tick,2233,2227,6,-6,152900,152100,29718,-110618,-108818,OK
390.951846,TraderOne,Tick,2233,2227,6,-6,152900,152100,29718,-110618,-108818,OK
391.268344,TraderOne,Tick,2233,2227,6,-6,152900,152100,29718,-110618,-108818,OK
391.497377,TraderOne,Tick,2233,2227,6,-6,152900,152100,29718,-110618,-108818,OK
391.704627,TraderOne,Tick,2233,2227,6,-6,152900,152100,29718,-110618,-108818,OK
391.965262,TraderOne,Tick,2233,2227,6,-6,152900,152100,29718,-110618,-108818,OK
392.278634,TraderOne,Tick,2233,2227,6,-6,152900,152100,29718,-110618,-108818,OK
392.463367,TraderOne,Tick,2233,2227,6,-6,152900,152100,29718,-110618,-108818,OK
392.783877,TraderOne,Tick,2233,2227,6,-6,152900,152100,29718,-110618,-108818,OK
393.005459,TraderOne,Tick,2233,2237,-4,4,152300,152100,29566,-110466,-111266,OK
393.223165,TraderOne,Tick,2233,2247,-14,14,152700,152200,29871,-106771,-110971,OK
393.492503,TraderOne,Tick,2233,2257,-24,24,152700,152200,30176,-104076,-111276,OK
393.80009,TraderOne,Tick,2233,2257,-24,24,152700,152500,30176,-104076,-108876,OK
394.02814,TraderOne,Tick,2233,2257,-24,24,152700,152500,30176,-104076,-108876,OK
394.241369,TraderOne,Tick,2233,2257,-24,24,152700,152400,30176,-104076,-111276,OK
394.538346,TraderOne,Tick,2233,2267,-34,34,152700,152400,30481,-101381,-111581,OK
394.792079,TraderOne,Tick,2233,2267,-34,34,152700,152400,30481,-101381,-111581,OK
395.001025,TraderOne,Tick,2243,2277,-34,34,152900,152400,30176,-100076,-110276,OK
395.271915,TraderOne,Tick,2243,2277,-34,34,152900,152400,30176,-100076,-110276,OK
395.490983,TraderOne,Tick,2243,2277,-34,34,152900,152400,30176,-100076,-110276,OK
395.785025,TraderOne,Tick,2253,2277,-24,24,152600,152300,30023,-103923,-111123,OK
395.983156,TraderOne,Tick,2263,2277,-14,14,151900,152300,30327,-101227,-97027,OK
396.267613,TraderOne,Tick,2263,2277,-14,14,151900,152300,30327,-101227,-97027,OK
396.465638,TraderOne,Tick,2263,2277,-14,14,151900,152300,30327,-101227,-97027,OK
396.759929,TraderOne,Tick,2263,2277,-14,14,151900,152300,30327,-101227,-97027,OK
397.025171,TraderOne,Tick,2263,2277,-14,14,151900,151700,30327,-101227,-104027,OK
397.279381,TraderOne,Tick,2263,2277,-14,14,151900,151400,30327,-101227,-105427,OK
397.480926,TraderOne,Tick,2263,2287,-24,24,151900,151400,30631,-96531,-103731,OK
397.702567,TraderOne,Tick,2263,2297,-34,34,151800,151400,30935,-92835,-103035,OK
397.962903,TraderOne,Tick,2263,2304,-41,41,151800,151400,31148,-89548,-101848,OK
398.253394,TraderOne,Tick,2263,2304,-41,41,151800,151400,31148,-89548,-101848,OK
398.462638,TraderOne,Tick,2273,2304,-31,31,151600,151100,30996,-95396,-104696,OK
398.783155,TraderOne,Tick,2273,2304,-31,31,151600,151100,30996,-95396,-104696,OK
398.955927,TraderOne,Tick,2273,2304,-31,31,151600,151100,30996,-95396,-104696,OK
399.225567,TraderOne,Tick,2273,2304,-31,31,151600,151200,30996,-95396,-104696,OK
399.521587,TraderOne,Tick,2273,2304,-31,31,151600,151200,30996,-95396,-104696,OK
399.781287,TraderOne,Tick,2273,2304,-31,31,151400,151200,30996,-95396,-101596,OK
399.994878,TraderOne,Tick,2283,2304,-21,21,151400,151200,30844,-99244,-103444,OK
400.281637,TraderOne,Tick,2283,2304,-21,21,151400,151200,30844,-99244,-103444,OK
400.548161,TraderOne,Tick,2283,2304,-21,21,151400,151200,30844,-99244,-103444,OK
400.72228,TraderOne,Tick,2283,2304,-21,21,151400,151000,30844,-99244,-105544,OK
400.988638,TraderOne,Tick,2283,2314,-31,31,151400,151000,31147,-96547,-105847,OK
401.238152,TraderOne,Tick,2283,2314,-31,31,151300,151000,31147,-96547,-105847,OK
401.455079,TraderOne,Tick,2283,2314,-31,31,151300,151000,31147,-96547,-105847,OK
401.791817,TraderOne,Tick,2283,2314,-31,31,151300,151000,31147,-96547,-105847,OK
402.023263,TraderOne,Tick,2283,2314,-31,31,151300,151000,31147,-96547,-105847,OK
402.226225,TraderOne,Tick,2283,2314,-31,31,151300,150900,31147,-96547,-105847,OK
402.45721,TraderOne,Tick,2283,2314,-31,31,151400,150900,31147,-96547,-105847,OK
402.713504,TraderOne,Tick,2283,2324,-41,41,151300,150900,31450,-92850,-105150,OK
403.02656,TraderOne,Tick,2283,2324,-41,41,151300,150900,31450,-92850,-105150,OK
403.283961,TraderOne,Tick,2283,2324,-41,41,151400,150900,31450,-92850,-105150,OK
403.525611,TraderOne,Tick,2283,2324,-41,41,151400,150900,31450,-92850,-105150,OK
403.709231,TraderOne,Tick,2283,2324,-41,41,151400,150900,31450,-92850,-105150,OK
404.048215,TraderOne,Tick,2283,2324,-41,41,151400,150900,31450,-92850,-105150,OK
404.275066,TraderOne,Tick,2283,2324,-41,41,151400,150900,31450,-92850,-105150,OK
404.520359,TraderOne,Tick,2283,2324,-41,41,151400,150900,31450,-92850,-105150,OK
404.744098,TraderOne,Tick,2283,2324,-41,41,151400,150900,31450,-92850,-105150,OK
405.020305,TraderOne,Tick,2283,2324,-41,41,151400,150900,31450,-92850,-105150,OK
405.263525,TraderOne,Tick,2283,2324,-41,41,151400,150900,31450,-92850,-105150,OK
405.545144,TraderOne,Tick,2283,2324,-41,41,151300,151000,31450,-92850,-105150,OK
405.769878,TraderOne,Tick,2283,2324,-41,41,151300,151000,31450,-92850,-105150,OK
405.961947,TraderOne,Tick,2283,2324,-41,41,151300,151000,31450,-92850,-105150,OK
406.201433,TraderOne,Tick,2283,2324,-41,41,151300,151000,31450,-92850,-105150,OK
406.4544,TraderOne,Tick,2283,2324,-41,41,151300,151000,31450,-92850,-105150,OK
406.735964,TraderOne,Tick,2283,2324,-41,41,151300,151000,31450,-92850,-105150,OK
406.956791,TraderOne,Tick,2283,2324,-41,41,151400,151000,31450,-92850,-105150,OK
407.212408,TraderOne,Tick,2283,2324,-41,41,151400,151000,31450,-92850,-105150,OK
407.465844,TraderOne,Tick,2283,2324,-41,41,151200,151000,31450,-92850,-101050,OK
407.733253,TraderOne,Tick,2283,2334,-51,51,151200,150500,31752,-88152,-103452,OK
407.992816,TraderOne,Tick,2283,2334,-51,51,151100,150500,31752,-88152,-103452,OK
408.287387,TraderOne,Tick,2283,2344,-61,61,151000,150500,32054,-82454,-100754,OK
408.453578,TraderOne,Tick,2283,2344,-61,61,151000,150500,32054,-82454,-100754,OK
408.751498,TraderOne,Tick,2293,2344,-51,51,150900,150500,31903,-89303,-104603,OK
408.974797,TraderOne,Tick,2293,2354,-61,61,150700,150500,32205,-83605,-95805,OK
409.283265,TraderOne,Tick,2303,2354,-51,51,150700,150500,32506,-89906,-100106,OK
409.539074,TraderOne,Tick,2303,2354,-51,51,150700,150500,32506,-89906,-100106,OK
409.748243,TraderOne,Tick,2313,2354,-41,41,150600,150000,32355,-96755,-109055,OK
409.95698,TraderOne,Tick,2313,2354,-41,41,150600,150000,32355,-96755,-109055,OK
410.271072,TraderOne,Tick,2313,2364,-51,51,150600,150000,32204,-92604,-107904,OK
410.518765,TraderOne,Tick,2313,2364,-51,51,150600,150000,32204,-92604,-107904,OK
410.735691,TraderOne,Tick,2313,2364,-51,51,150600,150000,32204,-92604,-107904,OK
410.952891,TraderOne,Tick,2313,2364,-51,51,150600,149900,32204,-92604,-107904,OK
411.276532,TraderOne,Tick,2313,2364,-51,51,150600,149900,32204,-92604,-107904,OK
411.544374,TraderOne,Tick,2323,2364,-41,41,150200,150000,32054,-98454,-106654,OK
411.749866,TraderOne,Tick,2323,2364,-41,41,150200,150100,32054,-98454,-102554,OK
412.020509,TraderOne,Tick,2323,2364,-41,41,150200,150100,32054,-98454,-102554,OK
412.279316,TraderOne,Tick,2333,2364,-31,31,150200,150100,31904,-103304,-106404,OK
412.516927,TraderOne,Tick,2343,2374,-31,31,150500,150100,31604,-103004,-112304,OK
412.739201,TraderOne,Tick,2343,2374,-31,31,150500,150000,31604,-103004,-112304,OK
412.951595,TraderOne,Tick,2343,2374,-31,31,150500,150000,31604,-103004,-112304,OK
413.248111,TraderOne,Tick,2343,2374,-31,31,150500,150000,31604,-103004,-112304,OK
413.459598,TraderOne,Tick,2343,2384,-41,41,150500,150000,31454,-98854,-111154,OK
413.788417,TraderOne,Tick,2343,2384,-41,41,150500,150000,31454,-98854,-111154,OK
413.964671,TraderOne,Tick,2343,2384,-41,41,150500,150000,31454,-98854,-111154,OK
414.255803,TraderOne,Tick,2353,2384,-31,31,150400,150000,31304,-105704,-115004,OK
414.451606,TraderOne,Tick,2353,2384,-31,31,150400,150000,31304,-105704,-115004,OK
414.724947,TraderOne,Tick,2353,2384,-31,31,150400,150000,31304,-105704,-115004,OK
414.973523,TraderOne,Tick,2363,2384,-21,21,150000,150000,31154,-108554,-108554,OK
415.222118,TraderOne,Tick,2373,2384,-11,11,150300,150000,31004,-112404,-115704,OK
415.487871,TraderOne,Tick,2373,2384,-11,11,150300,150000,31004,-112404,-115704,OK
415.73555,TraderOne,Tick,2383,2384,-1,1,150200,150000,31304,-114704,-114904,OK
415.989828,TraderOne,Tick,2383,2384,-1,1,150200,150000,31304,-114704,-114904,OK
416.234718,TraderOne,Tick,2383,2384,-1,1,150200,150000,31304,-114704,-114904,OK
416.476016,TraderOne,Tick,2383,2384,-1,1,150200,150000,31304,-114704,-114904,OK
416.758441,TraderOne,Tick,2383,2384,-1,1,150200,150000,31304,-114704,-114904,OK
417.024904,TraderOne,Tick,2383,2394,-11,11,150700,150000,31154,-113554,-116854,OK
417.232187,TraderOne,Tick,2383,2394,-11,11,150700,150000,31154,-113554,-116854,OK
417.550629,TraderOne,Tick,2383,2394,-11,11,150700,150000,31154,-113554,-116854,OK
417.745609,TraderOne,Tick,2383,2394,-11,11,150700,150000,31154,-113554,-116854,OK
418.014737,TraderOne,Tick,2383,2394,-11,11,150700,150000,31154,-113554,-116854,OK
418.228496,TraderOne,Tick,2383,2394,-11,11,150700,150000,31154,-113554,-116854,OK
418.454529,TraderOne,Tick,2383,2394,-11,11,150700,150200,31154,-113554,-116854,OK
418.774737,TraderOne,Tick,2383,2394,-11,11,150700,150300,31154,-113554,-116854,OK
419.011165,TraderOne,Tick,2383,2394,-11,11,150700,150300,31154,-113554,-116854,OK
419.298417,TraderOne,Tick,2383,2394,-11,11,150700,150300,31154,-113554,-116854,OK
419.469197,TraderOne,Tick,2383,2394,-11,11,150700,150300,31154,-113554,-116854,OK
419.792831,TraderOne,Tick,2383,2394,-11,11,150700,150300,31154,-113554,-116854,OK
419.981243,TraderOne,Tick,2383,2394,-11,11,150700,150300,31154,-113554,-116854,OK
420.275818,TraderOne,Tick,2383,2394,-11,11,150700,150300,31154,-113554,-116854,OK
420.522899,TraderOne,Tick,2383,2394,-11,11,150700,150300,31154,-113554,-116854,OK
420.776555,TraderOne,Tick,2383,2394,-11,11,150700,150300,31154,-113554,-116854,OK
421.000113,TraderOne,Tick,2383,2394,-11,11,150700,150300,31154,-113554,-116854,OK
421.219415,TraderOne,Tick,2383,2394,-11,11,150700,150300,31154,-113554,-116854,OK
421.502769,TraderOne,Tick,2383,2394,-11,11,150700,150000,31154,-113554,-116854,OK
421.732295,TraderOne,Tick,2383,2394,-11,11,150700,149900,31154,-113554,-116854,OK
422.033736,TraderOne,Tick,2383,2394,-11,11,150000,149900,31154,-113554,-114654,OK
422.214347,TraderOne,Tick,2383,2394,-11,11,150000,149900,31154,-113554,-114654,OK
422.476489,TraderOne,Tick,2383,2394,-11,11,150000,149900,31154,-113554,-114654,OK
422.795381,TraderOne,Tick,2383,2394,-11,11,150000,149900,31154,-113554,-114654,OK
422.965906,TraderOne,Tick,2383,2394,-11,11,150000,149900,31154,-113554,-114654,OK
423.246972,TraderOne,Tick,2383,2394,-11,11,150000,149900,31154,-113554,-114654,OK
423.541534,TraderOne,Tick,2383,2394,-11,11,150000,149900,31154,-113554,-114654,OK
423.765507,TraderOne,Tick,2383,2404,-21,21,150500,149900,31004,-111404,-117704,OK
423.996022,TraderOne,Tick,2383,2404,-21,21,150500,149900,31004,-111404,-117704,OK
424.216197,TraderOne,Tick,2383,2404,-21,21,150500,149900,31004,-111404,-117704,OK
424.546841,TraderOne,Tick,2383,2404,-21,21,150000,149900,31004,-111404,-113504,OK
424.758284,TraderOne,Tick,2383,2404,-21,21,150000,149900,31004,-111404,-113504,OK
425.04093,TraderOne,Tick,2383,2412,-29,29,150000,149500,31244,-110044,-115844,OK
425.217055,TraderOne,Tick,2383,2412,-29,29,150000,149500,31244,-110044,-115844,OK
425.451215,TraderOne,Tick,2383,2414,-31,31,149900,149500,31214,-109414,-115614,OK
425.744701,TraderOne,Tick,2383,2414,-31,31,149900,149700,31214,-109414,-115614,OK
426.012337,TraderOne,Tick,2393,2414,-21,21,150100,149700,31514,-113714,-117914,OK
426.298451,TraderOne,Tick,2393,2414,-21,21,150100,149800,31514,-113714,-120014,OK
426.472618,TraderOne,Tick,2393,2414,-21,21,150100,149800,31514,-113714,-120014,OK
426.764444,TraderOne,Tick,2399,2414,-15,15,150000,149800,31424,-114824,-117824,OK
427.02536,TraderOne,Tick,2399,2414,-15,15,150100,149800,31424,-114824,-119324,OK
427.280869,TraderOne,Tick,2399,2414,-15,15,150100,149800,31424,-114824,-119324,OK
427.525108,TraderOne,Tick,2399,2414,-15,15,150100,149800,31424,-114824,-119324,OK
427.703986,TraderOne,Tick,2399,2414,-15,15,150100,149800,31424,-114824,-119324,OK
428.040691,TraderOne,Tick,2399,2414,-15,15,150100,149800,31424,-114824,-119324,OK
428.261097,TraderOne,Tick,2399,2424,-25,25,150400,149800,31274,-112674,-120174,OK
428.541893,TraderOne,Tick,2399,2424,-25,25,150400,149800,31274,-112674,-120174,OK
428.727956,TraderOne,Tick,2409,2424,-15,15,149900,149800,31124,-117524,-119024,OK
428.985837,TraderOne,Tick,2409,2424,-15,15,149900,149800,31124,-117524,-119024,OK
429.268727,TraderOne,Tick,2409,2424,-15,15,149900,149800,31124,-117524,-119024,OK
429.513484,TraderOne,Tick,2409,2424,-15,15,149900,149800,31124,-117524,-119024,OK
429.800343,TraderOne,Tick,2409,2424,-15,15,149900,149800,31124,-117524,-119024,OK
429.96085,TraderOne,Tick,2409,2424,-15,15,149900,149800,31124,-117524,-119024,OK
430.201587,TraderOne,Tick,2409,2430,-21,21,149900,149600,31304,-116504,-120704,OK
430.521398,TraderOne,Tick,2409,2434,-25,25,149800,149600,31244,-115244,-120244,OK
430.744978,TraderOne,Tick,2409,2434,-25,25,149800,149600,31244,-115244,-120244,OK
430.988912,TraderOne,Tick,2409,2434,-25,25,149800,149600,31244,-115244,-120244,OK
431.225066,TraderOne,Tick,2409,2434,-25,25,149800,149600,31244,-115244,-120244,OK
431.490523,TraderOne,Tick,2409,2434,-25,25,149800,149600,31244,-115244,-120244,OK
431.72934,TraderOne,Tick,2409,2434,-25,25,149800,149700,31244,-115244,-117744,OK
431.96549,TraderOne,Tick,2409,2434,-25,25,149800,149700,31244,-115244,-117744,OK
432.29041,TraderOne,Tick,2412,2434,-22,22,149900,149700,31199,-116099,-120499,OK
432.466692,TraderOne,Tick,2412,2434,-22,22,149900,149700,31199,-116099,-120499,OK
432.725498,TraderOne,Tick,2412,2444,-32,32,149800,149700,31499,-112399,-115599,OK
433.006763,TraderOne,Tick,2412,2454,-42,42,149800,149500,31799,-108699,-117099,OK
433.225357,TraderOne,Tick,2412,2454,-42,42,149800,149500,31799,-108699,-117099,OK
433.499443,TraderOne,Tick,2412,2454,-42,42,149800,149500,31799,-108699,-117099,OK
433.717369,TraderOne,Tick,2412,2454,-42,42,149800,149500,31799,-108699,-117099,OK
434.024118,TraderOne,Tick,2422,2454,-32,32,149800,149300,31649,-116549,-122949,OK
434.234788,TraderOne,Tick,2422,2464,-42,42,149600,149300,31948,-111848,-120248,OK
434.508377,TraderOne,Tick,2422,2464,-42,42,149600,149000,31948,-111848,-120248,OK
434.791047,TraderOne,Tick,2422,2464,-42,42,149600,149000,31948,-111848,-120248,OK
434.991019,TraderOne,Tick,2422,2464,-42,42,149600,149000,31948,-111848,-120248,OK
435.273128,TraderOne,Tick,2422,2464,-42,42,149600,149300,31948,-111848,-120248,OK
435.452372,TraderOne,Tick,2422,2464,-42,42,149600,149300,31948,-111848,-120248,OK
435.720158,TraderOne,Tick,2422,2464,-42,42,149600,149300,31948,-111848,-120248,OK
436.014658,TraderOne,Tick,2422,2464,-42,42,149600,149300,31948,-111848,-120248,OK
436.254819,TraderOne,Tick,2422,2464,-42,42,149600,149300,31948,-111848,-120248,OK
436.538878,TraderOne,Tick,2422,2464,-42,42,149600,149300,31948,-111848,-120248,OK
436.754156,TraderOne,Tick,2422,2464,-42,42,149600,149300,31948,-111848,-120248,OK
437.029579,TraderOne,Tick,2422,2464,-42,42,149600,149300,31948,-111848,-120248,OK
437.204615,TraderOne,Tick,2422,2464,-42,42,149600,149300,31948,-111848,-120248,OK
437.46661,TraderOne,Tick,2422,2464,-42,42,149600,149300,31948,-111848,-120248,OK
437.745307,TraderOne,Tick,2422,2464,-42,42,149600,149300,31948,-111848,-120248,OK
437.988176,TraderOne,Tick,2422,2464,-42,42,149600,149300,31948,-111848,-120248,OK
438.295135,TraderOne,Tick,2422,2464,-42,42,149600,149300,31948,-111848,-120248,OK
438.484675,TraderOne,Tick,2432,2464,-32,32,149400,149300,31798,-116698,-119898,OK
438.705665,TraderOne,Tick,2432,2464,-32,32,149400,149300,31798,-116698,-119898,OK
439.010359,TraderOne,Tick,2432,2464,-32,32,149400,149500,31798,-116698,-113498,OK
439.253244,TraderOne,Tick,2442,2464,-22,22,149800,149500,31648,-120548,-124948,OK
439.541098,TraderOne,Tick,2452,2464,-12,12,149700,149500,31947,-123847,-126247,OK
439.717764,TraderOne,Tick,2452,2464,-12,12,149700,149500,31947,-123847,-126247,OK
439.989448,TraderOne,Tick,2452,2464,-12,12,149700,149300,31947,-123847,-126247,OK
440.250597,TraderOne,Tick,2452,2464,-12,12,149700,149300,31947,-123847,-126247,OK
440.487306,TraderOne,Tick,2452,2464,-12,12,149700,149300,31947,-123847,-126247,OK
440.756519,TraderOne,Tick,2452,2464,-12,12,149700,149300,31947,-123847,-126247,OK
441.04586,TraderOne,Tick,2462,2464,-2,2,149700,149700,32246,-126146,-126146,OK
441.270279,TraderOne,Tick,2472,2464,8,-8,149700,149700,32545,-127445,-127445,OK
441.458458,TraderOne,Tick,2472,2464,8,-8,149700,149700,32545,-127445,-127445,OK
441.781841,TraderOne,Tick,2472,2464,8,-8,149700,149700,32545,-127445,-127445,OK
441.998338,TraderOne,Tick,2472,2474,-2,2,149400,149700,32844,-127744,-127344,OK
442.206554,TraderOne,Tick,2472,2474,-2,2,149400,149700,32844,-127744,-127344,OK
442.517364,TraderOne,Tick,2472,2474,-2,2,149400,149700,32844,-127744,-127344,OK
442.783197,TraderOne,Tick,2472,2474,-2,2,149400,149700,32844,-127744,-127344,OK
443.00484,TraderOne,Tick,2472,2474,-2,2,149400,149700,32844,-127744,-127344,OK
443.219361,TraderOne,Tick,2472,2474,-2,2,149400,149700,32844,-127744,-127344,OK
443.471439,TraderOne,Tick,2472,2474,-2,2,149400,149700,32844,-127744,-127344,OK
443.797979,TraderOne,Tick,2472,2484,-12,12,149300,149700,33143,-127043,-124643,OK
443.987925,TraderOne,Tick,2472,2484,-12,12,149300,149700,33143,-127043,-124643,OK
444.298434,TraderOne,Tick,2472,2484,-12,12,149300,149700,33143,-127043,-124643,OK
444.49539,TraderOne,Tick,2472,2484,-12,12,149300,149200,33143,-127043,-128243,OK
444.748227,TraderOne,Tick,2472,2484,-12,12,149300,149200,33143,-127043,-128243,OK
445.030688,TraderOne,Tick,2472,2484,-12,12,149300,149200,33143,-127043,-128243,OK
445.246728,TraderOne,Tick,2472,2484,-12,12,149300,149300,33143,-127043,-127043,OK
445.472507,TraderOne,Tick,2472,2484,-12,12,149300,149300,33143,-127043,-127043,OK
445.727108,TraderOne,Tick,2472,2484,-12,12,149300,149300,33143,-127043,-127043,OK
445.970146,TraderOne,Tick,2472,2484,-12,12,149300,149300,33143,-127043,-127043,OK
446.213227,TraderOne,Tick,2472,2484,-12,12,149300,149300,33143,-127043,-127043,OK
446.459523,TraderOne,Tick,2472,2484,-12,12,149300,149300,33143,-127043,-127043,OK
446.774658,TraderOne,Tick,2472,2494,-22,22,149300,148900,33442,-123342,-127742,OK
446.986892,TraderOne,Tick,2472,2494,-22,22,149300,148900,33442,-123342,-127742,OK
447.247154,TraderOne,Tick,2472,2494,-22,22,149300,148900,33442,-123342,-127742,OK
447.457459,TraderOne,Tick,2472,2494,-22,22,149300,148900,33442,-123342,-127742,OK
447.774077,TraderOne,Tick,2472,2504,-32,32,149300,148900,33741,-120641,-127041,OK
447.960419,TraderOne,Tick,2472,2514,-42,42,149300,148900,34040,-116940,-125340,OK
448.238218,TraderOne,Tick,2472,2514,-42,42,149300,148900,34040,-116940,-125340,OK
448.492777,TraderOne,Tick,2472,2514,-42,42,149300,148900,34040,-116940,-125340,OK
448.73121,TraderOne,Tick,2472,2514,-42,42,149300,148900,34040,-116940,-125340,OK
448.951945,TraderOne,Tick,2472,2514,-42,42,149300,149000,34040,-116940,-125340,OK
449.267637,TraderOne,Tick,2472,2514,-42,42,149300,149000,34040,-116940,-125340,OK
449.453747,TraderOne,Tick,2472,2514,-42,42,149300,149000,34040,-116940,-125340,OK
449.723684,TraderOne,Tick,2482,2514,-32,32,149600,149000,34339,-122239,-128639,OK
449.971194,TraderOne,Tick,2482,2514,-32,32,149600,149000,34339,-122239,-128639,OK
450.203584,TraderOne,Tick,2482,2514,-32,32,149600,149000,34339,-122239,-128639,OK
450.505363,TraderOne,Tick,2486,2514,-28,28,149500,149000,34279,-123779,-129379,OK
450.755509,TraderOne,Tick,2486,2524,-38,38,149500,149000,34129,-120629,-128229,OK
451.040426,TraderOne,Tick,2486,2534,-48,48,149600,149000,34428,-116928,-126528,OK
451.217322,TraderOne,Tick,2486,2534,-48,48,149600,149000,34428,-116928,-126528,OK
451.49917,TraderOne,Tick,2486,2534,-48,48,149700,149000,34428,-116928,-126528,OK
451.767433,TraderOne,Tick,2496,2534,-38,38,149100,149200,34278,-121778,-117978,OK
451.965239,TraderOne,Tick,2504,2534,-30,30,149700,149200,34518,-124418,-130418,OK
452.256061,TraderOne,Tick,2504,2534,-30,30,149700,149200,34518,-124418,-130418,OK
452.502389,TraderOne,Tick,2504,2534,-30,30,149700,149300,34518,-124418,-130418,OK
452.781138,TraderOne,Tick,2504,2534,-30,30,149700,149300,34518,-124418,-130418,OK
452.990898,TraderOne,Tick,2504,2544,-40,40,149800,149300,34368,-121268,-129268,OK
453.245161,TraderOne,Tick,2504,2544,-40,40,149800,149300,34368,-121268,-129268,OK
453.459523,TraderOne,Tick,2504,2544,-40,40,149800,149300,34368,-121268,-129268,OK
453.745581,TraderOne,Tick,2504,2544,-40,40,149800,149300,34368,-121268,-129268,OK
453.988201,TraderOne,Tick,2504,2544,-40,40,149800,149300,34368,-121268,-129268,OK
454.278101,TraderOne,Tick,2504,2544,-40,40,149800,149300,34368,-121268,-129268,OK
454.51625,TraderOne,Tick,2514,2544,-30,30,149100,149000,34218,-125118,-128118,OK
454.729843,TraderOne,Tick,2514,2544,-30,30,149100,149000,34218,-125118,-128118,OK
455.020154,TraderOne,Tick,2514,2544,-30,30,149100,149000,34218,-125118,-128118,OK
455.205358,TraderOne,Tick,2514,2544,-30,30,149100,149000,34218,-125118,-128118,OK
455.477396,TraderOne,Tick,2514,2544,-30,30,149100,149000,34218,-125118,-128118,OK
455.704786,TraderOne,Tick,2514,2544,-30,30,149100,149100,34218,-125118,-125118,OK
455.988173,TraderOne,Tick,2514,2544,-30,30,149100,149100,34218,-125118,-125118,OK
456.291922,TraderOne,Tick,2514,2544,-30,30,149100,149100,34218,-125118,-125118,OK
456.51404,TraderOne,Tick,2514,2544,-30,30,149100,149100,34218,-125118,-125118,OK
456.711439,TraderOne,Tick,2514,2544,-30,30,149100,149100,34218,-125118,-125118,OK
457.018541,TraderOne,Tick,2514,2544,-30,30,149100,149200,34218,-125118,-122118,OK
457.265165,TraderOne,Tick,2514,2544,-30,30,149100,149300,34218,-125118,-119118,OK
457.470438,TraderOne,Tick,2514,2544,-30,30,149100,149300,34218,-125118,-119118,OK
457.705055,TraderOne,Tick,2514,2544,-30,30,149100,149300,34218,-125118,-119118,OK
458.030315,TraderOne,Tick,2514,2544,-30,30,149100,149300,34218,-125118,-119118,OK
458.282676,TraderOne,Tick,2514,2544,-30,30,149100,149300,34218,-125118,-119118,OK
458.513727,TraderOne,Tick,2514,2544,-30,30,149100,149300,34218,-125118,-119118,OK
458.749942,TraderOne,Tick,2514,2544,-30,30,149100,149500,34218,-125118,-119118,OK
458.993198,TraderOne,Tick,2514,2544,-30,30,149100,149500,34218,-125118,-119118,OK
459.271836,TraderOne,Tick,2514,2544,-30,30,149100,149500,34218,-125118,-119118,OK
459.501666,TraderOne,Tick,2514,2544,-30,30,149100,149500,34218,-125118,-119118,OK
459.714269,TraderOne,Tick,2514,2544,-30,30,149100,149500,34218,-125118,-119118,OK
459.970093,TraderOne,Tick,2514,2544,-30,30,149100,149500,34218,-125118,-119118,OK
460.274359,TraderOne,Tick,2514,2544,-30,30,149100,149500,34218,-125118,-119118,OK
460.484688,TraderOne,Tick,2514,2544,-30,30,149100,149500,34218,-125118,-119118,OK
460.748315,TraderOne,Tick,2514,2544,-30,30,149100,149500,34218,-125118,-119118,OK
460.957057,TraderOne,Tick,2514,2544,-30,30,149100,149500,34218,-125118,-119118,OK
461.232544,TraderOne,Tick,2514,2544,-30,30,149100,149500,34218,-125118,-119118,OK
461.458673,TraderOne,Tick,2514,2544,-30,30,149100,149500,34218,-125118,-119118,OK
461.714222,TraderOne,Tick,2514,2544,-30,30,149100,149500,34218,-125118,-119118,OK
462.032048,TraderOne,Tick,2514,2544,-30,30,149100,149500,34218,-125118,-119118,OK
462.246916,TraderOne,Tick,2524,2544,-20,20,149100,149500,34068,-128968,-124968,OK
462.468619,TraderOne,Tick,2524,2544,-20,20,149100,149500,34068,-128968,-124968,OK
462.709491,TraderOne,Tick,2524,2544,-20,20,149100,149500,34068,-128968,-124968,OK
462.984348,TraderOne,Tick,2524,2544,-20,20,149100,149500,34068,-128968,-124968,OK
463.281779,TraderOne,Tick,2534,2544,-10,10,149100,149200,33918,-132818,-131818,OK
463.475174,TraderOne,Tick,2534,2544,-10,10,149100,148900,33918,-132818,-134818,OK
463.781584,TraderOne,Tick,2534,2554,-20,20,149100,149000,34216,-132116,-134116,OK
463.978815,TraderOne,Tick,2534,2554,-20,20,149100,149000,34216,-132116,-134116,OK
464.290544,TraderOne,Tick,2534,2554,-20,20,149100,149000,34216,-132116,-134116,OK
464.501089,TraderOne,Tick,2534,2554,-20,20,149100,149000,34216,-132116,-134116,OK
464.792476,TraderOne,Tick,2534,2554,-20,20,149100,149000,34216,-132116,-134116,OK
465.030266,TraderOne,Tick,2534,2554,-20,20,149100,149000,34216,-132116,-134116,OK
465.235983,TraderOne,Tick,2534,2554,-20,20,149100,149000,34216,-132116,-134116,OK
465.482186,TraderOne,Tick,2534,2554,-20,20,149100,149100,34216,-132116,-132116,OK
465.755098,TraderOne,Tick,2544,2554,-10,10,149000,149100,34067,-130967,-129967,OK
465.9598,TraderOne,Tick,2554,2554,0,0,149300,149100,34366,-131266,-131266,OK
466.206108,TraderOne,Tick,2554,2554,0,0,149300,149100,34366,-131266,-131266,OK
466.482774,TraderOne,Tick,2554,2554,0,0,149300,149100,34366,-131266,-131266,OK
466.779512,TraderOne,Tick,2564,2554,10,-10,149000,149100,34217,-131117,-132117,OK
466.993346,TraderOne,Tick,2564,2554,10,-10,149000,149100,34217,-131117,-132117,OK
467.299488,TraderOne,Tick,2564,2554,10,-10,149000,149100,34217,-131117,-132117,OK
467.545559,TraderOne,Tick,2564,2554,10,-10,149000,149100,34217,-131117,-132117,OK
467.719642,TraderOne,Tick,2564,2554,10,-10,149000,149100,34217,-131117,-132117,OK
467.985022,TraderOne,Tick,2564,2564,0,0,149000,149100,34515,-132415,-132415,OK
468.225869,TraderOne,Tick,2564,2564,0,0,149000,149100,34515,-132415,-132415,OK
468.537604,TraderOne,Tick,2564,2564,0,0,149000,149100,34515,-132415,-132415,OK
468.795009,TraderOne,Tick,2564,2564,0,0,149000,149100,34515,-132415,-132415,OK
468.965443,TraderOne,Tick,2564,2564,0,0,149300,149100,34515,-132415,-132415,OK
469.272412,TraderOne,Tick,2564,2564,0,0,149300,149100,34515,-132415,-132415,OK
469.470915,TraderOne,Tick,2564,2564,0,0,149300,149100,34515,-132415,-132415,OK
469.763237,TraderOne,Tick,2574,2564,10,-10,148900,149100,34366,-132266,-134266,OK
469.999589,TraderOne,Tick,2574,2564,10,-10,148900,149100,34366,-132266,-134266,OK
470.255778,TraderOne,Tick,2574,2574,0,0,149300,149100,34217,-132117,-132117,OK
470.512654,TraderOne,Tick,2584,2574,10,-10,148900,149100,34068,-131968,-133968,OK
470.786733,TraderOne,Tick,2584,2574,10,-10,148900,149000,34068,-131968,-132968,OK
470.993089,TraderOne,Tick,2584,2574,10,-10,148900,149000,34068,-131968,-132968,OK
471.277478,TraderOne,Tick,2584,2574,10,-10,148900,149400,34068,-131968,-133968,OK
471.473164,TraderOne,Tick,2584,2574,10,-10,148900,149400,34068,-131968,-133968,OK
471.774719,TraderOne,Tick,2594,2574,20,-20,148900,149400,33919,-130819,-134819,OK
472.028927,TraderOne,Tick,2594,2574,20,-20,148900,149400,33919,-130819,-134819,OK
472.226561,TraderOne,Tick,2594,2584,10,-10,149900,149400,33770,-132670,-130670,OK
472.500913,TraderOne,Tick,2594,2594,0,0,149300,149400,33621,-134521,-134521,OK
472.706075,TraderOne,Tick,2594,2594,0,0,149300,149400,33621,-134521,-134521,OK
473.044688,TraderOne,Tick,2594,2594,0,0,149300,149400,33621,-134521,-134521,OK
473.24624,TraderOne,Tick,2594,2594,0,0,149300,149400,33621,-134521,-134521,OK
473.468222,TraderOne,Tick,2594,2594,0,0,149300,149400,33621,-134521,-134521,OK
473.751233,TraderOne,Tick,2594,2604,-10,10,149900,149400,33471,-135371,-137371,OK
473.967475,TraderOne,Tick,2594,2604,-10,10,149900,149400,33471,-135371,-137371,OK
474.204198,TraderOne,Tick,2594,2604,-10,10,149900,149400,33471,-135371,-137371,OK
474.526838,TraderOne,Tick,2594,2604,-10,10,149900,149400,33471,-135371,-137371,OK
474.76043,TraderOne,Tick,2604,2604,0,0,148900,149400,33321,-136221,-136221,OK
475.023768,TraderOne,Tick,2604,2604,0,0,148900,149400,33321,-136221,-136221,OK
475.202019,TraderOne,Tick,2604,2604,0,0,148900,149400,33321,-136221,-136221,OK
475.452087,TraderOne,Tick,2614,2604,10,-10,149300,149400,33172,-137072,-138072,OK
475.742998,TraderOne,Tick,2614,2604,10,-10,149300,149400,33172,-137072,-138072,OK
476.008552,TraderOne,Tick,2614,2604,10,-10,149300,149400,33172,-137072,-138072,OK
476.20679,TraderOne,Tick,2614,2604,10,-10,149300,149400,33172,-137072,-138072,OK
476.54717,TraderOne,Tick,2614,2604,10,-10,149300,149400,33172,-137072,-138072,OK
476.768576,TraderOne,Tick,2614,2604,10,-10,149300,149400,33172,-137072,-138072,OK
476.974895,TraderOne,Tick,2624,2604,20,-20,149300,149600,33471,-134371,-138371,OK
477.23273,TraderOne,Tick,2629,2604,25,-25,149300,149600,33620,-133020,-138020,OK
477.477209,TraderOne,Tick,2629,2604,25,-25,149300,149700,33620,-133020,-138020,OK
477.729537,TraderOne,Tick,2634,2604,30,-30,149000,149700,33545,-131945,-137945,OK
477.976471,TraderOne,Tick,2634,2604,30,-30,149000,149700,33545,-131945,-137945,OK
478.294219,TraderOne,Tick,2634,2604,30,-30,149000,149700,33545,-131945,-137945,OK
478.486893,TraderOne,Tick,2634,2604,30,-30,149000,149600,33545,-131945,-137945,OK
478.771606,TraderOne,Tick,2634,2604,30,-30,149000,149600,33545,-131945,-137945,OK
479.049644,TraderOne,Tick,2634,2604,30,-30,149000,149600,33545,-131945,-137945,OK
479.244313,TraderOne,Tick,2634,2604,30,-30,149000,149600,33545,-131945,-137945,OK
479.475971,TraderOne,Tick,2634,2604,30,-30,149000,149500,33545,-131945,-137945,OK
479.791967,TraderOne,Tick,2634,2604,30,-30,149000,149500,33545,-131945,-137945,OK
480.028196,TraderOne,Tick,2634,2604,30,-30,149000,149500,33545,-131945,-137945,OK
480.236679,TraderOne,Tick,2634,2604,30,-30,149000,149400,33545,-131945,-137945,OK
480.478411,TraderOne,Tick,2634,2604,30,-30,149000,149400,33545,-131945,-137945,OK
480.756254,TraderOne,Tick,2634,2604,30,-30,149000,149400,33545,-131945,-137945,OK
480.959707,TraderOne,Tick,2634,2604,30,-30,149000,149800,33545,-131945,-140945,OK
481.274273,TraderOne,Tick,2634,2604,30,-30,149000,149800,33545,-131945,-140945,OK
481.475273,TraderOne,Tick,2644,2604,40,-40,149700,150000,33844,-131244,-143244,OK
481.740587,TraderOne,Tick,2644,2614,30,-30,149900,150000,33694,-134094,-137094,OK
482.049289,TraderOne,Tick,2644,2614,30,-30,149900,150000,33694,-134094,-137094,OK
482.289383,TraderOne,Tick,2644,2614,30,-30,149900,150000,33694,-134094,-137094,OK
482.453569,TraderOne,Tick,2644,2614,30,-30,149900,150000,33694,-134094,-137094,OK
482.702544,TraderOne,Tick,2644,2614,30,-30,149900,150000,33694,-134094,-137094,OK
482.986416,TraderOne,Tick,2644,2614,30,-30,149900,150000,33694,-134094,-137094,OK
483.264776,TraderOne,Tick,2644,2614,30,-30,149900,150000,33694,-134094,-137094,OK
483.503591,TraderOne,Tick,2644,2614,30,-30,149900,150000,33694,-134094,-137094,OK
483.75062,TraderOne,Tick,2644,2614,30,-30,149900,150000,33694,-134094,-137094,OK
484.046876,TraderOne,Tick,2644,2614,30,-30,149900,150000,33694,-134094,-137094,OK
484.255801,TraderOne,Tick,2644,2614,30,-30,149900,150000,33694,-134094,-137094,OK
484.525473,TraderOne,Tick,2644,2614,30,-30,149900,150000,33694,-134094,-137094,OK
484.742422,TraderOne,Tick,2644,2614,30,-30,149900,150000,33694,-134094,-137094,OK
485.028197,TraderOne,Tick,2644,2614,30,-30,149900,150000,33694,-134094,-137094,OK
485.252318,TraderOne,Tick,2654,2614,40,-40,149500,150000,33544,-130944,-142944,OK
485.542614,TraderOne,Tick,2654,2614,40,-40,149500,150000,33544,-130944,-142944,OK
485.713996,TraderOne,Tick,2654,2624,30,-30,150000,150500,33394,-136794,-145794,OK
485.981383,TraderOne,Tick,2654,2624,30,-30,150000,150500,33394,-136794,-145794,OK
486.260769,TraderOne,Tick,2664,2634,30,-30,150300,151000,33544,-139944,-148944,OK
486.458227,TraderOne,Tick,2674,2634,40,-40,150400,151000,33845,-135245,-147245,OK
486.733171,TraderOne,Tick,2684,2634,50,-50,150500,150900,34146,-130546,-145546,OK
487.019161,TraderOne,Tick,2684,2634,50,-50,150500,150800,34146,-130546,-145546,OK
487.202721,TraderOne,Tick,2694,2634,60,-60,150400,151000,34447,-125847,-143847,OK
487.537815,TraderOne,Tick,2694,2644,50,-50,150400,150900,34748,-132148,-147148,OK
487.797883,TraderOne,Tick,2694,2644,50,-50,150400,150800,34748,-132148,-147148,OK
488.022587,TraderOne,Tick,2694,2644,50,-50,150400,150800,34748,-132148,-147148,OK
488.296791,TraderOne,Tick,2694,2644,50,-50,150400,150800,34748,-132148,-147148,OK
488.541115,TraderOne,Tick,2694,2644,50,-50,150400,150800,34748,-132148,-147148,OK
488.725394,TraderOne,Tick,2694,2654,40,-40,150500,150800,34598,-137998,-149998,OK
488.957841,TraderOne,Tick,2694,2654,40,-40,150500,150800,34598,-137998,-149998,OK
489.267102,TraderOne,Tick,2701,2654,47,-47,150500,150800,34809,-135409,-149509,OK
489.467128,TraderOne,Tick,2704,2654,50,-50,150400,151000,34764,-133564,-148564,OK
489.766592,TraderOne,Tick,2704,2654,50,-50,150600,151000,34764,-133564,-148564,OK
489.970301,TraderOne,Tick,2704,2664,40,-40,150800,151000,34613,-139413,-147413,OK
490.247402,TraderOne,Tick,2704,2664,40,-40,150800,151000,34613,-139413,-147413,OK
490.507002,TraderOne,Tick,2704,2664,40,-40,150800,151000,34613,-139413,-147413,OK
490.761201,TraderOne,Tick,2704,2664,40,-40,150800,151000,34613,-139413,-147413,OK
490.996855,TraderOne,Tick,2704,2664,40,-40,150800,151000,34613,-139413,-147413,OK
491.217479,TraderOne,Tick,2704,2664,40,-40,150800,150800,34613,-139413,-139413,OK
491.50932,TraderOne,Tick,2704,2664,40,-40,150800,150800,34613,-139413,-139413,OK
491.78051,TraderOne,Tick,2704,2664,40,-40,150800,150800,34613,-139413,-139413,OK
492.0354,TraderOne,Tick,2704,2664,40,-40,150800,150800,34613,-139413,-139413,OK
492.269467,TraderOne,Tick,2704,2664,40,-40,150800,150500,34613,-139413,-127413,OK
492.539432,TraderOne,Tick,2704,2671,33,-33,150300,150500,34823,-142423,-149023,OK
492.738795,TraderOne,Tick,2704,2681,23,-23,150800,150500,34673,-144273,-137373,OK
493.041373,TraderOne,Tick,2704,2681,23,-23,150800,150500,34673,-144273,-137373,OK
493.228127,TraderOne,Tick,2704,2681,23,-23,150800,150500,34673,-144273,-137373,OK
493.464702,TraderOne,Tick,2704,2681,23,-23,150800,150500,34673,-144273,-137373,OK
493.71921,TraderOne,Tick,2704,2681,23,-23,150800,150200,34673,-144273,-137373,OK
493.994455,TraderOne,Tick,2704,2681,23,-23,150800,150200,34673,-144273,-137373,OK
494.268783,TraderOne,Tick,2705,2681,24,-24,149900,150200,34658,-144058,-151258,OK
494.51693,TraderOne,Tick,2705,2681,24,-24,149900,150200,34658,-144058,-151258,OK
494.761605,TraderOne,Tick,2705,2681,24,-24,149900,150200,34658,-144058,-151258,OK
495.04087,TraderOne,Tick,2705,2681,24,-24,149900,150200,34658,-144058,-151258,OK
495.287534,TraderOne,Tick,2705,2681,24,-24,149900,150000,34658,-144058,-146458,OK
495.526777,TraderOne,Tick,2705,2681,24,-24,149900,150000,34658,-144058,-146458,OK
495.719164,TraderOne,Tick,2705,2691,14,-14,149600,149800,34957,-146357,-149157,OK
496.027086,TraderOne,Tick,2705,2691,14,-14,149600,149800,34957,-146357,-149157,OK
496.25188,TraderOne,Tick,2705,2691,14,-14,149600,149800,34957,-146357,-149157,OK
496.492753,TraderOne,Tick,2705,2691,14,-14,149600,149900,34957,-146357,-150557,OK
496.7352,TraderOne,Tick,2705,2691,14,-14,149600,149900,34957,-146357,-150557,OK
496.979386,TraderOne,Tick,2715,2691,24,-24,149500,149900,34807,-146207,-153407,OK
497.298089,TraderOne,Tick,2715,2691,24,-24,149500,149900,34807,-146207,-153407,OK
497.531604,TraderOne,Tick,2715,2691,24,-24,149500,149900,34807,-146207,-153407,OK
497.759937,TraderOne,Tick,2715,2691,24,-24,149500,149900,34807,-146207,-153407,OK
498.029266,TraderOne,Tick,2715,2691,24,-24,149500,149900,34807,-146207,-153407,OK
498.244827,TraderOne,Tick,2715,2691,24,-24,149500,149900,34807,-146207,-153407,OK
498.453766,TraderOne,Tick,2715,2691,24,-24,149500,149900,34807,-146207,-153407,OK
498.725409,TraderOne,Tick,2715,2691,24,-24,149500,149900,34807,-146207,-153407,OK
498.967101,TraderOne,Tick,2715,2691,24,-24,149500,149900,34807,-146207,-153407,OK
499.283485,TraderOne,Tick,2715,2691,24,-24,149500,149900,34807,-146207,-153407,OK
499.535207,TraderOne,Tick,2725,2691,34,-34,149400,149900,34657,-144057,-154257,OK
499.73478,TraderOne,Tick,2725,2691,34,-34,149400,149900,34657,-144057,-154257,OK
500.020767,TraderOne,Tick,2725,2691,34,-34,149400,149900,34657,-144057,-154257,OK
500.26303,TraderOne,Tick,2725,2691,34,-34,149400,149900,34657,-144057,-154257,OK
500.525143,TraderOne,Tick,2725,2691,34,-34,149400,149900,34657,-144057,-154257,OK
500.71389,TraderOne,Tick,2725,2691,34,-34,149400,149900,34657,-144057,-154257,OK
501.024558,TraderOne,Tick,2725,2701,24,-24,150400,149900,34507,-146907,-139707,OK
501.263019,TraderOne,Tick,2725,2701,24,-24,150400,149900,34507,-146907,-139707,OK
501.472876,TraderOne,Tick,2725,2701,24,-24,150400,149900,34507,-146907,-139707,OK
501.772261,TraderOne,Tick,2725,2701,24,-24,150400,149900,34507,-146907,-139707,OK
502.031364,TraderOne,Tick,2725,2701,24,-24,150400,149900,34507,-146907,-139707,OK
502.277563,TraderOne,Tick,2725,2701,24,-24,150400,149900,34507,-146907,-139707,OK
502.539671,TraderOne,Tick,2725,2706,19,-19,149700,149900,34432,-148832,-152632,OK
502.753207,TraderOne,Tick,2735,2706,29,-29,149600,150200,34732,-147132,-155832,OK
503.016966,TraderOne,Tick,2745,2706,39,-39,149600,150200,35032,-145432,-157132,OK
503.213932,TraderOne,Tick,2745,2706,39,-39,149600,150200,35032,-145432,-157132,OK
503.480447,TraderOne,Tick,2745,2716,29,-29,150600,150200,34882,-148282,-139582,OK
503.789424,TraderOne,Tick,2753,2716,37,-37,150000,150200,34762,-146562,-153962,OK
504.04744,TraderOne,Tick,2753,2716,37,-37,150000,150200,34762,-146562,-153962,OK
504.246673,TraderOne,Tick,2753,2716,37,-37,150000,150200,34762,-146562,-153962,OK
504.518055,TraderOne,Tick,2753,2716,37,-37,150000,150200,34762,-146562,-153962,OK
504.728691,TraderOne,Tick,2753,2716,37,-37,150000,150200,34762,-146562,-153962,OK
504.989521,TraderOne,Tick,2763,2726,37,-37,149400,150200,34462,-146262,-157362,OK
505.217987,TraderOne,Tick,2763,2726,37,-37,149400,150200,34462,-146262,-157362,OK
505.49025,TraderOne,Tick,2763,2726,37,-37,149400,150200,34462,-146262,-157362,OK
505.743489,TraderOne,Tick,2763,2726,37,-37,149400,150200,34462,-146262,-157362,OK
506.006586,TraderOne,Tick,2763,2726,37,-37,149400,150200,34462,-146262,-157362,OK
506.231953,TraderOne,Tick,2763,2736,27,-27,150100,150200,34312,-157112,-159812,OK
506.478582,TraderOne,Tick,2773,2736,37,-37,150600,150200,34613,-153413,-142313,OK
506.763392,TraderOne,Tick,2773,2736,37,-37,150600,150200,34613,-153413,-142313,OK
506.965407,TraderOne,Tick,2773,2736,37,-37,150600,150200,34613,-153413,-142313,OK
507.213484,TraderOne,Tick,2773,2745,28,-28,150400,150200,34477,-155977,-150377,OK
507.490883,TraderOne,Tick,2783,2745,38,-38,150400,150200,34327,-153827,-146227,OK
507.734683,TraderOne,Tick,2793,2745,48,-48,150400,150200,34628,-151128,-141528,OK
507.970854,TraderOne,Tick,2793,2745,48,-48,150400,150900,34628,-151128,-165528,OK
508.216866,TraderOne,Tick,2803,2745,58,-58,150400,151000,34929,-146429,-163829,OK
508.49168,TraderOne,Tick,2803,2745,58,-58,150400,151000,34929,-146429,-163829,OK
508.773341,TraderOne,Tick,2803,2745,58,-58,150400,151000,34929,-146429,-163829,OK
508.952903,TraderOne,Tick,2803,2745,58,-58,150400,151000,34929,-146429,-163829,OK
509.261489,TraderOne,Tick,2803,2755,48,-48,150400,151000,35230,-149730,-164130,OK
509.455204,TraderOne,Tick,2803,2755,48,-48,150400,151000,35230,-149730,-164130,OK
509.769963,TraderOne,Tick,2803,2755,48,-48,150400,151000,35230,-149730,-164130,OK
510.03121,TraderOne,Tick,2803,2755,48,-48,150400,151000,35230,-149730,-164130,OK
510.229647,TraderOne,Tick,2803,2755,48,-48,150400,151000,35230,-149730,-164130,OK
510.475787,TraderOne,Tick,2803,2755,48,-48,150400,151000,35230,-149730,-164130,OK
510.76688,TraderOne,Tick,2803,2765,38,-38,150300,151000,35080,-153580,-164980,OK
510.994662,TraderOne,Tick,2803,2775,28,-28,150600,151000,35381,-155881,-164281,OK
511.205127,TraderOne,Tick,2803,2775,28,-28,150600,151000,35381,-155881,-164281,OK
511.489086,TraderOne,Tick,2803,2775,28,-28,150600,151000,35381,-155881,-164281,OK
511.714462,TraderOne,Tick,2803,2775,28,-28,150800,151000,35381,-155881,-161481,OK
511.974231,TraderOne,Tick,2803,2775,28,-28,150600,151000,35381,-155881,-164281,OK
512.276246,TraderOne,Tick,2803,2775,28,-28,150600,151000,35381,-155881,-164281,OK
512.472363,TraderOne,Tick,2803,2775,28,-28,150600,151000,35381,-155881,-164281,OK
512.74765,TraderOne,Tick,2813,2775,38,-38,150400,151000,35230,-154730,-166130,OK
513.045272,TraderOne,Tick,2813,2782,31,-31,150700,151000,35125,-156725,-166025,OK
513.292108,TraderOne,Tick,2813,2782,31,-31,150700,151000,35125,-156725,-166025,OK
513.505345,TraderOne,Tick,2813,2782,31,-31,150700,150900,35125,-156725,-162925,OK
513.782906,TraderOne,Tick,2813,2782,31,-31,150700,150900,35125,-156725,-162925,OK
513.992578,TraderOne,Tick,2823,2782,41,-41,150500,150900,34974,-153574,-165874,OK
514.243065,TraderOne,Tick,2823,2792,31,-31,150800,151400,34823,-160423,-169723,OK
514.452891,TraderOne,Tick,2833,2792,41,-41,151000,151300,35125,-157725,-170025,OK
514.793878,TraderOne,Tick,2833,2792,41,-41,151000,151300,35125,-157725,-170025,OK
515.002489,TraderOne,Tick,2833,2792,41,-41,151000,151300,35125,-157725,-170025,OK
515.209617,TraderOne,Tick,2833,2792,41,-41,151000,151300,35125,-157725,-170025,OK
515.544514,TraderOne,Tick,2833,2792,41,-41,151000,151200,35125,-157725,-165925,OK
515.731642,TraderOne,Tick,2833,2792,41,-41,151000,151200,35125,-157725,-165925,OK
516.001577,TraderOne,Tick,2833,2792,41,-41,151000,151200,35125,-157725,-165925,OK
516.267336,TraderOne,Tick,2833,2792,41,-41,151000,151000,35125,-157725,-157725,OK
516.539253,TraderOne,Tick,2833,2802,31,-31,151000,151000,34974,-161574,-161574,OK
516.701379,TraderOne,Tick,2833,2802,31,-31,151000,151000,34974,-161574,-161574,OK
516.958722,TraderOne,Tick,2833,2802,31,-31,151000,151000,34974,-161574,-161574,OK
517.275509,TraderOne,Tick,2833,2802,31,-31,151000,151000,34974,-161574,-161574,OK
517.534988,TraderOne,Tick,2833,2802,31,-31,151000,151000,34974,-161574,-161574,OK
517.729198,TraderOne,Tick,2833,2802,31,-31,151000,151000,34974,-161574,-161574,OK
517.989268,TraderOne,Tick,2833,2802,31,-31,151000,151400,34974,-161574,-170874,OK
518.234114,TraderOne,Tick,2843,2802,41,-41,151100,151400,35276,-157976,-170276,OK
518.539832,TraderOne,Tick,2843,2812,31,-31,151100,151500,35125,-164825,-174125,OK
518.784524,TraderOne,Tick,2853,2812,41,-41,151200,151500,35427,-161127,-173427,OK
518.972609,TraderOne,Tick,2853,2812,41,-41,151200,151500,35427,-161127,-173427,OK
519.239674,TraderOne,Tick,2853,2812,41,-41,151200,151500,35427,-161127,-173427,OK
519.460823,TraderOne,Tick,2853,2822,31,-31,151100,151500,35729,-165429,-174729,OK
519.741157,TraderOne,Tick,2853,2822,31,-31,151100,151500,35729,-165429,-174729,OK
520.045587,TraderOne,Tick,2853,2822,31,-31,151100,151500,35729,-165429,-174729,OK
520.255535,TraderOne,Tick,2863,2822,41,-41,151200,151500,36031,-162731,-175031,OK
520.506205,TraderOne,Tick,2863,2822,41,-41,151200,151500,36031,-162731,-175031,OK
520.784475,TraderOne,Tick,2863,2822,41,-41,151200,151500,36031,-162731,-175031,OK
521.005631,TraderOne,Tick,2863,2822,41,-41,151200,151600,36031,-162731,-175031,OK
521.282953,TraderOne,Tick,2863,2822,41,-41,151200,151600,36031,-162731,-175031,OK
521.512134,TraderOne,Tick,2863,2822,41,-41,151200,151600,36031,-162731,-175031,OK
521.723996,TraderOne,Tick,2873,2822,51,-51,151100,151700,36333,-159033,-174333,OK
521.99288,TraderOne,Tick,2883,2822,61,-61,151100,151700,36635,-154335,-172635,OK
522.276167,TraderOne,Tick,2883,2832,51,-51,151100,151700,36937,-160637,-175937,OK
522.452004,TraderOne,Tick,2883,2832,51,-51,151100,151700,36937,-160637,-175937,OK
522.737779,TraderOne,Tick,2883,2832,51,-51,151100,151500,36937,-160637,-175937,OK
523.04471,TraderOne,Tick,2893,2832,61,-61,151000,151500,36786,-155486,-173786,OK
523.296782,TraderOne,Tick,2893,2842,51,-51,151000,151500,37088,-161788,-177088,OK
523.495567,TraderOne,Tick,2893,2849,44,-44,151100,151500,36982,-166582,-179782,OK
523.731476,TraderOne,Tick,2903,2849,54,-54,151200,151500,37284,-161884,-178084,OK
523.970162,TraderOne,Tick,2903,2849,54,-54,151300,151500,37284,-161884,-172684,OK
524.284076,TraderOne,Tick,2913,2849,64,-64,151300,151500,37587,-158187,-170987,OK
524.511315,TraderOne,Tick,2913,2849,64,-64,151200,151500,37587,-158187,-177387,OK
524.768124,TraderOne,Tick,2913,2849,64,-64,151300,151900,37587,-158187,-177387,OK
524.984409,TraderOne,Tick,2923,2849,74,-74,151300,151900,37890,-154490,-176690,OK
525.278394,TraderOne,Tick,2923,2849,74,-74,151300,151900,37890,-154490,-176690,OK
525.544461,TraderOne,Tick,2923,2859,64,-64,151200,151900,38192,-159792,-178992,OK
525.712187,TraderOne,Tick,2923,2859,64,-64,151200,151900,38192,-159792,-178992,OK
526.026868,TraderOne,Tick,2923,2859,64,-64,151200,151900,38192,-159792,-178992,OK
526.252755,TraderOne,Tick,2923,2869,54,-54,151100,151700,38494,-166094,-182294,OK
526.53777,TraderOne,Tick,2923,2869,54,-54,151100,151700,38494,-166094,-182294,OK
526.773825,TraderOne,Tick,2923,2879,44,-44,151400,151700,38343,-169943,-183143,OK
527.006537,TraderOne,Tick,2923,2879,44,-44,151400,151700,38343,-169943,-183143,OK
527.226759,TraderOne,Tick,2923,2879,44,-44,151400,151700,38343,-169943,-183143,OK
527.509522,TraderOne,Tick,2923,2879,44,-44,151400,151700,38343,-169943,-183143,OK
527.746013,TraderOne,Tick,2923,2879,44,-44,151400,151700,38343,-169943,-183143,OK
527.981299,TraderOne,Tick,2923,2879,44,-44,151400,151700,38343,-169943,-183143,OK
528.286989,TraderOne,Tick,2923,2879,44,-44,151400,151700,38343,-169943,-183143,OK
528.527088,TraderOne,Tick,2923,2879,44,-44,151400,151700,38343,-169943,-183143,OK
528.743323,TraderOne,Tick,2923,2879,44,-44,151400,151400,38343,-169943,-169943,OK
529.008098,TraderOne,Tick,2923,2889,34,-34,151000,151400,38645,-174245,-184445,OK
529.210627,TraderOne,Tick,2923,2889,34,-34,151000,151400,38645,-174245,-184445,OK
529.482421,TraderOne,Tick,2923,2889,34,-34,151000,151400,38645,-174245,-184445,OK
529.783171,TraderOne,Tick,2923,2899,24,-24,151000,151200,38947,-176547,-181347,OK
530.034819,TraderOne,Tick,2923,2909,14,-14,151000,151200,39249,-178849,-181649,OK
530.208192,TraderOne,Tick,2923,2909,14,-14,151000,151100,39249,-178849,-180249,OK
530.463735,TraderOne,Tick,2923,2909,14,-14,151000,151200,39249,-178849,-181649,OK
530.762656,TraderOne,Tick,2923,2909,14,-14,151000,151400,39249,-178849,-183049,OK
531.000526,TraderOne,Tick,2923,2909,14,-14,151000,150900,39249,-178849,-177449,OK
531.25896,TraderOne,Tick,2923,2919,4,-4,150900,150900,39551,-179151,-179151,OK
531.468583,TraderOne,Tick,2923,2919,4,-4,150900,150900,39551,-179151,-179151,OK
531.714064,TraderOne,Tick,2923,2919,4,-4,150900,150900,39551,-179151,-179151,OK
532.012823,TraderOne,Tick,2923,2929,-6,6,151500,151000,39400,-179000,-180800,OK
532.228099,TraderOne,Tick,2923,2929,-6,6,151500,151000,39400,-179000,-180800,OK
532.549109,TraderOne,Tick,2923,2929,-6,6,151500,151000,39400,-179000,-180800,OK
532.739052,TraderOne,Tick,2923,2929,-6,6,151500,151000,39400,-179000,-180800,OK
532.987299,TraderOne,Tick,2933,2929,4,-4,150800,150900,39249,-180849,-181249,OK
533.270105,TraderOne,Tick,2933,2929,4,-4,150800,150900,39249,-180849,-181249,OK
533.474788,TraderOne,Tick,2933,2929,4,-4,150800,150900,39249,-180849,-181249,OK
533.769378,TraderOne,Tick,2933,2929,4,-4,150800,150900,39249,-180849,-181249,OK
533.954537,TraderOne,Tick,2933,2937,-4,4,150900,150900,39128,-180728,-180728,OK
534.279462,TraderOne,Tick,2933,2947,-14,14,151400,150700,38977,-179577,-183777,OK
534.470579,TraderOne,Tick,2933,2947,-14,14,151400,150700,38977,-179577,-183777,OK
534.798858,TraderOne,Tick,2933,2947,-14,14,151400,150700,38977,-179577,-183777,OK
535.029681,TraderOne,Tick,2933,2957,-24,24,151400,150700,38826,-177426,-184626,OK
535.233391,TraderOne,Tick,2936,2957,-21,21,150900,150700,38781,-178281,-182481,OK
535.50119,TraderOne,Tick,2936,2957,-21,21,150900,150700,38781,-178281,-182481,OK
535.711031,TraderOne,Tick,2936,2957,-21,21,150900,150700,38781,-178281,-182481,OK
536.046118,TraderOne,Tick,2936,2957,-21,21,150900,150800,38781,-178281,-180381,OK
536.212047,TraderOne,Tick,2936,2957,-21,21,150900,150800,38781,-178281,-180381,OK
536.502391,TraderOne,Tick,2936,2957,-21,21,150900,150800,38781,-178281,-180381,OK
536.755111,TraderOne,Tick,2946,2957,-11,11,150800,150700,38630,-181130,-182230,OK
536.971976,TraderOne,Tick,2946,2957,-11,11,150800,150800,38630,-181130,-181130,OK
537.278051,TraderOne,Tick,2956,2957,-1,1,150600,150800,38479,-182979,-182779,OK
537.497435,TraderOne,Tick,2956,2957,-1,1,150600,150800,38479,-182979,-182779,OK
537.712976,TraderOne,Tick,2956,2957,-1,1,150600,151100,38479,-182979,-182679,OK
538.018503,TraderOne,Tick,2956,2957,-1,1,150600,151100,38479,-182979,-182679,OK
538.203581,TraderOne,Tick,2956,2957,-1,1,150600,151100,38479,-182979,-182679,OK
538.528853,TraderOne,Tick,2956,2957,-1,1,150600,151100,38479,-182979,-182679,OK
538.766264,TraderOne,Tick,2956,2957,-1,1,150600,151000,38479,-182979,-182679,OK
538.970611,TraderOne,Tick,2966,2977,-11,11,151500,151000,38026,-180526,-183826,OK
539.222458,TraderOne,Tick,2966,2977,-11,11,151500,150900,38026,-180526,-183826,OK
539.480773,TraderOne,Tick,2966,2977,-11,11,151500,150900,38026,-180526,-183826,OK
539.78016,TraderOne,Tick,2966,2977,-11,11,151500,150900,38026,-180526,-183826,OK
539.955688,TraderOne,Tick,2966,2977,-11,11,151500,150900,38026,-180526,-183826,OK
540.258614,TraderOne,Tick,2966,2977,-11,11,151500,150900,38026,-180526,-183826,OK
540.519784,TraderOne,Tick,2966,2977,-11,11,151500,150900,38026,-180526,-183826,OK
540.788663,TraderOne,Tick,2966,2977,-11,11,151500,150900,38026,-180526,-183826,OK
540.992918,TraderOne,Tick,2966,2977,-11,11,151500,151000,38026,-180526,-183826,OK
541.234111,TraderOne,Tick,2966,2977,-11,11,151500,151100,38026,-180526,-183826,OK
541.508707,TraderOne,Tick,2966,2987,-21,21,151600,151600,37875,-181375,-181375,OK
541.730087,TraderOne,Tick,2976,2987,-11,11,151600,151800,38178,-180678,-178478,OK
542.017853,TraderOne,Tick,2986,2987,-1,1,151600,151800,38481,-178981,-178781,OK
542.295988,TraderOne,Tick,2996,2987,9,-9,151600,151800,38784,-177284,-179084,OK
542.469736,TraderOne,Tick,3006,2987,19,-19,151600,151900,39087,-177587,-183287,OK
542.786797,TraderOne,Tick,3016,2987,29,-29,151600,152000,39390,-174890,-183590,OK
543.04477,TraderOne,Tick,3026,2987,39,-39,151600,152000,39693,-172193,-183893,OK
543.288734,TraderOne,Tick,3036,2987,49,-49,151400,152000,39996,-169496,-184196,OK
543.5483,TraderOne,Tick,3036,2987,49,-49,151600,152000,39996,-169496,-184196,OK
543.744118,TraderOne,Tick,3046,2987,59,-59,151800,152000,40300,-165800,-177600,OK
543.992459,TraderOne,Tick,3046,2987,59,-59,151800,152500,40300,-165800,-183500,OK
544.25938,TraderOne,Tick,3046,2987,59,-59,151800,152500,40300,-165800,-183500,OK
544.533687,TraderOne,Tick,3046,2987,59,-59,151800,152500,40300,-165800,-183500,OK
544.782973,TraderOne,Tick,3046,2987,59,-59,152000,152500,40300,-165800,-183500,OK
545.034907,TraderOne,Tick,3046,2987,59,-59,152000,152600,40300,-165800,-183500,OK
545.290988,TraderOne,Tick,3046,2987,59,-59,152000,152400,40300,-165800,-183500,OK
545.542264,TraderOne,Tick,3046,2987,59,-59,152200,152400,40300,-165800,-177600,OK
545.727702,TraderOne,Tick,3046,2987,59,-59,152200,152400,40300,-165800,-177600,OK
546.01865,TraderOne,Tick,3046,2987,59,-59,152200,152400,40300,-165800,-177600,OK
546.291309,TraderOne,Tick,3046,2987,59,-59,152200,152400,40300,-165800,-177600,OK
546.472613,TraderOne,Tick,3046,2987,59,-59,152200,152400,40300,-165800,-177600,OK
546.790546,TraderOne,Tick,3046,2987,59,-59,152200,152400,40300,-165800,-177600,OK
546.990849,TraderOne,Tick,3046,2987,59,-59,152200,152400,40300,-165800,-177600,OK
547.26406,TraderOne,Tick,3046,2987,59,-59,152200,152400,40300,-165800,-177600,OK
547.45118,TraderOne,Tick,3046,2987,59,-59,152200,152400,40300,-165800,-177600,OK
547.745994,TraderOne,Tick,3046,2997,49,-49,152200,152400,40148,-172648,-182448,OK
547.96636,TraderOne,Tick,3056,2997,59,-59,152300,152400,40453,-168953,-174853,OK
548.217858,TraderOne,Tick,3056,2997,59,-59,152300,152400,40453,-168953,-174853,OK
548.539968,TraderOne,Tick,3056,3007,49,-49,152200,152400,40757,-173257,-183057,OK
548.750351,TraderOne,Tick,3056,3017,39,-39,152300,152400,40605,-177105,-181005,OK
548.955913,TraderOne,Tick,3056,3017,39,-39,152300,152400,40605,-177105,-181005,OK
549.259949,TraderOne,Tick,3056,3017,39,-39,152300,152400,40605,-177105,-181005,OK
549.502593,TraderOne,Tick,3056,3017,39,-39,152300,152500,40605,-177105,-184905,OK
549.740464,TraderOne,Tick,3056,3017,39,-39,152300,152700,40605,-177105,-188805,OK
550.03759,TraderOne,Tick,3066,3017,49,-49,152300,152700,40910,-173410,-188110,OK
550.204906,TraderOne,Tick,3076,3017,59,-59,152400,152700,41215,-169715,-187415,OK
550.502131,TraderOne,Tick,3076,3017,59,-59,152400,152700,41215,-169715,-187415,OK
550.775932,TraderOne,Tick,3076,3017,59,-59,152400,152700,41215,-169715,-187415,OK
550.950962,TraderOne,Tick,3076,3017,59,-59,152400,152700,41215,-169715,-187415,OK
551.298911,TraderOne,Tick,3076,3027,49,-59,152400,153000,41063,1354437,-190263,OK
551.49609,TraderOne,Tick,3086,3027,59,-59,152500,153000,41368,-172868,-190568,OK
551.798421,TraderOne,Tick,3086,3027,59,-59,152500,153000,41368,-172868,-190568,OK
552.044414,TraderOne,Tick,3086,3027,59,-59,152500,153000,41368,-172868,-190568,OK
552.275019,TraderOne,Tick,3086,3027,59,-59,152500,153000,41368,-172868,-190568,OK
552.500907,TraderOne,Tick,3096,3027,69,-69,152600,153000,41673,-166173,-186873,OK
552.785557,TraderOne,Tick,3096,3027,69,-69,152800,153600,41673,-166173,-186873,OK
553.03722,TraderOne,Tick,3106,3027,79,-79,153000,153600,41979,-160479,-184179,OK
553.299293,TraderOne,Tick,3106,3037,69,-69,153100,153600,42285,-165785,-186485,OK
553.50247,TraderOne,Tick,3106,3037,69,-69,153000,153600,42285,-165785,-186485,OK
553.755623,TraderOne,Tick,3106,3047,59,-59,153000,153600,42591,-173091,-190791,OK
554.034329,TraderOne,Tick,3106,3047,59,-59,153300,153600,42591,-173091,-190791,OK
554.239068,TraderOne,Tick,3106,3047,59,-59,153300,153600,42591,-173091,-190791,OK
554.501258,TraderOne,Tick,3106,3057,49,-49,153300,153600,42897,-178397,-193097,OK
554.784669,TraderOne,Tick,3106,3057,49,-49,153300,153600,42897,-178397,-193097,OK
554.98511,TraderOne,Tick,3106,3067,39,-39,153300,153600,42744,-180244,-191944,OK
555.251291,TraderOne,Tick,3106,3067,39,-39,153300,153600,42744,-180244,-191944,OK
555.516926,TraderOne,Tick,3106,3067,39,-39,153300,153200,42744,-180244,-176344,OK
555.780602,TraderOne,Tick,3106,3067,39,-39,153300,153200,42744,-180244,-176344,OK
556.003321,TraderOne,Tick,3106,3067,39,-39,153300,153200,42744,-180244,-176344,OK
556.262615,TraderOne,Tick,3106,3067,39,-39,153300,153300,42744,-180244,-180244,OK
556.497058,TraderOne,Tick,3116,3067,49,-49,152900,153300,43050,-176550,-191250,OK
556.774189,TraderOne,Tick,3116,3077,39,-39,153100,153600,42897,-184397,-196097,OK
556.966028,TraderOne,Tick,3126,3077,49,-49,153300,153600,43204,-180704,-195404,OK
557.204738,TraderOne,Tick,3136,3077,59,-59,153300,153600,43511,-177011,-194711,OK
557.485298,TraderOne,Tick,3136,3077,59,-59,153300,153600,43511,-177011,-194711,OK
557.755065,TraderOne,Tick,3136,3077,59,-59,153300,153600,43511,-177011,-194711,OK
558.03098,TraderOne,Tick,3136,3077,59,-59,153300,153600,43511,-177011,-194711,OK
558.205143,TraderOne,Tick,3136,3077,59,-59,153300,153600,43511,-177011,-194711,OK
558.492556,TraderOne,Tick,3136,3077,59,-59,153300,153600,43511,-177011,-194711,OK
558.798413,TraderOne,Tick,3136,3077,59,-59,153300,153600,43511,-177011,-194711,OK
558.981221,TraderOne,Tick,3136,3087,49,-49,153200,153600,43817,-183317,-198017,OK
559.266582,TraderOne,Tick,3136,3087,49,-49,153200,153600,43817,-183317,-198017,OK
559.522937,TraderOne,Tick,3139,3087,52,-52,153100,153600,43771,-182071,-197671,OK
559.733739,TraderOne,Tick,3139,3097,42,-42,153200,153600,43618,-188918,-201518,OK
559.961202,TraderOne,Tick,3149,3097,52,-52,153300,153600,43925,-185225,-200825,OK
560.244924,TraderOne,Tick,3157,3097,60,-60,153200,153600,43802,-181102,-199102,OK
560.476114,TraderOne,Tick,3157,3107,50,-50,153400,153600,43649,-186949,-196949,OK
560.761634,TraderOne,Tick,3157,3107,50,-50,153400,153600,43649,-186949,-196949,OK
561.008456,TraderOne,Tick,3167,3107,60,-60,153100,153600,43496,-181796,-199796,OK
561.277348,TraderOne,Tick,3167,3117,50,-50,153500,154200,43343,-190643,-205643,OK
561.52235,TraderOne,Tick,3167,3127,40,-40,153800,154400,43189,-198489,-210489,OK
561.784769,TraderOne,Tick,3167,3127,40,-40,153900,154400,43189,-198489,-210489,OK
561.982439,TraderOne,Tick,3177,3127,50,-50,153900,154400,43497,-193797,-208797,OK
562.268005,TraderOne,Tick,3177,3127,50,-50,154000,154600,43497,-193797,-208797,OK
562.463054,TraderOne,Tick,3177,3127,50,-50,154000,154800,43497,-193797,-208797,OK
562.739586,TraderOne,Tick,3187,3127,60,-60,154100,154900,43805,-188105,-206105,OK
562.998602,TraderOne,Tick,3187,3127,60,-60,154100,154900,43805,-188105,-206105,OK
563.222921,TraderOne,Tick,3187,3127,60,-60,154100,154600,43805,-188105,-206105,OK
563.481704,TraderOne,Tick,3187,3137,50,-50,153900,154600,44113,-193413,-208413,OK
563.783428,TraderOne,Tick,3187,3147,40,-40,154200,154700,43959,-200259,-212259,OK
563.978876,TraderOne,Tick,3187,3147,40,-40,154200,154700,43959,-200259,-212259,OK
564.292239,TraderOne,Tick,3187,3147,40,-40,154200,154900,43959,-200259,-212259,OK
564.496789,TraderOne,Tick,3197,3147,50,-50,154200,154900,44268,-197568,-212568,OK
564.707309,TraderOne,Tick,3197,3147,50,-50,154100,154900,44268,-197568,-212568,OK
564.988902,TraderOne,Tick,3197,3147,50,-50,154100,154900,44268,-197568,-212568,OK
565.232799,TraderOne,Tick,3197,3147,50,-50,154100,154900,44268,-197568,-212568,OK
565.533215,TraderOne,Tick,3197,3147,50,-50,154100,154700,44268,-197568,-212568,OK
565.76567,TraderOne,Tick,3197,3147,50,-50,154100,154700,44268,-197568,-212568,OK
565.971371,TraderOne,Tick,3197,3147,50,-50,154100,154700,44268,-197568,-212568,OK
566.270208,TraderOne,Tick,3197,3147,50,-50,154100,154700,44268,-197568,-212568,OK
566.520003,TraderOne,Tick,3197,3147,50,-50,154100,154700,44268,-197568,-212568,OK
566.765848,TraderOne,Tick,3197,3147,50,-50,154100,154700,44268,-197568,-212568,OK
567.027279,TraderOne,Tick,3197,3147,50,-50,154100,154700,44268,-197568,-212568,OK
567.270911,TraderOne,Tick,3197,3147,50,-50,154100,154700,44268,-197568,-212568,OK
567.458853,TraderOne,Tick,3197,3147,50,-50,154100,154700,44268,-197568,-212568,OK
567.701111,TraderOne,Tick,3197,3147,50,-50,154100,154700,44268,-197568,-212568,OK
568.038367,TraderOne,Tick,3197,3147,50,-50,154100,154700,44268,-197568,-212568,OK
568.204042,TraderOne,Tick,3197,3147,50,-50,154100,154400,44268,-197568,-212568,OK
568.549235,TraderOne,Tick,3197,3147,50,-50,154100,154400,44268,-197568,-212568,OK
568.70332,TraderOne,Tick,3197,3157,40,-40,154400,154400,44114,-202414,-202414,OK
569.050045,TraderOne,Tick,3197,3157,40,-40,154400,154400,44114,-202414,-202414,OK
569.206426,TraderOne,Tick,3207,3157,50,-50,154000,154700,43960,-196260,-211260,OK
569.548435,TraderOne,Tick,3207,3157,50,-50,154400,154700,43960,-196260,-211260,OK
569.767466,TraderOne,Tick,3207,3157,50,-50,154400,154700,43960,-196260,-211260,OK
569.968309,TraderOne,Tick,3207,3157,50,-50,154400,154700,43960,-196260,-211260,OK
570.286942,TraderOne,Tick,3207,3157,50,-50,154400,154700,43960,-196260,-211260,OK
570.480896,TraderOne,Tick,3207,3157,50,-50,154400,154700,43960,-196260,-211260,OK
570.79992,TraderOne,Tick,3207,3157,50,-50,154400,154700,43960,-196260,-211260,OK
570.951682,TraderOne,Tick,3207,3157,50,-50,154400,154700,43960,-196260,-211260,OK
571.203228,TraderOne,Tick,3207,3167,40,-40,154600,155300,43806,-205106,-217106,OK
571.460229,TraderOne,Tick,3217,3167,50,-50,154800,155400,44115,-200415,-215415,OK
571.722058,TraderOne,Tick,3227,3177,50,-50,155000,155600,44270,-201570,-216570,OK
571.966045,TraderOne,Tick,3227,3177,50,-50,155000,155700,44270,-201570,-216570,OK
572.247272,TraderOne,Tick,3237,3177,60,-60,155100,155700,44580,-196880,-214880,OK
572.450152,TraderOne,Tick,3237,3187,50,-50,155100,155700,44890,-203190,-218190,OK
572.738021,TraderOne,Tick,3237,3187,50,-50,155200,155700,44890,-203190,-218190,OK
572.99099,TraderOne,Tick,3237,3187,50,-50,155200,155700,44890,-203190,-218190,OK
573.293901,TraderOne,Tick,3247,3187,60,-60,155000,155700,44735,-199035,-217035,OK
573.452193,TraderOne,Tick,3247,3197,50,-50,155700,155700,44579,-204879,-204879,OK
573.774883,TraderOne,Tick,3247,3197,50,-50,155000,155700,44579,-204879,-219879,OK
573.980767,TraderOne,Tick,3247,3197,50,-50,155000,155700,44579,-204879,-219879,OK
574.275652,TraderOne,Tick,3247,3197,50,-50,155000,155500,44579,-204879,-219879,OK
574.526693,TraderOne,Tick,3247,3197,50,-50,155000,155300,44579,-204879,-219879,OK
574.728098,TraderOne,Tick,3247,3207,40,-40,154900,155300,44889,-209189,-221189,OK
575.031989,TraderOne,Tick,3257,3217,40,-40,154600,155300,45044,-206344,-218344,OK
575.208704,TraderOne,Tick,3257,3217,40,-40,154600,155300,45044,-206344,-218344,OK
575.543094,TraderOne,Tick,3257,3217,40,-40,154600,155300,45044,-206344,-218344,OK
575.712698,TraderOne,Tick,3257,3217,40,-40,154600,155300,45044,-206344,-218344,OK
576.039137,TraderOne,Tick,3257,3217,40,-40,154600,155300,45044,-206344,-218344,OK
576.236707,TraderOne,Tick,3257,3217,40,-40,154600,155300,45044,-206344,-218344,OK
576.486601,TraderOne,Tick,3257,3217,40,-40,154600,155300,45044,-206344,-218344,OK
576.786892,TraderOne,Tick,3257,3217,40,-40,154600,155300,45044,-206344,-218344,OK
577.00219,TraderOne,Tick,3257,3217,40,-40,154600,155300,45044,-206344,-218344,OK
577.219566,TraderOne,Tick,3257,3217,40,-40,154600,155100,45044,-206344,-218344,OK
577.498891,TraderOne,Tick,3257,3227,30,-30,154900,155100,44889,-210189,-216189,OK
577.77651,TraderOne,Tick,3257,3230,27,-27,155100,155100,44982,-211182,-211182,OK
578.02209,TraderOne,Tick,3267,3230,37,-37,154600,155100,44827,-209027,-220127,OK
578.222977,TraderOne,Tick,3267,3230,37,-37,154600,155100,44827,-209027,-220127,OK
578.545228,TraderOne,Tick,3267,3230,37,-37,154600,155100,44827,-209027,-220127,OK
578.74395,TraderOne,Tick,3267,3230,37,-37,154600,155100,44827,-209027,-220127,OK
579.007215,TraderOne,Tick,3267,3230,37,-37,154600,155100,44827,-209027,-220127,OK
579.236687,TraderOne,Tick,3267,3230,37,-37,154600,155100,44827,-209027,-220127,OK
579.532349,TraderOne,Tick,3267,3230,37,-37,154600,155100,44827,-209027,-220127,OK
579.712041,TraderOne,Tick,3267,3230,37,-37,154600,155100,44827,-209027,-220127,OK
579.957136,TraderOne,Tick,3267,3230,37,-37,154600,155100,44827,-209027,-220127,OK
580.209571,TraderOne,Tick,3267,3230,37,-37,154600,155400,44827,-209027,-220127,OK
580.457098,TraderOne,Tick,3277,3230,47,-47,154600,155400,44672,-204872,-218972,OK
580.722955,TraderOne,Tick,3277,3230,47,-47,154600,155400,44672,-204872,-218972,OK
581.015855,TraderOne,Tick,3277,3240,37,-37,155300,155400,44517,-211717,-215417,OK
581.215633,TraderOne,Tick,3277,3250,27,-27,155200,155400,44827,-214027,-219427,OK
581.477937,TraderOne,Tick,3277,3260,17,-17,155500,155400,44672,-214872,-213172,OK
581.746867,TraderOne,Tick,3277,3260,17,-17,155500,155500,44672,-214872,-214872,OK
582.048948,TraderOne,Tick,3287,3260,27,-27,155500,155500,44983,-213183,-213183,OK
582.266934,TraderOne,Tick,3287,3260,27,-27,155500,155500,44983,-213183,-213183,OK
582.482418,TraderOne,Tick,3287,3260,27,-27,155500,155600,44983,-213183,-215883,OK
582.743896,TraderOne,Tick,3287,3260,27,-27,155500,155600,44983,-213183,-215883,OK
583.014644,TraderOne,Tick,3297,3260,37,-37,155200,155600,44828,-210028,-221128,OK
583.289892,TraderOne,Tick,3297,3260,37,-37,155200,155600,44828,-210028,-221128,OK
583.52933,TraderOne,Tick,3297,3270,27,-27,155200,155600,45138,-213338,-221438,OK
583.778644,TraderOne,Tick,3297,3280,17,-17,155700,155600,44983,-216183,-214483,OK
584.023444,TraderOne,Tick,3297,3280,17,-17,155700,155600,44983,-216183,-214483,OK
584.212413,TraderOne,Tick,3297,3290,7,-7,155800,155600,44827,-217027,-215627,OK
584.495373,TraderOne,Tick,3297,3290,7,-7,155800,155600,44827,-217027,-215627,OK
584.708001,TraderOne,Tick,3297,3290,7,-7,155800,155600,44827,-217027,-215627,OK
585.042129,TraderOne,Tick,3297,3290,7,-7,155800,155600,44827,-217027,-215627,OK
585.26843,TraderOne,Tick,3297,3290,7,-7,155800,155600,44827,-217027,-215627,OK
585.480649,TraderOne,Tick,3297,3290,7,-7,155800,155600,44827,-217027,-215627,OK
585.706625,TraderOne,Tick,3297,3290,7,-7,155800,155600,44827,-217027,-215627,OK
585.982561,TraderOne,Tick,3297,3290,7,-7,155800,155300,44827,-217027,-214927,OK
586.20881,TraderOne,Tick,3297,3290,7,-7,155800,155500,44827,-217027,-214927,OK
586.493047,TraderOne,Tick,3307,3290,17,-17,155200,155400,44672,-216872,-220272,OK
586.757451,TraderOne,Tick,3307,3290,17,-17,155200,155500,44672,-216872,-221972,OK
586.97569,TraderOne,Tick,3307,3290,17,-17,155200,155600,44672,-216872,-221972,OK
587.240059,TraderOne,Tick,3307,3290,17,-17,155200,155600,44672,-216872,-221972,OK
587.470323,TraderOne,Tick,3307,3290,17,-17,155200,155600,44672,-216872,-221972,OK
587.768043,TraderOne,Tick,3314,3290,24,-24,155400,155600,44563,-216063,-220863,OK
587.988254,TraderOne,Tick,3314,3290,24,-24,155400,155600,44563,-216063,-220863,OK
588.278106,TraderOne,Tick,3314,3290,24,-24,155400,155600,44563,-216063,-220863,OK
588.54938,TraderOne,Tick,3314,3300,14,-14,155900,155600,44874,-218374,-214174,OK
588.784239,TraderOne,Tick,3314,3300,14,-14,155900,155600,44874,-218374,-214174,OK
588.954056,TraderOne,Tick,3324,3300,24,-24,155200,155600,44718,-219218,-226418,OK
589.243586,TraderOne,Tick,3324,3300,24,-24,155200,155600,44718,-219218,-226418,OK
589.535936,TraderOne,Tick,3324,3300,24,-24,155200,155600,44718,-219218,-226418,OK
589.737569,TraderOne,Tick,3324,3300,24,-24,155200,155600,44718,-219218,-226418,OK
589.977637,TraderOne,Tick,3324,3300,24,-24,155200,155600,44718,-219218,-226418,OK
590.293985,TraderOne,Tick,3324,3300,24,-24,155200,155600,44718,-219218,-226418,OK
590.460574,TraderOne,Tick,3324,3300,24,-24,155200,155600,44718,-219218,-226418,OK
590.787237,TraderOne,Tick,3324,3310,14,-14,155200,155600,45028,-221528,-225728,OK
590.951543,TraderOne,Tick,3324,3320,4,-4,155200,155600,45338,-222838,-224038,OK
591.253134,TraderOne,Tick,3324,3320,4,-4,155200,155000,45338,-222838,-222038,OK
591.542753,TraderOne,Tick,3324,3328,-4,4,155200,155000,45586,-223086,-223886,OK
591.719687,TraderOne,Tick,3324,3328,-4,4,155200,155000,45586,-223086,-223886,OK
591.96881,TraderOne,Tick,3324,3328,-4,4,155200,155000,45586,-223086,-223886,OK
592.282104,TraderOne,Tick,3324,3328,-4,4,155200,155300,45586,-223086,-222686,OK
592.463361,TraderOne,Tick,3324,3328,-4,4,155200,155300,45586,-223086,-222686,OK
592.752554,TraderOne,Tick,3324,3328,-4,4,155200,155300,45586,-223086,-222686,OK
593.025807,TraderOne,Tick,3324,3328,-4,4,155200,155500,45586,-223086,-221886,OK
593.207945,TraderOne,Tick,3324,3328,-4,4,155200,155500,45586,-223086,-221886,OK
593.512632,TraderOne,Tick,3324,3337,-13,13,155700,155500,45446,-222046,-224646,OK
593.762501,TraderOne,Tick,3324,3337,-13,13,155700,155400,45446,-222046,-225946,OK
594.001633,TraderOne,Tick,3324,3344,-20,20,155600,155400,45337,-220537,-224537,OK
594.215103,TraderOne,Tick,3324,3344,-20,20,155600,155300,45337,-220537,-226537,OK
594.479279,TraderOne,Tick,3324,3344,-20,20,155600,155400,45337,-220537,-224537,OK
594.745263,TraderOne,Tick,3334,3344,-10,10,155600,155400,45181,-223381,-225381,OK
595.027715,TraderOne,Tick,3344,3344,0,0,155400,155400,45492,-224692,-224692,OK
595.234849,TraderOne,Tick,3344,3344,0,0,155400,155400,45492,-224692,-224692,OK
595.486437,TraderOne,Tick,3354,3344,10,-10,155300,155300,45803,-225003,-225003,OK
595.78753,TraderOne,Tick,3354,3349,5,-5,155300,155300,45725,-225425,-225425,OK
596.001879,TraderOne,Tick,3354,3349,5,-5,155300,155300,45725,-225425,-225425,OK
596.210317,TraderOne,Tick,3354,3349,5,-5,155300,155300,45725,-225425,-225425,OK
596.517084,TraderOne,Tick,3354,3349,5,-5,155300,155300,45725,-225425,-225425,OK
596.717101,TraderOne,Tick,3354,3349,5,-5,155300,155200,45725,-225425,-224925,OK
597.004297,TraderOne,Tick,3354,3349,5,-5,155300,155100,45725,-225425,-224425,OK
597.200809,TraderOne,Tick,3354,3349,5,-5,155300,155100,45725,-225425,-224425,OK
597.478794,TraderOne,Tick,3354,3349,5,-5,155300,155100,45725,-225425,-224425,OK
597.722896,TraderOne,Tick,3354,3349,5,-5,155300,155100,45725,-225425,-224425,OK
598.044339,TraderOne,Tick,3354,3359,-5,5,155100,155100,46035,-225735,-225735,OK
598.230602,TraderOne,Tick,3354,3359,-5,5,155100,155100,46035,-225735,-225735,OK
598.483283,TraderOne,Tick,3354,3369,-15,15,155100,154900,46345,-224045,-227045,OK
598.765961,TraderOne,Tick,3354,3369,-15,15,155100,155100,46345,-224045,-224045,OK
598.973882,TraderOne,Tick,3354,3377,-23,23,155400,155100,46221,-222321,-229221,OK
599.256527,TraderOne,Tick,3354,3377,-23,23,155400,155100,46221,-222321,-229221,OK
599.468775,TraderOne,Tick,3354,3387,-33,33,155600,155100,46066,-220166,-230066,OK
599.792132,TraderOne,Tick,3354,3387,-33,33,155600,155100,46066,-220166,-230066,OK
600.030465,TraderOne,Tick,3354,3387,-33,33,155600,155100,46066,-220166,-230066,OK
600.224377,TraderOne,Tick,3354,3387,-33,33,155600,155100,46066,-220166,-230066,OK
600.547147,TraderOne,Tick,3354,3389,-35,35,155500,155100,46035,-219335,-229835,OK
600.74529,TraderOne,Tick,3354,3389,-35,35,155500,155100,46035,-219335,-229835,OK
600.972199,TraderOne,Tick,3354,3389,-35,35,155500,155100,46035,-219335,-229835,OK
601.299337,TraderOne,Tick,3354,3389,-35,35,155500,155100,46035,-219335,-229835,OK
601.452593,TraderOne,Tick,3354,3389,-35,35,155500,155100,46035,-219335,-229835,OK
601.790269,TraderOne,Tick,3354,3389,-35,35,155500,155100,46035,-219335,-229835,OK
602.000778,TraderOne,Tick,3354,3397,-43,43,155800,155100,45911,-216811,-229711,OK
602.220428,TraderOne,Tick,3354,3397,-43,43,155800,155100,45911,-216811,-229711,OK
602.50223,TraderOne,Tick,3354,3397,-43,43,155800,155100,45911,-216811,-229711,OK
602.796052,TraderOne,Tick,3361,3397,-36,36,155600,155100,45802,-220202,-231002,OK
603.045259,TraderOne,Tick,3361,3397,-36,36,155600,155100,45802,-220202,-231002,OK
603.20187,TraderOne,Tick,3361,3397,-36,36,155600,155100,45802,-220202,-231002,OK
603.489117,TraderOne,Tick,3361,3397,-36,36,155600,155100,45802,-220202,-231002,OK
603.737882,TraderOne,Tick,3361,3397,-36,36,155600,155100,45802,-220202,-231002,OK
603.965977,TraderOne,Tick,3361,3397,-36,36,155600,155100,45802,-220202,-231002,OK
604.285146,TraderOne,Tick,3361,3397,-36,36,155600,155100,45802,-220202,-231002,OK
604.54739,TraderOne,Tick,3361,3397,-36,36,155600,155100,45802,-220202,-231002,OK
604.70579,TraderOne,Tick,3361,3397,-36,36,155600,155100,45802,-220202,-231002,OK
604.972735,TraderOne,Tick,3361,3397,-36,36,155600,155100,45802,-220202,-231002,OK
605.247659,TraderOne,Tick,3361,3407,-46,46,155300,154600,46113,-214513,-228313,OK
605.5399,TraderOne,Tick,3361,3417,-56,56,155000,154600,46423,-209823,-226623,OK
605.732671,TraderOne,Tick,3371,3417,-46,46,155000,154600,46733,-215133,-228933,OK
606.018713,TraderOne,Tick,3371,3417,-46,46,155000,154600,46733,-215133,-228933,OK
606.245696,TraderOne,Tick,3371,3417,-46,46,155000,154600,46733,-215133,-228933,OK
606.549827,TraderOne,Tick,3371,3417,-46,46,155000,154700,46733,-215133,-228933,OK
606.781747,TraderOne,Tick,3371,3417,-46,46,155000,154700,46733,-215133,-228933,OK
607.029377,TraderOne,Tick,3371,3417,-46,46,155000,154700,46733,-215133,-228933,OK
607.271238,TraderOne,Tick,3371,3417,-46,46,155000,155000,46733,-215133,-215133,OK
607.450938,TraderOne,Tick,3381,3417,-36,36,154900,155000,46577,-219977,-216377,OK
607.733809,TraderOne,Tick,3381,3417,-36,36,154900,155000,46577,-219977,-216377,OK
608.009271,TraderOne,Tick,3381,3417,-36,36,155500,155000,46577,-219977,-230777,OK
608.234017,TraderOne,Tick,3381,3417,-36,36,155500,155000,46577,-219977,-230777,OK
608.540667,TraderOne,Tick,3385,3417,-32,32,155600,155400,46515,-221115,-227515,OK
608.718783,TraderOne,Tick,3385,3417,-32,32,155600,155400,46515,-221115,-227515,OK
609.026992,TraderOne,Tick,3395,3417,-22,22,155800,155400,46827,-225427,-232027,OK
609.294505,TraderOne,Tick,3395,3417,-22,22,155800,155700,46827,-225427,-227627,OK
609.50366,TraderOne,Tick,3405,3417,-12,12,155500,155700,47139,-229739,-227339,OK
609.741381,TraderOne,Tick,3409,3417,-8,8,155100,155700,47263,-228663,-226263,OK
609.986779,TraderOne,Tick,3415,3417,-2,2,155000,155700,47170,-230970,-230370,OK
610.256458,TraderOne,Tick,3415,3417,-2,2,155000,155700,47170,-230970,-230370,OK
610.494468,TraderOne,Tick,3415,3417,-2,2,155000,155700,47170,-230970,-230370,OK
610.70728,TraderOne,Tick,3415,3417,-2,2,155000,155500,47170,-230970,-230370,OK
610.952988,TraderOne,Tick,3425,3417,8,-8,155800,155500,47014,-231814,-229414,OK
611.275266,TraderOne,Tick,3425,3417,8,-8,155800,155500,47014,-231814,-229414,OK
611.47716,TraderOne,Tick,3435,3417,18,-18,155900,155500,47326,-232126,-226726,OK
611.723944,TraderOne,Tick,3435,3417,18,-18,155900,155500,47326,-232126,-226726,OK
612.036818,TraderOne,Tick,3435,3417,18,-18,155900,155500,47326,-232126,-226726,OK
612.290855,TraderOne,Tick,3435,3417,18,-18,155900,156000,47326,-232126,-233926,OK
612.545805,TraderOne,Tick,3435,3427,8,-8,156000,156000,47170,-234970,-234970,OK
612.754487,TraderOne,Tick,3435,3427,8,-8,156000,156000,47170,-234970,-234970,OK
613.023517,TraderOne,Tick,3445,3427,18,-18,155400,156200,47014,-234814,-240214,OK
613.205809,TraderOne,Tick,3445,3427,18,-18,155400,156300,47014,-234814,-240214,OK
613.494344,TraderOne,Tick,3455,3427,28,-28,156000,156100,47326,-234126,-236926,OK
613.756276,TraderOne,Tick,3455,3427,28,-28,156000,156100,47326,-234126,-236926,OK
613.965846,TraderOne,Tick,3455,3427,28,-28,156000,156400,47326,-234126,-242526,OK
614.281776,TraderOne,Tick,3465,3427,38,-38,156000,156400,47638,-231438,-242838,OK
614.461816,TraderOne,Tick,3475,3427,48,-48,156000,156400,47950,-229750,-244150,OK
614.794642,TraderOne,Tick,3475,3427,48,-48,156000,156400,47950,-229750,-244150,OK
615.024173,TraderOne,Tick,3475,3427,48,-48,156000,156400,47950,-229750,-244150,OK
615.243445,TraderOne,Tick,3475,3427,48,-48,156000,156400,47950,-229750,-244150,OK
615.543894,TraderOne,Tick,3475,3427,48,-48,156000,156400,47950,-229750,-244150,OK
615.730356,TraderOne,Tick,3475,3427,48,-48,156000,156400,47950,-229750,-244150,OK
616.01294,TraderOne,Tick,3475,3427,48,-48,156000,156400,47950,-229750,-244150,OK
616.225257,TraderOne,Tick,3475,3427,48,-48,156000,156400,47950,-229750,-244150,OK
616.532751,TraderOne,Tick,3475,3427,48,-48,156000,156400,47950,-229750,-244150,OK
616.784326,TraderOne,Tick,3475,3427,48,-48,156000,156400,47950,-229750,-244150,OK
616.980905,TraderOne,Tick,3475,3427,48,-48,156000,156400,47950,-229750,-244150,OK
617.296173,TraderOne,Tick,3475,3427,48,-48,156000,156400,47950,-229750,-244150,OK
617.497601,TraderOne,Tick,3475,3427,48,-48,156000,155900,47950,-229750,-224950,OK
617.719214,TraderOne,Tick,3475,3427,48,-48,156000,155900,47950,-229750,-224950,OK
618.033626,TraderOne,Tick,3475,3427,48,-48,156000,155900,47950,-229750,-224950,OK
618.276077,TraderOne,Tick,3475,3427,48,-48,156000,155900,47950,-229750,-224950,OK
618.488723,TraderOne,Tick,3475,3427,48,-48,156000,155900,47950,-229750,-224950,OK
618.771551,TraderOne,Tick,3475,3427,48,-48,156000,155700,47950,-229750,-215350,OK
618.979511,TraderOne,Tick,3475,3437,38,-38,155400,155700,48261,-234061,-245461,OK
619.274414,TraderOne,Tick,3485,3437,48,-48,155000,155600,48106,-231906,-246306,OK
619.459289,TraderOne,Tick,3485,3437,48,-48,155000,155600,48106,-231906,-246306,OK
619.77933,TraderOne,Tick,3485,3447,38,-38,156000,155600,47951,-234751,-223351,OK
620.038986,TraderOne,Tick,3485,3454,31,-31,155400,155600,47842,-236742,-242942,OK
620.209515,TraderOne,Tick,3485,3454,31,-31,155400,155600,47842,-236742,-242942,OK
620.480999,TraderOne,Tick,3485,3454,31,-31,155400,155600,47842,-236742,-242942,OK
620.781311,TraderOne,Tick,3485,3454,31,-31,155400,155700,47842,-236742,-246042,OK
620.968259,TraderOne,Tick,3494,3454,40,-40,155300,155700,47702,-233002,-245002,OK
621.209119,TraderOne,Tick,3494,3454,40,-40,155300,155700,47702,-233002,-245002,OK
621.550168,TraderOne,Tick,3494,3454,40,-40,155300,155700,47702,-233002,-245002,OK
621.705147,TraderOne,Tick,3504,3454,50,-50,155400,155700,47546,-228846,-243846,OK
622.002047,TraderOne,Tick,3504,3454,50,-50,155400,156200,47546,-228846,-243846,OK
622.232622,TraderOne,Tick,3504,3454,50,-50,155400,156200,47546,-228846,-243846,OK
622.542371,TraderOne,Tick,3504,3454,50,-50,155400,156200,47546,-228846,-243846,OK
622.746358,TraderOne,Tick,3504,3464,40,-40,156400,156200,47390,-233690,-225690,OK
623.014119,TraderOne,Tick,3504,3464,40,-40,156400,156200,47390,-233690,-225690,OK
623.243813,TraderOne,Tick,3504,3464,40,-40,156400,156200,47390,-233690,-225690,OK
623.510475,TraderOne,Tick,3504,3464,40,-40,156400,156200,47390,-233690,-225690,OK
623.717461,TraderOne,Tick,3504,3474,30,-30,156400,156200,47234,-237534,-231534,OK
624.028797,TraderOne,Tick,3504,3474,30,-30,156400,156200,47234,-237534,-231534,OK
624.201426,TraderOne,Tick,3504,3474,30,-30,156400,155900,47234,-237534,-228534,OK
624.510776,TraderOne,Tick,3504,3484,20,-20,156000,155900,47078,-240378,-238378,OK
624.767963,TraderOne,Tick,3504,3484,20,-20,156000,155900,47078,-240378,-238378,OK
625.020406,TraderOne,Tick,3504,3484,20,-20,156000,155900,47078,-240378,-238378,OK
625.267419,TraderOne,Tick,3504,3484,20,-20,156000,155900,47078,-240378,-238378,OK
625.51886,TraderOne,Tick,3504,3484,20,-20,156000,155500,47078,-240378,-234378,OK
625.71183,TraderOne,Tick,3504,3484,20,-20,156000,155400,47078,-240378,-234378,OK
625.97564,TraderOne,Tick,3504,3484,20,-20,156000,155200,47078,-240378,-234378,OK
626.290885,TraderOne,Tick,3504,3494,10,-10,155200,155200,47388,-242688,-242688,OK
626.50831,TraderOne,Tick,3504,3494,10,-10,155200,155200,47388,-242688,-242688,OK
626.745811,TraderOne,Tick,3504,3494,10,-10,155200,155200,47388,-242688,-242688,OK
626.998879,TraderOne,Tick,3504,3494,10,-10,155200,155200,47388,-242688,-242688,OK
627.233874,TraderOne,Tick,3504,3494,10,-10,155200,155500,47388,-242688,-245688,OK
627.54821,TraderOne,Tick,3504,3494,10,-10,155200,155500,47388,-242688,-245688,OK
627.743446,TraderOne,Tick,3504,3494,10,-10,155200,155500,47388,-242688,-245688,OK
627.973368,TraderOne,Tick,3504,3494,10,-10,155200,155500,47388,-242688,-245688,OK
628.221894,TraderOne,Tick,3504,3494,10,-10,155200,155800,47388,-242688,-245688,OK
628.535919,TraderOne,Tick,3504,3494,10,-10,155200,155800,47388,-242688,-245688,OK
628.709805,TraderOne,Tick,3504,3494,10,-10,155200,155800,47388,-242688,-245688,OK
628.993443,TraderOne,Tick,3504,3494,10,-10,155200,155800,47388,-242688,-245688,OK
629.212215,TraderOne,Tick,3504,3494,10,-10,155200,155800,47388,-242688,-245688,OK
629.483061,TraderOne,Tick,3504,3494,10,-10,156000,155800,47388,-242688,-240688,OK
629.799626,TraderOne,Tick,3504,3494,10,-10,156000,155800,47388,-242688,-240688,OK
629.956706,TraderOne,Tick,3504,3494,10,-10,156000,155800,47388,-242688,-240688,OK
630.281206,TraderOne,Tick,3504,3494,10,-10,156000,155800,47388,-242688,-240688,OK
630.525186,TraderOne,Tick,3504,3494,10,-10,156000,155800,47388,-242688,-240688,OK
630.772273,TraderOne,Tick,3504,3494,10,-10,156000,155700,47388,-242688,-239688,OK
630.984815,TraderOne,Tick,3504,3494,10,-10,156000,155700,47388,-242688,-239688,OK
631.254498,TraderOne,Tick,3504,3504,0,0,155900,155700,47232,-244532,-244532,OK
631.463544,TraderOne,Tick,3504,3504,0,0,155900,155700,47232,-244532,-244532,OK
631.705507,TraderOne,Tick,3504,3504,0,0,155900,155700,47232,-244532,-244532,OK
632.022717,TraderOne,Tick,3514,3504,10,-10,156000,156000,47544,-244844,-244844,OK
632.273802,TraderOne,Tick,3514,3514,0,0,156000,156000,47856,-246156,-246156,OK
632.524149,TraderOne,Tick,3514,3514,0,0,156000,156000,47856,-246156,-246156,OK
632.782928,TraderOne,Tick,3514,3514,0,0,156000,156000,47856,-246156,-246156,OK
633.046024,TraderOne,Tick,3514,3514,0,0,156000,155800,47856,-246156,-246156,OK
633.229304,TraderOne,Tick,3514,3524,-10,10,155900,155800,48168,-245468,-246468,OK
633.495984,TraderOne,Tick,3514,3534,-20,20,155900,155800,48480,-244780,-246780,OK
633.729633,TraderOne,Tick,3514,3534,-20,20,155900,155800,48480,-244780,-246780,OK
634.035878,TraderOne,Tick,3524,3534,-10,10,155600,155800,48324,-246624,-244624,OK
634.291126,TraderOne,Tick,3524,3534,-10,10,155600,155800,48324,-246624,-244624,OK
634.503762,TraderOne,Tick,3524,3534,-10,10,155600,155800,48324,-246624,-244624,OK
634.768275,TraderOne,Tick,3524,3534,-10,10,155600,155800,48324,-246624,-244624,OK
635.034435,TraderOne,Tick,3524,3534,-10,10,155600,155800,48324,-246624,-244624,OK
635.258114,TraderOne,Tick,3544,3534,10,-10,155700,155800,48479,-248779,-249779,OK
635.525563,TraderOne,Tick,3544,3534,10,-10,155700,155800,48479,-248779,-249779,OK
635.701043,TraderOne,Tick,3544,3534,10,-10,155700,155800,48479,-248779,-249779,OK
635.97009,TraderOne,Tick,3544,3534,10,-10,155600,155800,48479,-248779,-250779,OK
636.23864,TraderOne,Tick,3544,3534,10,-10,155600,155800,48479,-248779,-250779,OK
636.529858,TraderOne,Tick,3544,3534,10,-10,155600,155900,48479,-248779,-251779,OK
636.729991,TraderOne,Tick,3544,3534,10,-10,155600,155900,48479,-248779,-251779,OK
636.973939,TraderOne,Tick,3544,3534,10,-10,155600,155900,48479,-248779,-251779,OK
637.207679,TraderOne,Tick,3544,3534,10,-10,155600,155900,48479,-248779,-251779,OK
637.508148,TraderOne,Tick,3544,3534,10,-10,155600,155900,48479,-248779,-251779,OK
637.724483,TraderOne,Tick,3554,3534,20,-20,155700,155900,48790,-248090,-252090,OK
638.004254,TraderOne,Tick,3564,3534,30,-30,155700,155900,49101,-246401,-252401,OK
638.297173,TraderOne,Tick,3574,3534,40,-40,155400,155900,48945,-243245,-255245,OK
638.528786,TraderOne,Tick,3574,3544,30,-30,155800,155900,48789,-249089,-252089,OK
638.704362,TraderOne,Tick,3584,3544,40,-40,155800,155900,49101,-245401,-249401,OK
638.97935,TraderOne,Tick,3584,3544,40,-40,155800,155900,49101,-245401,-249401,OK
639.276909,TraderOne,Tick,3584,3544,40,-40,155800,155900,49101,-245401,-249401,OK
639.522938,TraderOne,Tick,3584,3544,40,-40,155800,155900,49101,-245401,-249401,OK
639.724843,TraderOne,Tick,3584,3544,40,-40,155800,155900,49101,-245401,-249401,OK
639.980191,TraderOne,Tick,3584,3544,40,-40,155800,155900,49101,-245401,-249401,OK
640.295,TraderOne,Tick,3584,3544,40,-40,155800,155900,49101,-245401,-249401,OK
640.4554,TraderOne,Tick,3584,3544,40,-40,155800,155900,49101,-245401,-249401,OK
640.794354,TraderOne,Tick,3584,3554,30,-30,155500,155900,48945,-246245,-255245,OK
641.000988,TraderOne,Tick,3584,3554,30,-30,156100,155900,48945,-246245,-240245,OK
641.244452,TraderOne,Tick,3584,3564,20,-20,155500,155900,49256,-249556,-255556,OK
641.504919,TraderOne,Tick,3584,3564,20,-20,155500,155700,49256,-249556,-253556,OK
641.713177,TraderOne,Tick,3584,3564,20,-20,155500,155700,49256,-249556,-253556,OK
641.984844,TraderOne,Tick,3584,3564,20,-20,155500,156000,49256,-249556,-255556,OK
642.202412,TraderOne,Tick,3584,3574,10,-10,156100,156000,49100,-251400,-250400,OK
642.482539,TraderOne,Tick,3584,3574,10,-10,156100,156000,49100,-251400,-250400,OK
642.794651,TraderOne,Tick,3594,3574,20,-20,155600,156000,49412,-248712,-254712,OK
642.997264,TraderOne,Tick,3604,3574,30,-30,155900,156500,49724,-247024,-256024,OK
643.280395,TraderOne,Tick,3614,3574,40,-40,155900,156500,50036,-243336,-255336,OK
643.539817,TraderOne,Tick,3624,3574,50,-50,155900,156500,50348,-237648,-252648,OK
643.721908,TraderOne,Tick,3624,3574,50,-50,156100,156500,50348,-237648,-252648,OK
643.993207,TraderOne,Tick,3624,3574,50,-50,156100,156700,50348,-237648,-252648,OK
644.253434,TraderOne,Tick,3634,3574,60,-60,156100,157100,50660,-230960,-248960,OK
644.505165,TraderOne,Tick,3644,3574,70,-70,156400,157000,50973,-225273,-246273,OK
644.792067,TraderOne,Tick,3644,3584,60,-60,156400,157000,51286,-230586,-248586,OK
644.988913,TraderOne,Tick,3644,3594,50,-50,156200,157000,51598,-236898,-251898,OK
645.263185,TraderOne,Tick,3644,3604,40,-40,156600,157000,51442,-241742,-253742,OK
645.452685,TraderOne,Tick,3644,3604,40,-40,156600,157000,51442,-241742,-253742,OK
645.748757,TraderOne,Tick,3644,3604,40,-40,156600,157000,51442,-241742,-253742,OK
646.004897,TraderOne,Tick,3644,3604,40,-40,156600,156400,51442,-241742,-233742,OK
646.287639,TraderOne,Tick,3644,3604,40,-40,156600,156400,51442,-241742,-233742,OK
646.497523,TraderOne,Tick,3644,3604,40,-40,156600,156400,51442,-241742,-233742,OK
646.754775,TraderOne,Tick,3644,3604,40,-40,156600,156400,51442,-241742,-233742,OK
647.007077,TraderOne,Tick,3644,3604,40,-40,156600,156400,51442,-241742,-233742,OK
647.265458,TraderOne,Tick,3644,3614,30,-30,156100,156400,51286,-245586,-254586,OK
647.532085,TraderOne,Tick,3644,3614,30,-30,156100,156300,51286,-245586,-251586,OK
647.786202,TraderOne,Tick,3644,3614,30,-30,156100,156300,51286,-245586,-251586,OK
648.000729,TraderOne,Tick,3644,3614,30,-30,156100,156300,51286,-245586,-251586,OK
648.228812,TraderOne,Tick,3644,3614,30,-30,156100,156200,51286,-245586,-248586,OK
648.499993,TraderOne,Tick,3644,3614,30,-30,156100,156000,51286,-245586,-242586,OK
648.766512,TraderOne,Tick,3644,3614,30,-30,156100,156000,51286,-245586,-242586,OK
648.981002,TraderOne,Tick,3644,3614,30,-30,156100,156000,51286,-245586,-242586,OK
649.201245,TraderOne,Tick,3644,3614,30,-30,156100,156000,51286,-245586,-242586,OK
649.504074,TraderOne,Tick,3644,3624,20,-20,156600,156000,51130,-249430,-243430,OK
649.753181,TraderOne,Tick,3644,3634,10,-10,156600,156000,50974,-251274,-248274,OK
650.01399,TraderOne,Tick,3644,3634,10,-10,156600,156000,50974,-251274,-248274,OK
650.232509,TraderOne,Tick,3644,3634,10,-10,156600,156000,50974,-251274,-248274,OK
650.521745,TraderOne,Tick,3644,3634,10,-10,156600,156000,50974,-251274,-248274,OK
650.764146,TraderOne,Tick,3644,3634,10,-10,156600,155900,50974,-251274,-248274,OK
650.970121,TraderOne,Tick,3654,3634,20,-20,155500,155800,50818,-250118,-256118,OK
651.223004,TraderOne,Tick,3654,3634,20,-20,155500,155800,50818,-250118,-256118,OK
651.54064,TraderOne,Tick,3654,3654,0,0,156000,155800,50974,-249274,-249274,OK
651.748179,TraderOne,Tick,3654,3664,-10,10,156000,155800,51286,-248586,-250586,OK
652.015216,TraderOne,Tick,3654,3674,-20,20,156000,155800,51598,-247898,-251898,OK
652.225035,TraderOne,Tick,3654,3674,-20,20,156000,155800,51598,-247898,-251898,OK
652.528326,TraderOne,Tick,3654,3684,-30,30,156000,155700,51910,-246210,-255210,OK
652.776962,TraderOne,Tick,3654,3684,-30,30,156000,155700,51910,-246210,-255210,OK
652.978405,TraderOne,Tick,3654,3684,-30,30,156000,155700,51910,-246210,-255210,OK
653.244713,TraderOne,Tick,3654,3684,-30,30,156000,155800,51910,-246210,-252210,OK
653.492234,TraderOne,Tick,3654,3684,-30,30,156000,155800,51910,-246210,-252210,OK
653.749654,TraderOne,Tick,3654,3684,-30,30,156000,155800,51910,-246210,-252210,OK
654.003876,TraderOne,Tick,3654,3684,-30,30,156000,155800,51910,-246210,-252210,OK
654.262371,TraderOne,Tick,3654,3684,-30,30,156000,155800,51910,-246210,-252210,OK
654.479201,TraderOne,Tick,3654,3684,-30,30,156000,155800,51910,-246210,-252210,OK
654.741492,TraderOne,Tick,3654,3684,-30,30,156000,155800,51910,-246210,-252210,OK
655.022867,TraderOne,Tick,3654,3684,-30,30,156000,155800,51910,-246210,-252210,OK
655.291876,TraderOne,Tick,3654,3684,-30,30,156000,155700,51910,-246210,-255210,OK
655.540716,TraderOne,Tick,3654,3694,-40,40,156300,155700,51754,-243054,-255054,OK
655.77248,TraderOne,Tick,3654,3694,-40,40,156300,155700,51754,-243054,-255054,OK
656.007714,TraderOne,Tick,3654,3694,-40,40,156300,155700,51754,-243054,-255054,OK
656.221865,TraderOne,Tick,3654,3694,-40,40,156300,155700,51754,-243054,-255054,OK
656.519118,TraderOne,Tick,3654,3694,-40,40,156300,155800,51754,-243054,-255054,OK
656.709652,TraderOne,Tick,3654,3694,-40,40,156300,155800,51754,-243054,-255054,OK
656.979535,TraderOne,Tick,3664,3694,-30,30,155500,155800,51598,-246898,-237898,OK
657.299254,TraderOne,Tick,3674,3694,-20,20,156000,155800,51442,-248742,-252742,OK
657.511887,TraderOne,Tick,3681,3694,-13,13,155600,155800,51660,-246860,-244260,OK
657.799812,TraderOne,Tick,3681,3704,-23,23,156600,155800,51504,-244704,-251604,OK
658.021577,TraderOne,Tick,3681,3714,-33,33,156600,155800,51348,-241548,-251448,OK
658.218264,TraderOne,Tick,3681,3714,-33,33,156600,155800,51348,-241548,-251448,OK
658.540721,TraderOne,Tick,3681,3714,-33,33,156600,155800,51348,-241548,-251448,OK
658.714133,TraderOne,Tick,3691,3714,-23,23,155500,155800,51192,-245392,-238492,OK
659.012262,TraderOne,Tick,3691,3714,-23,23,155500,155800,51192,-245392,-238492,OK
659.299459,TraderOne,Tick,3691,3714,-23,23,155500,155800,51192,-245392,-238492,OK
659.527947,TraderOne,Tick,3701,3714,-13,13,156200,155800,51504,-248704,-252604,OK
659.798719,TraderOne,Tick,3701,3714,-13,13,156200,155800,51504,-248704,-252604,OK
659.996945,TraderOne,Tick,3701,3714,-13,13,156200,155800,51504,-248704,-252604,OK
660.300397,TraderOne,Tick,3701,3714,-13,13,156200,155900,51504,-248704,-252604,OK
660.493367,TraderOne,Tick,3701,3714,-13,13,156200,156100,51504,-248704,-250004,OK
660.796356,TraderOne,Tick,3711,3714,-3,3,156200,156100,51816,-250016,-250316,OK
661.009619,TraderOne,Tick,3721,3714,7,-7,156200,156100,52128,-251328,-250628,OK
661.277275,TraderOne,Tick,3721,3714,7,-7,156200,156000,52128,-251328,-249928,OK
661.541686,TraderOne,Tick,3721,3714,7,-7,156200,156000,52128,-251328,-249928,OK
661.721894,TraderOne,Tick,3721,3724,-3,3,156200,156000,51972,-253172,-253772,OK
662.014801,TraderOne,Tick,3721,3724,-3,3,156200,156000,51972,-253172,-253772,OK
662.253984,TraderOne,Tick,3721,3724,-3,3,156200,156000,51972,-253172,-253772,OK
662.456317,TraderOne,Tick,3721,3724,-3,3,156200,156000,51972,-253172,-253772,OK
662.709113,TraderOne,Tick,3731,3724,7,-7,155900,156000,51816,-254016,-254716,OK
662.995083,TraderOne,Tick,3731,3724,7,-7,155900,156000,51816,-254016,-254716,OK
663.28183,TraderOne,Tick,3731,3724,7,-7,155900,156000,51816,-254016,-254716,OK
663.510496,TraderOne,Tick,3731,3734,-3,3,156200,155900,51660,-253860,-254760,OK
663.747873,TraderOne,Tick,3731,3734,-3,3,156200,155900,51660,-253860,-254760,OK
664.0235,TraderOne,Tick,3731,3734,-3,3,156200,155900,51660,-253860,-254760,OK
664.237176,TraderOne,Tick,3731,3734,-3,3,156200,155900,51660,-253860,-254760,OK
664.549706,TraderOne,Tick,3741,3734,7,-7,155700,155800,51504,-254704,-255404,OK
664.734276,TraderOne,Tick,3741,3734,7,-7,155700,155800,51504,-254704,-255404,OK
664.969353,TraderOne,Tick,3741,3734,7,-7,155700,155800,51504,-254704,-255404,OK
665.23764,TraderOne,Tick,3741,3734,7,-7,155700,155900,51504,-254704,-256104,OK
665.460789,TraderOne,Tick,3741,3734,7,-7,155700,155900,51504,-254704,-256104,OK
665.798693,TraderOne,Tick,3741,3734,7,-7,155700,155900,51504,-254704,-256104,OK
665.993219,TraderOne,Tick,3741,3734,7,-7,155700,155900,51504,-254704,-256104,OK
666.223036,TraderOne,Tick,3741,3744,-3,3,156500,155900,51348,-255548,-256448,OK
666.511377,TraderOne,Tick,3741,3744,-3,3,156500,155900,51348,-255548,-256448,OK
666.716026,TraderOne,Tick,3741,3744,-3,3,156500,155900,51348,-255548,-256448,OK
667.022308,TraderOne,Tick,3741,3754,-13,13,156700,156600,51192,-260392,-261692,OK
667.294617,TraderOne,Tick,3751,3754,-3,3,156800,156800,51506,-262706,-262706,OK
667.515213,TraderOne,Tick,3751,3754,-3,3,156800,156800,51506,-262706,-262706,OK
667.788098,TraderOne,Tick,3761,3754,7,-7,156800,156800,51820,-264020,-264020,OK
667.990506,TraderOne,Tick,3761,3754,7,-7,156800,156800,51820,-264020,-264020,OK
668.211953,TraderOne,Tick,3761,3754,7,-7,156800,156800,51820,-264020,-264020,OK
668.535126,TraderOne,Tick,3761,3764,-3,3,156800,156400,52133,-264333,-265233,OK
668.767481,TraderOne,Tick,3761,3774,-13,13,156700,156400,52446,-263646,-267546,OK
669.016558,TraderOne,Tick,3761,3774,-13,13,156700,156400,52446,-263646,-267546,OK
669.245234,TraderOne,Tick,3761,3774,-13,13,156700,156400,52446,-263646,-267546,OK
669.514381,TraderOne,Tick,3761,3774,-13,13,156700,156400,52446,-263646,-267546,OK
669.796343,TraderOne,Tick,3771,3774,-3,3,156100,156400,52290,-265490,-264590,OK
670.045174,TraderOne,Tick,3771,3774,-3,3,156100,156400,52290,-265490,-264590,OK
670.203202,TraderOne,Tick,3771,3774,-3,3,156100,156300,52290,-265490,-264890,OK
670.474123,TraderOne,Tick,3771,3774,-3,3,156100,156400,52290,-265490,-264590,OK
670.797696,TraderOne,Tick,3771,3774,-3,3,156100,156400,52290,-265490,-264590,OK
671.039573,TraderOne,Tick,3771,3774,-3,3,156100,156400,52290,-265490,-264590,OK
671.26354,TraderOne,Tick,3771,3774,-3,3,156100,156400,52290,-265490,-264590,OK
671.534603,TraderOne,Tick,3771,3774,-3,3,156100,156400,52290,-265490,-264590,OK
671.75017,TraderOne,Tick,3771,3774,-3,3,156100,156200,52290,-265490,-265190,OK
671.954537,TraderOne,Tick,3771,3774,-3,3,156100,156200,52290,-265490,-265190,OK
672.274661,TraderOne,Tick,3771,3774,-3,3,156100,156200,52290,-265490,-265190,OK
672.496015,TraderOne,Tick,3771,3784,-13,13,156100,156200,52602,-264802,-263502,OK
672.787777,TraderOne,Tick,3771,3786,-15,15,156700,156200,52571,-264571,-269071,OK
673.038841,TraderOne,Tick,3771,3786,-15,15,156700,156200,52571,-264571,-269071,OK
673.236845,TraderOne,Tick,3771,3786,-15,15,156700,156200,52571,-264571,-269071,OK
673.493337,TraderOne,Tick,3771,3786,-15,15,156700,156200,52571,-264571,-269071,OK
673.772226,TraderOne,Tick,3771,3786,-15,15,156700,156200,52571,-264571,-269071,OK
673.997936,TraderOne,Tick,3781,3786,-5,5,156100,156200,52415,-266415,-265915,OK
674.25198,TraderOne,Tick,3781,3786,-5,5,156100,156200,52415,-266415,-265915,OK
674.530951,TraderOne,Tick,3781,3786,-5,5,156100,156200,52415,-266415,-265915,OK
674.772524,TraderOne,Tick,3781,3786,-5,5,156100,155800,52415,-266415,-267915,OK
675.038081,TraderOne,Tick,3781,3796,-15,15,156600,155800,52727,-263727,-268227,OK
675.273761,TraderOne,Tick,3781,3796,-15,15,156600,155800,52727,-263727,-268227,OK
675.475017,TraderOne,Tick,3781,3796,-15,15,156600,155800,52727,-263727,-268227,OK
675.79979,TraderOne,Tick,3781,3806,-25,25,156200,155800,53039,-263039,-270539,OK
676.027494,TraderOne,Tick,3781,3806,-25,25,156200,155800,53039,-263039,-270539,OK
676.251135,TraderOne,Tick,3781,3806,-25,25,156200,155800,53039,-263039,-270539,OK
676.500806,TraderOne,Tick,3791,3806,-15,15,155700,155800,52883,-265883,-264383,OK
676.719912,TraderOne,Tick,3801,3806,-5,5,155700,155800,52727,-268727,-268227,OK
677.045508,TraderOne,Tick,3811,3806,5,-5,155700,155800,53038,-267038,-267538,OK
677.279361,TraderOne,Tick,3821,3806,15,-15,155700,155800,53349,-265349,-266849,OK
677.519595,TraderOne,Tick,3831,3806,25,-25,155700,155800,53660,-264660,-267160,OK
677.718295,TraderOne,Tick,3831,3806,25,-25,155700,155800,53660,-264660,-267160,OK
677.97763,TraderOne,Tick,3831,3806,25,-25,155700,155900,53660,-264660,-269660,OK
678.240178,TraderOne,Tick,3841,3806,35,-35,155700,155900,53971,-262971,-269971,OK
678.476719,TraderOne,Tick,3841,3806,35,-35,155700,155900,53971,-262971,-269971,OK
678.772605,TraderOne,Tick,3841,3806,35,-35,155600,155900,53971,-262971,-273471,OK
678.992287,TraderOne,Tick,3841,3816,25,-25,155500,155900,54282,-265582,-273082,OK
679.27883,TraderOne,Tick,3841,3816,25,-25,155500,155700,54282,-265582,-270582,OK
679.472164,TraderOne,Tick,3841,3826,15,-15,155700,155700,54593,-267893,-267893,OK
679.751872,TraderOne,Tick,3841,3826,15,-15,155700,155700,54593,-267893,-267893,OK
680.037935,TraderOne,Tick,3841,3826,15,-15,155700,155700,54593,-267893,-267893,OK
680.277882,TraderOne,Tick,3841,3836,5,-5,155700,155700,54437,-268737,-268737,OK
680.489087,TraderOne,Tick,3851,3846,5,-5,155500,155600,54593,-266893,-267393,OK
680.778909,TraderOne,Tick,3853,3846,7,-7,155500,155600,54562,-266862,-267562,OK
681.013224,TraderOne,Tick,3853,3846,7,-7,155500,155600,54562,-266862,-267562,OK
681.258367,TraderOne,Tick,3853,3846,7,-7,155500,155600,54562,-266862,-267562,OK
681.511743,TraderOne,Tick,3853,3846,7,-7,155500,155600,54562,-266862,-267562,OK
681.716876,TraderOne,Tick,3853,3852,1,-1,155700,155600,54469,-266769,-266669,OK
682.016636,TraderOne,Tick,3853,3852,1,-1,155700,155600,54469,-266769,-266669,OK
682.244435,TraderOne,Tick,3853,3852,1,-1,155700,155700,54469,-266769,-266769,OK
682.487102,TraderOne,Tick,3853,3852,1,-1,155700,155700,54469,-266769,-266769,OK
682.740202,TraderOne,Tick,3853,3862,-9,9,156200,155400,54313,-263613,-266313,OK
683.031275,TraderOne,Tick,3853,3862,-9,9,156200,155400,54313,-263613,-266313,OK
683.297549,TraderOne,Tick,3853,3862,-9,9,156200,155400,54313,-263613,-266313,OK
683.53383,TraderOne,Tick,3853,3862,-9,9,156200,155400,54313,-263613,-266313,OK
683.7895,TraderOne,Tick,3853,3862,-9,9,156200,155400,54313,-263613,-266313,OK
684.027881,TraderOne,Tick,3853,3872,-19,19,155500,155400,54157,-262457,-264357,OK
684.23648,TraderOne,Tick,3863,3872,-9,9,155300,155400,54002,-263302,-262402,OK
684.47341,TraderOne,Tick,3863,3872,-9,9,155300,155400,54002,-263302,-262402,OK
684.711817,TraderOne,Tick,3863,3872,-9,9,155300,155400,54002,-263302,-262402,OK
685.04693,TraderOne,Tick,3863,3872,-9,9,155300,155400,54002,-263302,-262402,OK
685.262512,TraderOne,Tick,3863,3872,-9,9,155300,155400,54002,-263302,-262402,OK
685.48603,TraderOne,Tick,3863,3872,-9,9,155300,155400,54002,-263302,-262402,OK
685.759024,TraderOne,Tick,3863,3872,-9,9,155300,155500,54002,-263302,-261502,OK
686.033581,TraderOne,Tick,3863,3872,-9,9,155300,155500,54002,-263302,-261502,OK
686.263003,TraderOne,Tick,3873,3872,1,-1,155600,155600,54313,-263613,-263613,OK
686.459851,TraderOne,Tick,3883,3872,11,-11,155600,155600,54624,-263924,-263924,OK
686.780861,TraderOne,Tick,3883,3882,1,-1,155700,155600,54468,-264468,-264368,OK
687.027571,TraderOne,Tick,3883,3882,1,-1,155700,155600,54468,-264468,-264368,OK
687.279031,TraderOne,Tick,3883,3882,1,-1,155700,155600,54468,-264468,-264368,OK
687.538062,TraderOne,Tick,3883,3882,1,-1,155700,155200,54468,-264468,-264168,OK
687.73292,TraderOne,Tick,3883,3892,-9,9,155300,155200,54779,-262779,-263679,OK
687.995106,TraderOne,Tick,3883,3902,-19,19,155300,155000,55090,-261090,-266790,OK
688.236542,TraderOne,Tick,3883,3912,-29,29,155300,155000,55401,-259401,-268101,OK
688.501045,TraderOne,Tick,3883,3912,-29,29,155300,155000,55401,-259401,-268101,OK
688.701016,TraderOne,Tick,3883,3912,-29,29,155300,155000,55401,-259401,-268101,OK
688.992707,TraderOne,Tick,3883,3912,-29,29,155300,155000,55401,-259401,-268101,OK
689.285662,TraderOne,Tick,3883,3912,-29,29,155300,155000,55401,-259401,-268101,OK
689.549308,TraderOne,Tick,3883,3922,-39,39,155300,155000,55246,-256246,-267946,OK
689.746175,TraderOne,Tick,3883,3922,-39,39,155300,155000,55246,-256246,-267946,OK
689.99481,TraderOne,Tick,3883,3922,-39,39,155300,155000,55246,-256246,-267946,OK
690.284523,TraderOne,Tick,3883,3922,-39,39,155300,155100,55246,-256246,-264046,OK
690.458356,TraderOne,Tick,3883,3922,-39,39,155300,155200,55246,-256246,-260146,OK
690.710915,TraderOne,Tick,3883,3922,-39,39,155300,155200,55246,-256246,-260146,OK
690.965493,TraderOne,Tick,3883,3922,-39,39,155300,155200,55246,-256246,-260146,OK
691.221686,TraderOne,Tick,3883,3922,-39,39,155300,155200,55246,-256246,-260146,OK
691.497557,TraderOne,Tick,3883,3922,-39,39,155300,155200,55246,-256246,-260146,OK
691.770636,TraderOne,Tick,3883,3922,-39,39,155300,155200,55246,-256246,-260146,OK
692.019452,TraderOne,Tick,3893,3922,-29,29,155200,155200,55090,-261090,-261090,OK
692.233226,TraderOne,Tick,3893,3922,-29,29,155200,155200,55090,-261090,-261090,OK
692.46272,TraderOne,Tick,3893,3922,-29,29,155200,155200,55090,-261090,-261090,OK
692.789594,TraderOne,Tick,3903,3932,-29,29,155500,155200,54779,-260779,-269479,OK
692.985058,TraderOne,Tick,3903,3932,-29,29,155500,155200,54779,-260779,-269479,OK
693.21221,TraderOne,Tick,3903,3942,-39,39,155500,155200,55090,-259090,-270790,OK
693.501963,TraderOne,Tick,3903,3942,-39,39,155500,155200,55090,-259090,-270790,OK
693.770661,TraderOne,Tick,3913,3942,-29,29,155200,155100,54934,-263934,-266834,OK
694.030608,TraderOne,Tick,3913,3942,-29,29,155200,155100,54934,-263934,-266834,OK
694.203191,TraderOne,Tick,3913,3942,-29,29,155200,155100,54934,-263934,-266834,OK
694.52095,TraderOne,Tick,3913,3942,-29,29,155200,155100,54934,-263934,-266834,OK
694.764068,TraderOne,Tick,3913,3942,-29,29,155200,155100,54934,-263934,-266834,OK
694.952171,TraderOne,Tick,3913,3942,-29,29,155200,155100,54934,-263934,-266834,OK
695.212477,TraderOne,Tick,3913,3942,-29,29,155200,155100,54934,-263934,-266834,OK
695.491432,TraderOne,Tick,3913,3942,-29,29,155200,155100,54934,-263934,-266834,OK
695.796643,TraderOne,Tick,3923,3942,-19,19,155200,155100,54779,-266779,-268679,OK
695.966607,TraderOne,Tick,3923,3942,-19,19,155200,155100,54779,-266779,-268679,OK
696.247564,TraderOne,Tick,3923,3942,-19,19,155200,155100,54779,-266779,-268679,OK
696.526077,TraderOne,Tick,3923,3942,-19,19,155200,155100,54779,-266779,-268679,OK
696.700845,TraderOne,Tick,3923,3942,-19,19,155200,155100,54779,-266779,-268679,OK
696.97413,TraderOne,Tick,3943,3942,1,-1,155100,155100,54468,-267468,-267468,OK
697.254034,TraderOne,Tick,3943,3942,1,-1,155100,155600,54468,-267468,-267768,OK
697.496194,TraderOne,Tick,3943,3942,1,-1,155100,155600,54468,-267468,-267768,OK
697.755543,TraderOne,Tick,3943,3942,1,-1,155100,155700,54468,-267468,-267768,OK
698.042438,TraderOne,Tick,3953,3949,4,-4,155800,155700,54670,-267670,-267270,OK
698.228936,TraderOne,Tick,3953,3949,4,-4,155800,155700,54670,-267670,-267270,OK
698.469165,TraderOne,Tick,3953,3949,4,-4,155800,155700,54670,-267670,-267270,OK
698.707378,TraderOne,Tick,3953,3949,4,-4,155800,155700,54670,-267670,-267270,OK
699.004372,TraderOne,Tick,3963,3949,14,-14,155100,155700,54514,-267514,-271714,OK
699.286823,TraderOne,Tick,3963,3949,14,-14,155100,155700,54514,-267514,-271714,OK
699.520583,TraderOne,Tick,3963,3949,14,-14,155100,155700,54514,-267514,-271714,OK
699.756485,TraderOne,Tick,3963,3949,14,-14,155100,155700,54514,-267514,-271714,OK
699.967989,TraderOne,Tick,3963,3949,14,-14,155100,155700,54514,-267514,-271714,OK
700.255563,TraderOne,Tick,3963,3949,14,-14,155100,155700,54514,-267514,-271714,OK
700.470127,TraderOne,Tick,3963,3949,14,-14,155100,155700,54514,-267514,-271714,OK
700.790925,TraderOne,Tick,3963,3959,4,-4,155700,155700,54359,-268359,-268359,OK
700.961811,TraderOne,Tick,3963,3959,4,-4,155700,155700,54359,-268359,-268359,OK
701.21283,TraderOne,Tick,3963,3966,-3,3,155400,155200,54250,-268250,-268850,OK
701.488714,TraderOne,Tick,3963,3966,-3,3,155400,155200,54250,-268250,-268850,OK
701.723466,TraderOne,Tick,3963,3976,-13,13,155200,155200,54560,-267560,-267560,OK
701.990988,TraderOne,Tick,3963,3976,-13,13,155200,155200,54560,-267560,-267560,OK
702.253478,TraderOne,Tick,3973,3996,-23,23,155100,155200,54095,-266095,-263795,OK
702.450426,TraderOne,Tick,3973,3996,-23,23,155100,155200,54095,-266095,-263795,OK
702.800409,TraderOne,Tick,3973,3996,-23,23,155100,155200,54095,-266095,-263795,OK
703.041292,TraderOne,Tick,3973,3996,-23,23,155100,155200,54095,-266095,-263795,OK
703.223949,TraderOne,Tick,3973,3996,-23,23,155100,155200,54095,-266095,-263795,OK
703.519795,TraderOne,Tick,3973,3996,-23,23,155100,155200,54095,-266095,-263795,OK
703.781057,TraderOne,Tick,3973,3996,-23,23,155100,155200,54095,-266095,-263795,OK
704.016552,TraderOne,Tick,3973,4001,-28,28,155400,155200,54250,-264750,-270350,OK
704.262085,TraderOne,Tick,3983,4001,-18,18,154900,155200,54095,-267595,-262195,OK
704.542687,TraderOne,Tick,3983,4001,-18,18,154900,155000,54095,-267595,-265795,OK
704.705027,TraderOne,Tick,3983,4003,-20,20,155300,155000,54064,-266964,-272964,OK
705.035586,TraderOne,Tick,3983,4003,-20,20,155300,155000,54064,-266964,-272964,OK
705.245334,TraderOne,Tick,3983,4003,-20,20,155300,155000,54064,-266964,-272964,OK
705.457261,TraderOne,Tick,3983,4003,-20,20,155300,155000,54064,-266964,-272964,OK
705.784963,TraderOne,Tick,3983,4003,-20,20,155300,155000,54064,-266964,-272964,OK
706.032565,TraderOne,Tick,3983,4003,-20,20,155300,154800,54064,-266964,-272964,OK
706.233848,TraderOne,Tick,3990,4003,-13,13,154900,154800,53956,-268256,-269556,OK
706.453587,TraderOne,Tick,3990,4003,-13,13,154900,154800,53956,-268256,-269556,OK
706.746895,TraderOne,Tick,3990,4003,-13,13,154900,154600,53956,-268256,-272156,OK
706.982017,TraderOne,Tick,3990,4003,-13,13,154900,154600,53956,-268256,-272156,OK
707.21649,TraderOne,Tick,3990,4013,-23,23,154800,154600,54266,-266566,-271166,OK
707.515056,TraderOne,Tick,3990,4013,-23,23,154800,154500,54266,-266566,-273466,OK
707.711729,TraderOne,Tick,3990,4013,-23,23,154800,154700,54266,-266566,-268866,OK
708.0247,TraderOne,Tick,3990,4021,-31,31,155200,154700,54142,-264042,-273342,OK
708.201007,TraderOne,Tick,4000,4021,-21,21,154800,154700,53987,-267887,-269987,OK
708.518004,TraderOne,Tick,4008,4021,-13,13,155000,154700,53863,-270163,-274063,OK
708.787943,TraderOne,Tick,4008,4021,-13,13,155000,154600,53863,-270163,-274063,OK
709.008817,TraderOne,Tick,4008,4021,-13,13,155000,154600,53863,-270163,-274063,OK
709.245316,TraderOne,Tick,4008,4021,-13,13,155000,154600,53863,-270163,-274063,OK
709.509244,TraderOne,Tick,4008,4031,-23,23,154800,154600,54173,-269473,-274073,OK
709.779455,TraderOne,Tick,4008,4031,-23,23,154800,154500,54173,-269473,-276373,OK
709.965744,TraderOne,Tick,4008,4031,-23,23,154800,154500,54173,-269473,-276373,OK
710.258651,TraderOne,Tick,4008,4031,-23,23,154800,154500,54173,-269473,-276373,OK
710.487218,TraderOne,Tick,4008,4031,-23,23,154800,154500,54173,-269473,-276373,OK
710.711396,TraderOne,Tick,4008,4031,-23,23,154800,154500,54173,-269473,-276373,OK
710.995621,TraderOne,Tick,4008,4041,-33,33,154800,154500,54483,-266783,-276683,OK
711.242258,TraderOne,Tick,4008,4051,-43,43,155000,154400,54328,-262628,-275528,OK
711.45276,TraderOne,Tick,4008,4051,-43,43,154800,154400,54328,-262628,-275528,OK
711.740973,TraderOne,Tick,4008,4051,-43,43,154800,154400,54328,-262628,-275528,OK
711.983245,TraderOne,Tick,4008,4061,-53,53,155000,154400,54173,-257473,-273373,OK
712.292681,TraderOne,Tick,4008,4061,-53,53,154900,154400,54173,-257473,-273373,OK
712.501259,TraderOne,Tick,4018,4061,-43,43,154900,154400,54483,-263783,-276683,OK
712.707743,TraderOne,Tick,4018,4061,-43,43,154800,154400,54483,-263783,-276683,OK
713.011482,TraderOne,Tick,4018,4061,-43,43,154800,154400,54483,-263783,-276683,OK
713.289515,TraderOne,Tick,4018,4061,-43,43,154800,154400,54483,-263783,-276683,OK
713.512044,TraderOne,Tick,4028,4061,-33,33,154800,154400,54793,-269093,-278993,OK
713.728337,TraderOne,Tick,4028,4061,-33,33,154800,154400,54793,-269093,-278993,OK
713.956488,TraderOne,Tick,4028,4061,-33,33,154800,154400,54793,-269093,-278993,OK
714.253725,TraderOne,Tick,4028,4061,-33,33,154800,154200,54793,-269093,-278993,OK
714.534897,TraderOne,Tick,4038,4071,-33,33,154500,154000,54948,-271248,-281148,OK
714.737597,TraderOne,Tick,4038,4081,-43,43,154400,153800,55257,-267557,-280457,OK
714.981392,TraderOne,Tick,4038,4091,-53,53,154400,154000,55566,-262866,-278766,OK
715.203806,TraderOne,Tick,4038,4091,-53,53,154400,154100,55566,-262866,-278766,OK
715.478573,TraderOne,Tick,4038,4091,-53,53,154400,153900,55566,-262866,-278766,OK
715.747609,TraderOne,Tick,4048,4091,-43,43,154500,153900,55412,-269712,-282612,OK
716.007889,TraderOne,Tick,4048,4091,-43,43,154400,153900,55412,-269712,-282612,OK
716.214715,TraderOne,Tick,4048,4091,-43,43,154400,153800,55412,-269712,-282612,OK
716.548744,TraderOne,Tick,4048,4101,-53,53,154400,153900,55721,-265021,-280921,OK
716.799881,TraderOne,Tick,4058,4101,-43,43,154500,153900,55567,-271867,-284767,OK
717.018055,TraderOne,Tick,4058,4101,-43,43,154400,153900,55567,-271867,-284767,OK
717.233443,TraderOne,Tick,4058,4101,-43,43,154400,153900,55567,-271867,-284767,OK
717.522337,TraderOne,Tick,4058,4101,-43,43,154400,153700,55567,-271867,-284767,OK
717.764584,TraderOne,Tick,4058,4111,-53,53,154400,153700,55876,-267176,-283076,OK
717.981723,TraderOne,Tick,4068,4111,-43,43,154200,153700,55722,-274022,-286922,OK
718.274177,TraderOne,Tick,4068,4111,-43,43,154200,153700,55722,-274022,-286922,OK
718.480147,TraderOne,Tick,4068,4111,-43,43,154200,153700,55722,-274022,-286922,OK
718.734824,TraderOne,Tick,4068,4111,-43,43,154200,153600,55722,-274022,-286922,OK
718.990754,TraderOne,Tick,4068,4111,-43,43,154200,153600,55722,-274022,-286922,OK
719.220301,TraderOne,Tick,4068,4111,-43,43,154200,153600,55722,-274022,-286922,OK
719.520321,TraderOne,Tick,4068,4121,-53,53,154300,153600,55568,-268868,-284768,OK
719.796264,TraderOne,Tick,4068,4121,-53,53,154300,153800,55568,-268868,-284768,OK
720.011622,TraderOne,Tick,4078,4121,-43,43,154100,153800,55877,-275177,-288077,OK
720.228832,TraderOne,Tick,4088,4121,-33,33,154200,153700,55723,-281023,-290923,OK
720.540544,TraderOne,Tick,4088,4131,-43,43,154100,153700,56031,-277331,-290231,OK
720.777227,TraderOne,Tick,4088,4131,-43,43,154100,153700,56031,-277331,-290231,OK
720.965097,TraderOne,Tick,4088,4131,-43,43,154100,153700,56031,-277331,-290231,OK
721.25571,TraderOne,Tick,4088,4131,-43,43,154000,153700,56031,-277331,-290231,OK
721.508659,TraderOne,Tick,4088,4131,-43,43,154000,153700,56031,-277331,-290231,OK
721.794017,TraderOne,Tick,4088,4131,-43,43,154000,153700,56031,-277331,-290231,OK
721.983832,TraderOne,Tick,4088,4131,-43,43,154000,153700,56031,-277331,-290231,OK
722.247722,TraderOne,Tick,4088,4131,-43,43,154000,153700,56031,-277331,-290231,OK
722.453832,TraderOne,Tick,4088,4131,-43,43,154000,153700,56031,-277331,-290231,OK
722.755627,TraderOne,Tick,4088,4141,-53,53,154000,153700,56339,-272639,-288539,OK
722.964494,TraderOne,Tick,4098,4141,-43,43,154000,153700,56647,-278947,-291847,OK
723.206392,TraderOne,Tick,4098,4141,-43,43,154100,153700,56647,-278947,-291847,OK
723.540187,TraderOne,Tick,4098,4141,-43,43,154100,153700,56647,-278947,-291847,OK
723.72671,TraderOne,Tick,4098,4141,-43,43,154100,153700,56647,-278947,-291847,OK
724.019295,TraderOne,Tick,4108,4141,-33,33,153700,153000,56493,-287793,-297693,OK
724.244594,TraderOne,Tick,4108,4141,-33,33,153700,153000,56493,-287793,-297693,OK
724.540829,TraderOne,Tick,4108,4141,-33,33,153700,153000,56493,-287793,-297693,OK
724.761365,TraderOne,Tick,4108,4141,-33,33,153500,153000,56493,-287793,-297693,OK
725.026017,TraderOne,Tick,4108,4151,-43,43,153500,152900,56800,-284100,-297000,OK
725.274635,TraderOne,Tick,4108,4151,-43,43,153400,152800,56800,-284100,-297000,OK
725.533195,TraderOne,Tick,4108,4151,-43,43,153400,152800,56800,-284100,-297000,OK
725.749274,TraderOne,Tick,4118,4151,-33,33,153100,152800,56647,-289947,-299847,OK
725.980999,TraderOne,Tick,4118,4151,-33,33,153100,152800,56647,-289947,-299847,OK
726.221197,TraderOne,Tick,4118,4151,-33,33,153100,152800,56647,-289947,-299847,OK
726.460875,TraderOne,Tick,4118,4151,-33,33,153100,152700,56647,-289947,-299847,OK
726.727264,TraderOne,Tick,4118,4161,-43,43,153100,152700,56953,-286253,-299153,OK
726.994672,TraderOne,Tick,4118,4161,-43,43,153100,152700,56953,-286253,-299153,OK
727.252056,TraderOne,Tick,4128,4161,-33,33,153200,152700,57259,-291559,-301459,OK
727.495458,TraderOne,Tick,4128,4161,-33,33,153200,152700,57259,-291559,-301459,OK
727.741785,TraderOne,Tick,4128,4171,-43,43,153500,152700,57106,-287406,-300306,OK
727.960409,TraderOne,Tick,4138,4171,-33,33,153100,152700,56953,-292253,-302153,OK
728.260318,TraderOne,Tick,4138,4171,-33,33,153100,152700,56953,-292253,-302153,OK
728.468204,TraderOne,Tick,4138,4171,-33,33,153100,152700,56953,-292253,-302153,OK
728.762068,TraderOne,Tick,4138,4171,-33,33,153100,152700,56953,-292253,-302153,OK
728.972315,TraderOne,Tick,4138,4171,-33,33,153100,152700,56953,-292253,-302153,OK
729.217024,TraderOne,Tick,4148,4171,-23,23,153000,152700,56800,-296100,-303000,OK
729.471298,TraderOne,Tick,4148,4171,-23,23,153000,152700,56800,-296100,-303000,OK
729.796733,TraderOne,Tick,4148,4174,-26,26,153200,152700,56754,-295454,-303254,OK
729.995056,TraderOne,Tick,4148,4174,-26,26,153200,152700,56754,-295454,-303254,OK
730.215198,TraderOne,Tick,4148,4174,-26,26,153200,152700,56754,-295454,-303254,OK
730.457034,TraderOne,Tick,4148,4174,-26,26,153200,152700,56754,-295454,-303254,OK
730.724111,TraderOne,Tick,4148,4174,-26,26,153200,152900,56754,-295454,-303254,OK
731.036083,TraderOne,Tick,4148,4174,-26,26,153200,152900,56754,-295454,-303254,OK
731.267535,TraderOne,Tick,4148,4174,-26,26,153200,152900,56754,-295454,-303254,OK
731.492077,TraderOne,Tick,4158,4174,-16,16,153100,152900,57060,-297760,-300960,OK
731.73469,TraderOne,Tick,4158,4174,-16,16,153100,152900,57060,-297760,-300960,OK
732.021381,TraderOne,Tick,4168,4174,-6,6,153100,152900,57366,-299066,-300266,OK
732.241521,TraderOne,Tick,4168,4174,-6,6,153100,152900,57366,-299066,-300266,OK
732.482214,TraderOne,Tick,4168,4174,-6,6,153100,152900,57366,-299066,-300266,OK
732.707663,TraderOne,Tick,4168,4174,-6,6,153100,152900,57366,-299066,-300266,OK
732.951307,TraderOne,Tick,4168,4174,-6,6,153100,152900,57366,-299066,-300266,OK
733.27992,TraderOne,Tick,4168,4174,-6,6,153100,152900,57366,-299066,-300266,OK
733.502586,TraderOne,Tick,4168,4174,-6,6,153100,152900,57366,-299066,-300266,OK
733.764412,TraderOne,Tick,4168,4174,-6,6,153100,152900,57366,-299066,-300266,OK
733.963533,TraderOne,Tick,4168,4174,-6,6,153100,152900,57366,-299066,-300266,OK
734.236272,TraderOne,Tick,4168,4174,-6,6,153100,152800,57366,-299066,-300866,OK
734.458022,TraderOne,Tick,4168,4174,-6,6,153100,152800,57366,-299066,-300866,OK
734.785989,TraderOne,Tick,4168,4174,-6,6,153100,152800,57366,-299066,-300866,OK
734.959443,TraderOne,Tick,4168,4174,-6,6,153100,152800,57366,-299066,-300866,OK
735.278683,TraderOne,Tick,4168,4174,-6,6,153100,153100,57366,-299066,-299066,OK
735.523832,TraderOne,Tick,4168,4184,-16,16,153600,152900,57213,-297913,-302713,OK
735.761621,TraderOne,Tick,4178,4184,-6,6,153000,152900,57060,-299760,-300360,OK
736.008477,TraderOne,Tick,4178,4184,-6,6,153000,152800,57060,-299760,-300960,OK
736.283279,TraderOne,Tick,4178,4194,-16,16,153000,152600,57366,-296066,-300866,OK
736.530767,TraderOne,Tick,4178,4204,-26,26,153000,152500,57672,-293372,-301172,OK
736.795545,TraderOne,Tick,4178,4204,-26,26,153000,152500,57672,-293372,-301172,OK
737.04899,TraderOne,Tick,4178,4204,-26,26,152800,152500,57672,-293372,-301172,OK
737.244113,TraderOne,Tick,4178,4204,-26,26,152800,152500,57672,-293372,-301172,OK
737.463969,TraderOne,Tick,4178,4204,-26,26,152800,152500,57672,-293372,-301172,OK
737.768163,TraderOne,Tick,4178,4204,-26,26,152800,152500,57672,-293372,-301172,OK
738.028682,TraderOne,Tick,4178,4214,-36,36,153200,152500,57519,-291219,-302019,OK
738.230061,TraderOne,Tick,4178,4214,-36,36,153200,152500,57519,-291219,-302019,OK
738.474665,TraderOne,Tick,4188,4214,-26,26,152700,152500,57366,-295066,-300266,OK
738.77256,TraderOne,Tick,4188,4214,-26,26,152700,152500,57366,-295066,-300266,OK
738.981123,TraderOne,Tick,4188,4224,-36,36,152700,152500,57671,-292371,-299571,OK
739.270342,TraderOne,Tick,4188,4224,-36,36,152700,152100,57671,-292371,-303171,OK
739.513567,TraderOne,Tick,4188,4224,-36,36,152700,152100,57671,-292371,-303171,OK
739.731953,TraderOne,Tick,4188,4224,-36,36,152600,152100,57671,-292371,-303171,OK
739.990147,TraderOne,Tick,4188,4224,-36,36,152600,152100,57671,-292371,-303171,OK
740.280366,TraderOne,Tick,4188,4224,-36,36,152600,152400,57671,-292371,-299571,OK
740.513214,TraderOne,Tick,4188,4224,-36,36,152600,152400,57671,-292371,-299571,OK
740.710927,TraderOne,Tick,4188,4224,-36,36,152600,152500,57671,-292371,-295971,OK
740.987455,TraderOne,Tick,4198,4224,-26,26,152800,152500,57518,-300218,-308018,OK
741.275531,TraderOne,Tick,4198,4234,-36,36,152600,152500,57823,-297523,-301123,OK
741.480256,TraderOne,Tick,4198,4234,-36,36,152600,151900,57823,-297523,-308323,OK
741.759648,TraderOne,Tick,4198,4234,-36,36,152600,151900,57823,-297523,-308323,OK
742.000906,TraderOne,Tick,4198,4234,-36,36,152600,151900,57823,-297523,-308323,OK
742.29043,TraderOne,Tick,4198,4234,-36,36,152600,151800,57823,-297523,-308323,OK
742.542836,TraderOne,Tick,4198,4234,-36,36,152600,151700,57823,-297523,-308323,OK
742.788569,TraderOne,Tick,4198,4234,-36,36,152600,151700,57823,-297523,-308323,OK
743.029898,TraderOne,Tick,4198,4234,-36,36,152600,151700,57823,-297523,-308323,OK
743.290832,TraderOne,Tick,4198,4234,-36,36,152600,151700,57823,-297523,-308323,OK
743.471075,TraderOne,Tick,4198,4234,-36,36,152600,151900,57823,-297523,-308323,OK
743.785152,TraderOne,Tick,4198,4234,-36,36,152600,151900,57823,-297523,-308323,OK
744.019094,TraderOne,Tick,4198,4234,-36,36,152600,151900,57823,-297523,-308323,OK
744.237634,TraderOne,Tick,4198,4234,-36,36,152600,151900,57823,-297523,-308323,OK
744.50679,TraderOne,Tick,4198,4234,-36,36,152600,151900,57823,-297523,-308323,OK
744.720339,TraderOne,Tick,4198,4234,-36,36,152600,151900,57823,-297523,-308323,OK
745.006525,TraderOne,Tick,4198,4234,-36,36,152600,151900,57823,-297523,-308323,OK
745.282145,TraderOne,Tick,4198,4234,-36,36,152600,151900,57823,-297523,-308323,OK
745.467297,TraderOne,Tick,4198,4234,-36,36,152600,151900,57823,-297523,-308323,OK
745.773862,TraderOne,Tick,4208,4234,-26,26,152200,151900,57671,-301371,-309171,OK
745.962688,TraderOne,Tick,4208,4234,-26,26,152200,151900,57671,-301371,-309171,OK
746.23339,TraderOne,Tick,4208,4234,-26,26,152200,151800,57671,-301371,-309171,OK
746.455619,TraderOne,Tick,4208,4234,-26,26,152200,151800,57671,-301371,-309171,OK
746.706666,TraderOne,Tick,4208,4234,-26,26,152200,151900,57671,-301371,-309171,OK
747.050403,TraderOne,Tick,4208,4234,-26,26,152200,151900,57671,-301371,-309171,OK
747.232029,TraderOne,Tick,4208,4244,-36,36,152100,151700,57975,-298675,-309475,OK
747.506341,TraderOne,Tick,4208,4254,-46,46,152100,151700,58279,-294979,-308779,OK
747.733935,TraderOne,Tick,4208,4254,-46,46,152100,151700,58279,-294979,-308779,OK
748.019879,TraderOne,Tick,4208,4264,-56,56,152000,151700,58127,-290827,-307627,OK
748.208476,TraderOne,Tick,4208,4264,-56,56,152000,151700,58127,-290827,-307627,OK
748.467289,TraderOne,Tick,4208,4264,-56,56,152000,151700,58127,-290827,-307627,OK
748.726473,TraderOne,Tick,4208,4264,-56,56,152000,151700,58127,-290827,-307627,OK
748.985089,TraderOne,Tick,4218,4264,-46,46,152000,151700,57975,-295675,-309475,OK
749.296917,TraderOne,Tick,4218,4264,-46,46,152000,151700,57975,-295675,-309475,OK
749.495441,TraderOne,Tick,4218,4264,-46,46,152000,151700,57975,-295675,-309475,OK
749.752432,TraderOne,Tick,4228,4264,-36,36,151500,151700,57823,-301523,-294323,OK
750.048349,TraderOne,Tick,4238,4264,-26,26,151400,151700,58126,-299826,-292026,OK
750.275651,TraderOne,Tick,4248,4264,-16,16,151400,151700,58429,-299129,-294329,OK
750.530112,TraderOne,Tick,4258,4264,-6,6,151000,151700,58732,-298432,-296632,OK
750.774136,TraderOne,Tick,4259,4264,-5,5,151400,151500,58762,-298362,-297862,OK
751.045467,TraderOne,Tick,4259,4264,-5,5,151400,151500,58762,-298362,-297862,OK
751.277984,TraderOne,Tick,4259,4264,-5,5,151400,151500,58762,-298362,-297862,OK
751.511417,TraderOne,Tick,4259,4264,-5,5,151400,151500,58762,-298362,-297862,OK
751.734554,TraderOne,Tick,4259,4264,-5,5,151400,151500,58762,-298362,-297862,OK
752.027421,TraderOne,Tick,4259,4264,-5,5,151400,151500,58762,-298362,-297862,OK
752.276218,TraderOne,Tick,4259,4264,-5,5,151400,151500,58762,-298362,-297862,OK
752.532579,TraderOne,Tick,4259,4264,-5,5,151400,151700,58762,-298362,-296862,OK
752.709865,TraderOne,Tick,4259,4264,-5,5,151400,151700,58762,-298362,-296862,OK
752.953394,TraderOne,Tick,4259,4264,-5,5,151400,151000,58762,-298362,-299862,OK
753.299585,TraderOne,Tick,4259,4264,-5,5,151400,151000,58762,-298362,-299862,OK
753.452654,TraderOne,Tick,4259,4264,-5,5,151400,151000,58762,-298362,-299862,OK
753.787025,TraderOne,Tick,4259,4264,-5,5,151400,151000,58762,-298362,-299862,OK
754.00996,TraderOne,Tick,4259,4264,-5,5,151400,151100,58762,-298362,-299862,OK
754.242896,TraderOne,Tick,4259,4264,-5,5,151400,151100,58762,-298362,-299862,OK
754.54497,TraderOne,Tick,4259,4264,-5,5,151400,151100,58762,-298362,-299862,OK
754.771019,TraderOne,Tick,4259,4264,-5,5,151400,151100,58762,-298362,-299862,OK
755.029266,TraderOne,Tick,4259,4264,-5,5,151400,151100,58762,-298362,-299862,OK
755.217304,TraderOne,Tick,4259,4264,-5,5,151400,151100,58762,-298362,-299862,OK
755.468156,TraderOne,Tick,4259,4264,-5,5,151400,151100,58762,-298362,-299862,OK
755.780048,TraderOne,Tick,4269,4264,5,-5,150800,151200,58611,-298211,-299711,OK
755.972445,TraderOne,Tick,4269,4264,5,-5,150800,151200,58611,-298211,-299711,OK
756.254524,TraderOne,Tick,4269,4271,-2,2,151400,151300,58505,-298105,-298305,OK
756.518149,TraderOne,Tick,4269,4271,-2,2,151400,151100,58505,-298105,-298705,OK
756.706743,TraderOne,Tick,4269,4271,-2,2,151400,151100,58505,-298105,-298705,OK
757.006034,TraderOne,Tick,4269,4281,-12,12,151900,151100,58353,-297953,-301553,OK
757.265961,TraderOne,Tick,4269,4281,-12,12,151900,151100,58353,-297953,-301553,OK
757.472527,TraderOne,Tick,4269,4281,-12,12,151900,151100,58353,-297953,-301553,OK
757.704324,TraderOne,Tick,4269,4281,-12,12,151900,151100,58353,-297953,-301553,OK
757.950898,TraderOne,Tick,4269,4281,-12,12,151900,151100,58353,-297953,-301553,OK
758.214303,TraderOne,Tick,4269,4291,-22,22,151900,151100,58201,-295801,-302401,OK
758.535811,TraderOne,Tick,4269,4291,-22,22,151900,151100,58201,-295801,-302401,OK
758.757736,TraderOne,Tick,4269,4291,-22,22,151900,151400,58201,-295801,-302401,OK
758.993695,TraderOne,Tick,4269,4291,-22,22,151900,151500,58201,-295801,-302401,OK
759.27156,TraderOne,Tick,4269,4291,-22,22,151900,151500,58201,-295801,-302401,OK
759.482337,TraderOne,Tick,4269,4291,-22,22,151900,151500,58201,-295801,-302401,OK
759.779571,TraderOne,Tick,4269,4291,-22,22,151900,151500,58201,-295801,-302401,OK
760.02559,TraderOne,Tick,4269,4301,-32,32,151800,151500,58049,-292649,-302249,OK
760.215623,TraderOne,Tick,4269,4301,-32,32,151800,151500,58049,-292649,-302249,OK
760.476955,TraderOne,Tick,4279,4301,-22,22,150900,151500,57898,-296498,-289898,OK
760.751626,TraderOne,Tick,4279,4301,-22,22,150900,151500,57898,-296498,-289898,OK
760.998488,TraderOne,Tick,4279,4301,-22,22,150900,151500,57898,-296498,-289898,OK
761.242388,TraderOne,Tick,4279,4301,-22,22,150900,151300,57898,-296498,-289898,OK
761.470494,TraderOne,Tick,4279,4301,-22,22,150900,151300,57898,-296498,-289898,OK
761.705095,TraderOne,Tick,4279,4311,-32,32,151800,151300,57746,-293346,-302946,OK
762.018271,TraderOne,Tick,4279,4311,-32,32,151800,151300,57746,-293346,-302946,OK
762.284657,TraderOne,Tick,4279,4311,-32,32,151800,151000,57746,-293346,-302946,OK
762.45016,TraderOne,Tick,4289,4321,-32,32,151600,151000,57444,-295044,-304644,OK
762.774502,TraderOne,Tick,4289,4321,-32,32,151600,151100,57444,-295044,-304644,OK
762.958403,TraderOne,Tick,4289,4321,-32,32,151600,151000,57444,-295044,-304644,OK
763.231176,TraderOne,Tick,4289,4321,-32,32,151600,151000,57444,-295044,-304644,OK
763.486055,TraderOne,Tick,4289,4321,-32,32,151600,151000,57444,-295044,-304644,OK
763.763038,TraderOne,Tick,4299,4321,-22,22,150800,150900,57293,-299893,-297693,OK
764.002239,TraderOne,Tick,4299,4321,-22,22,150800,150900,57293,-299893,-297693,OK
764.283025,TraderOne,Tick,4299,4321,-22,22,150800,150900,57293,-299893,-297693,OK
764.520483,TraderOne,Tick,4306,4321,-15,15,151000,150900,57187,-301887,-303387,OK
764.765369,TraderOne,Tick,4316,4321,-5,5,150800,150900,57036,-304736,-304236,OK
765.022034,TraderOne,Tick,4316,4321,-5,5,150800,150900,57036,-304736,-304236,OK
765.20904,TraderOne,Tick,4317,4321,-4,4,150800,150900,57066,-304866,-304466,OK
765.519129,TraderOne,Tick,4317,4321,-4,4,150800,150900,57066,-304866,-304466,OK
765.759306,TraderOne,Tick,4317,4321,-4,4,150800,150900,57066,-304866,-304466,OK
766.003342,TraderOne,Tick,4317,4321,-4,4,150800,150900,57066,-304866,-304466,OK
766.2439,TraderOne,Tick,4317,4321,-4,4,150800,150900,57066,-304866,-304466,OK
766.547339,TraderOne,Tick,4327,4321,6,-6,150700,150900,56915,-305715,-306915,OK
766.734411,TraderOne,Tick,4327,4321,6,-6,150700,150900,56915,-305715,-306915,OK
767.030931,TraderOne,Tick,4327,4321,6,-6,150700,150900,56915,-305715,-306915,OK
767.241695,TraderOne,Tick,4327,4321,6,-6,150700,150900,56915,-305715,-306915,OK
767.550079,TraderOne,Tick,4327,4321,6,-6,150700,150700,56915,-305715,-305715,OK
767.742025,TraderOne,Tick,4327,4321,6,-6,150700,150700,56915,-305715,-305715,OK
768.015915,TraderOne,Tick,4327,4321,6,-6,150700,150700,56915,-305715,-305715,OK
768.282631,TraderOne,Tick,4327,4321,6,-6,150700,150700,56915,-305715,-305715,OK
768.523118,TraderOne,Tick,4327,4321,6,-6,150700,150700,56915,-305715,-305715,OK
768.778551,TraderOne,Tick,4327,4321,6,-6,150700,150700,56915,-305715,-305715,OK
769.017569,TraderOne,Tick,4327,4321,6,-6,150700,150700,56915,-305715,-305715,OK
769.220148,TraderOne,Tick,4337,4321,16,-16,150600,150700,57217,-306017,-307617,OK
769.544002,TraderOne,Tick,4347,4321,26,-26,150900,151100,57519,-304319,-309519,OK
769.770423,TraderOne,Tick,4347,4321,26,-26,150900,151100,57519,-304319,-309519,OK
770.030624,TraderOne,Tick,4347,4321,26,-26,150900,151100,57519,-304319,-309519,OK
770.226814,TraderOne,Tick,4347,4321,26,-26,150900,151100,57519,-304319,-309519,OK
770.524515,TraderOne,Tick,4347,4321,26,-26,150900,151100,57519,-304319,-309519,OK
770.780528,TraderOne,Tick,4357,4321,36,-36,150900,151100,57821,-301621,-308821,OK
770.986104,TraderOne,Tick,4357,4321,36,-36,150900,151100,57821,-301621,-308821,OK
771.278513,TraderOne,Tick,4357,4321,36,-36,150900,151100,57821,-301621,-308821,OK
771.5423,TraderOne,Tick,4357,4321,36,-36,150900,151100,57821,-301621,-308821,OK
771.767101,TraderOne,Tick,4357,4321,36,-36,150900,151100,57821,-301621,-308821,OK
771.958713,TraderOne,Tick,4357,4321,36,-36,150900,151100,57821,-301621,-308821,OK
772.213408,TraderOne,Tick,4357,4321,36,-36,150900,151100,57821,-301621,-308821,OK
772.524095,TraderOne,Tick,4357,4321,36,-36,150900,151100,57821,-301621,-308821,OK
772.725515,TraderOne,Tick,4357,4321,36,-36,150900,151100,57821,-301621,-308821,OK
773.038847,TraderOne,Tick,4357,4321,36,-36,150600,151100,57821,-301621,-312421,OK
773.294049,TraderOne,Tick,4357,4331,26,-26,151400,151100,58122,-304922,-297122,OK
773.531731,TraderOne,Tick,4357,4331,26,-26,151400,151100,58122,-304922,-297122,OK
773.727875,TraderOne,Tick,4367,4331,36,-36,150500,151100,57971,-302771,-313571,OK
773.987583,TraderOne,Tick,4367,4331,36,-36,150500,151100,57971,-302771,-313571,OK
774.232779,TraderOne,Tick,4367,4331,36,-36,150500,151100,57971,-302771,-313571,OK
774.51842,TraderOne,Tick,4367,4331,36,-36,150500,151100,57971,-302771,-313571,OK
774.778491,TraderOne,Tick,4367,4331,36,-36,150500,151100,57971,-302771,-313571,OK
774.985745,TraderOne,Tick,4367,4331,36,-36,150500,151100,57971,-302771,-313571,OK
775.217656,TraderOne,Tick,4367,4331,36,-36,150500,151100,57971,-302771,-313571,OK
775.531826,TraderOne,Tick,4367,4331,36,-36,150500,151100,57971,-302771,-313571,OK
775.726764,TraderOne,Tick,4367,4331,36,-36,150500,151100,57971,-302771,-313571,OK
775.973661,TraderOne,Tick,4367,4331,36,-36,150500,151100,57971,-302771,-313571,OK
776.257114,TraderOne,Tick,4367,4341,26,-26,151100,151100,57820,-305620,-305620,OK
776.541901,TraderOne,Tick,4367,4351,16,-16,151500,151100,58123,-303923,-299123,OK
776.748458,TraderOne,Tick,4367,4361,6,-6,151500,151100,58426,-299226,-297426,OK
776.960506,TraderOne,Tick,4367,4363,4,-4,151500,151100,58487,-298687,-297487,OK
777.252392,TraderOne,Tick,4367,4363,4,-4,151500,151100,58487,-298687,-297487,OK
777.530669,TraderOne,Tick,4367,4363,4,-4,151500,151100,58487,-298687,-297487,OK
777.782254,TraderOne,Tick,4367,4363,4,-4,151500,151100,58487,-298687,-297487,OK
777.964057,TraderOne,Tick,4367,4363,4,-4,151500,151100,58487,-298687,-297487,OK
778.291167,TraderOne,Tick,4367,4373,-6,6,151100,151100,58336,-299536,-299536,OK
778.473407,TraderOne,Tick,4367,4373,-6,6,151300,151100,58336,-299536,-300736,OK
778.702911,TraderOne,Tick,4367,4373,-6,6,151300,151100,58336,-299536,-300736,OK
779.008504,TraderOne,Tick,4367,4383,-16,16,151700,151100,58185,-298385,-303185,OK
779.224814,TraderOne,Tick,4367,4383,-16,16,151700,151100,58185,-298385,-303185,OK
779.489105,TraderOne,Tick,4367,4383,-16,16,151700,151100,58185,-298385,-303185,OK
779.729011,TraderOne,Tick,4369,4383,-14,14,151100,151100,58155,-298555,-298555,OK
779.984422,TraderOne,Tick,4369,4383,-14,14,151100,151100,58155,-298555,-298555,OK
780.235041,TraderOne,Tick,4369,4383,-14,14,151100,151100,58155,-298555,-298555,OK
780.507378,TraderOne,Tick,4369,4383,-14,14,151100,151100,58155,-298555,-298555,OK
780.746587,TraderOne,Tick,4369,4383,-14,14,151100,151100,58155,-298555,-298555,OK
780.982066,TraderOne,Tick,4369,4383,-14,14,151100,150800,58155,-298555,-302755,OK
781.275459,TraderOne,Tick,4369,4393,-24,24,151600,150800,58004,-296404,-303604,OK
781.485014,TraderOne,Tick,4369,4393,-24,24,151600,150800,58004,-296404,-303604,OK
781.782283,TraderOne,Tick,4369,4393,-24,24,151600,150800,58004,-296404,-303604,OK
781.99873,TraderOne,Tick,4369,4393,-24,24,151600,150800,58004,-296404,-303604,OK
782.236831,TraderOne,Tick,4369,4393,-24,24,151600,150800,58004,-296404,-303604,OK
782.534209,TraderOne,Tick,4369,4393,-24,24,151600,151200,58004,-296404,-303604,OK
782.772981,TraderOne,Tick,4379,4393,-14,14,150900,151400,57852,-299252,-295052,OK
782.97493,TraderOne,Tick,4379,4393,-14,14,150900,151400,57852,-299252,-295052,OK
783.211665,TraderOne,Tick,4379,4393,-14,14,150900,151400,57852,-299252,-295052,OK
783.46939,TraderOne,Tick,4379,4393,-14,14,150900,151400,57852,-299252,-295052,OK
783.759443,TraderOne,Tick,4379,4403,-24,24,151500,151400,57701,-297101,-299501,OK
783.956804,TraderOne,Tick,4379,4403,-24,24,151500,151400,57701,-297101,-299501,OK
784.260291,TraderOne,Tick,4379,4403,-24,24,151500,151400,57701,-297101,-299501,OK
784.506161,TraderOne,Tick,4379,4403,-24,24,151500,151400,57701,-297101,-299501,OK
784.777925,TraderOne,Tick,4379,4403,-24,24,151500,151400,57701,-297101,-299501,OK
784.99684,TraderOne,Tick,4379,4413,-34,34,151500,151400,57550,-293950,-297350,OK
785.21427,TraderOne,Tick,4389,4413,-24,24,150500,151400,57399,-297799,-290599,OK
785.548983,TraderOne,Tick,4389,4413,-24,24,150500,151400,57399,-297799,-290599,OK
785.789012,TraderOne,Tick,4399,4413,-14,14,150500,151400,57248,-300648,-296448,OK
785.963428,TraderOne,Tick,4399,4413,-14,14,150500,151400,57248,-300648,-296448,OK
786.234546,TraderOne,Tick,4399,4413,-14,14,150500,151400,57248,-300648,-296448,OK
786.529024,TraderOne,Tick,4399,4413,-14,14,150500,151400,57248,-300648,-296448,OK
786.727765,TraderOne,Tick,4399,4413,-14,14,150500,151400,57248,-300648,-296448,OK
786.953216,TraderOne,Tick,4399,4413,-14,14,150500,151400,57248,-300648,-296448,OK
787.264307,TraderOne,Tick,4399,4413,-14,14,150500,151400,57248,-300648,-296448,OK
787.516515,TraderOne,Tick,4399,4413,-14,14,150500,150800,57248,-300648,-296448,OK
787.762634,TraderOne,Tick,4409,4413,-4,4,150500,150800,57097,-303497,-302297,OK
788.033763,TraderOne,Tick,4409,4423,-14,14,151400,150500,56946,-299346,-303546,OK
788.296034,TraderOne,Tick,4409,4423,-14,14,151400,150500,56946,-299346,-303546,OK
788.466192,TraderOne,Tick,4409,4423,-14,14,151400,150500,56946,-299346,-303546,OK
788.711613,TraderOne,Tick,4419,4433,-14,14,151100,150500,56644,-298044,-302244,OK
789.042556,TraderOne,Tick,4429,4433,-4,4,150500,150300,56493,-299893,-300693,OK
789.276128,TraderOne,Tick,4429,4443,-14,14,150500,150200,56794,-298194,-302394,OK
789.539561,TraderOne,Tick,4429,4453,-24,24,150500,150200,57095,-295495,-302695,OK
789.781206,TraderOne,Tick,4429,4453,-24,24,150500,150200,57095,-295495,-302695,OK
790.011522,TraderOne,Tick,4429,4453,-24,24,150500,150200,57095,-295495,-302695,OK
790.217709,TraderOne,Tick,4429,4453,-24,24,150500,150200,57095,-295495,-302695,OK
790.492866,TraderOne,Tick,4429,4463,-34,34,150900,150200,56944,-292344,-302544,OK
790.72267,TraderOne,Tick,4429,4463,-34,34,150900,150200,56944,-292344,-302544,OK
791.034796,TraderOne,Tick,4429,4463,-34,34,150900,150200,56944,-292344,-302544,OK
791.291269,TraderOne,Tick,4429,4463,-34,34,150900,150400,56944,-292344,-302544,OK
791.549248,TraderOne,Tick,4429,4473,-44,44,151100,150800,56793,-290193,-303393,OK
791.770641,TraderOne,Tick,4439,4473,-34,34,151100,150800,57095,-295495,-305695,OK
791.9874,TraderOne,Tick,4439,4473,-34,34,151100,150800,57095,-295495,-305695,OK
792.284299,TraderOne,Tick,4449,4473,-24,24,150500,150800,56944,-298344,-291144,OK
792.517355,TraderOne,Tick,4449,4473,-24,24,150500,150800,56944,-298344,-291144,OK
792.757695,TraderOne,Tick,4449,4473,-24,24,150500,150900,56944,-298344,-291144,OK
793.027944,TraderOne,Tick,4449,4473,-24,24,150500,150900,56944,-298344,-291144,OK
793.264659,TraderOne,Tick,4449,4473,-24,24,150500,150900,56944,-298344,-291144,OK
793.470973,TraderOne,Tick,4459,4473,-14,14,150300,150900,56793,-301193,-296993,OK
793.761483,TraderOne,Tick,4459,4473,-14,14,150300,151000,56793,-301193,-296993,OK
794.032176,TraderOne,Tick,4459,4473,-14,14,150300,151000,56793,-301193,-296993,OK
794.211815,TraderOne,Tick,4459,4473,-14,14,150300,151000,56793,-301193,-296993,OK
794.545639,TraderOne,Tick,4459,4473,-14,14,150300,151000,56793,-301193,-296993,OK
794.716393,TraderOne,Tick,4459,4473,-14,14,150300,151000,56793,-301193,-296993,OK
795.037549,TraderOne,Tick,4459,4473,-14,14,150300,150900,56793,-301193,-296993,OK
795.260142,TraderOne,Tick,4459,4473,-14,14,150300,150900,56793,-301193,-296993,OK
795.475296,TraderOne,Tick,4459,4473,-14,14,150300,150900,56793,-301193,-296993,OK
795.740884,TraderOne,Tick,4459,4473,-14,14,150300,150900,56793,-301193,-296993,OK
796.021314,TraderOne,Tick,4459,4483,-24,24,151500,150900,56642,-298042,-305242,OK
796.294999,TraderOne,Tick,4459,4483,-24,24,151500,150500,56642,-298042,-305242,OK
796.464622,TraderOne,Tick,4459,4483,-24,24,151500,150500,56642,-298042,-305242,OK
796.736606,TraderOne,Tick,4459,4493,-34,34,150700,150500,56943,-295343,-302143,OK
797.028801,TraderOne,Tick,4459,4493,-34,34,150700,150500,56943,-295343,-302143,OK
797.262665,TraderOne,Tick,4459,4493,-34,34,150700,150500,56943,-295343,-302143,OK
797.505855,TraderOne,Tick,4459,4493,-34,34,150700,150500,56943,-295343,-302143,OK
797.701038,TraderOne,Tick,4459,4493,-34,34,150700,150500,56943,-295343,-302143,OK
798.016139,TraderOne,Tick,4459,4493,-34,34,150700,150500,56943,-295343,-302143,OK
798.256147,TraderOne,Tick,4459,4493,-34,34,150700,150500,56943,-295343,-302143,OK
798.459167,TraderOne,Tick,4469,4493,-24,24,150700,150500,56792,-299192,-303992,OK
798.733608,TraderOne,Tick,4469,4493,-24,24,150700,150500,56792,-299192,-303992,OK
799.012571,TraderOne,Tick,4469,4493,-24,24,150700,150500,56792,-299192,-303992,OK
799.255335,TraderOne,Tick,4469,4493,-24,24,150700,150500,56792,-299192,-303992,OK
799.493407,TraderOne,Tick,4469,4493,-24,24,150700,150500,56792,-299192,-303992,OK
799.777473,TraderOne,Tick,4469,4493,-24,24,150700,150500,56792,-299192,-303992,OK
800.03568,TraderOne,Tick,4469,4493,-24,24,150700,150500,56792,-299192,-303992,OK
800.238175,TraderOne,Tick,4469,4493,-24,24,150700,150500,56792,-299192,-303992,OK
800.49946,TraderOne,Tick,4479,4493,-14,14,150400,150800,56641,-299041,-294841,OK
800.767803,TraderOne,Tick,4479,4493,-14,14,150400,150800,56641,-299041,-294841,OK
800.956303,TraderOne,Tick,4479,4493,-14,14,150400,150800,56641,-299041,-294841,OK
801.254735,TraderOne,Tick,4479,4493,-14,14,150400,150800,56641,-299041,-294841,OK
801.516518,TraderOne,Tick,4489,4493,-4,4,150300,150800,56490,-300890,-299690,OK
801.795798,TraderOne,Tick,4489,4493,-4,4,150300,150800,56490,-300890,-299690,OK
801.994524,TraderOne,Tick,4499,4493,6,-6,150800,151100,56339,-301739,-303539,OK
802.2153,TraderOne,Tick,4499,4493,6,-6,150800,151100,56339,-301739,-303539,OK
802.528183,TraderOne,Tick,4499,4493,6,-6,150800,151000,56339,-301739,-302939,OK
802.734094,TraderOne,Tick,4499,4493,6,-6,150800,151200,56339,-301739,-303539,OK
802.97856,TraderOne,Tick,4499,4493,6,-6,150800,151200,56339,-301739,-303539,OK
803.233151,TraderOne,Tick,4499,4493,6,-6,150800,151200,56339,-301739,-303539,OK
803.47509,TraderOne,Tick,4499,4493,6,-6,150800,151200,56339,-301739,-303539,OK
803.772061,TraderOne,Tick,4499,4503,-4,4,151600,151200,56188,-300588,-301788,OK
804.025654,TraderOne,Tick,4499,4503,-4,4,151600,151200,56188,-300588,-301788,OK
804.270848,TraderOne,Tick,4499,4503,-4,4,151600,150900,56188,-300588,-301788,OK
804.535383,TraderOne,Tick,4499,4503,-4,4,151600,150900,56188,-300588,-301788,OK
804.772408,TraderOne,Tick,4509,4503,6,-6,150300,150900,56037,-301437,-303237,OK
804.975927,TraderOne,Tick,4509,4503,6,-6,150300,150900,56037,-301437,-303237,OK
805.2727,TraderOne,Tick,4519,4503,16,-16,150400,150900,55886,-299286,-304086,OK
805.478091,TraderOne,Tick,4519,4503,16,-16,150400,150900,55886,-299286,-304086,OK
805.769204,TraderOne,Tick,4519,4503,16,-16,150400,150900,55886,-299286,-304086,OK
806.031628,TraderOne,Tick,4519,4503,16,-16,150400,150900,55886,-299286,-304086,OK
806.256964,TraderOne,Tick,4519,4513,6,-6,151600,150900,55735,-300135,-298335,OK
806.520433,TraderOne,Tick,4519,4513,6,-6,151600,150900,55735,-300135,-298335,OK
806.720737,TraderOne,Tick,4519,4513,6,-6,151600,151100,55735,-300135,-298335,OK
806.97671,TraderOne,Tick,4519,4523,-4,4,151800,151100,55584,-300984,-302184,OK
807.210369,TraderOne,Tick,4519,4523,-4,4,151800,151100,55584,-300984,-302184,OK
807.516078,TraderOne,Tick,4519,4523,-4,4,151800,151100,55584,-300984,-302184,OK
807.723499,TraderOne,Tick,4519,4523,-4,4,151800,151100,55584,-300984,-302184,OK
807.959753,TraderOne,Tick,4519,4523,-4,4,151800,151100,55584,-300984,-302184,OK
808.291681,TraderOne,Tick,4529,4523,6,-6,150500,151300,55433,-302833,-304633,OK
808.498593,TraderOne,Tick,4539,4523,16,-16,150600,151300,55282,-304682,-309482,OK
808.701318,TraderOne,Tick,4539,4523,16,-16,150600,151300,55282,-304682,-309482,OK
809.020101,TraderOne,Tick,4539,4523,16,-16,150600,151300,55282,-304682,-309482,OK
809.264479,TraderOne,Tick,4539,4523,16,-16,150600,151300,55282,-304682,-309482,OK
809.485866,TraderOne,Tick,4539,4523,16,-16,150600,151300,55282,-304682,-309482,OK
809.799668,TraderOne,Tick,4539,4533,6,-6,151800,151300,55131,-305531,-303731,OK
809.987134,TraderOne,Tick,4549,4533,16,-16,150800,151300,54980,-305380,-310180,OK
810.256331,TraderOne,Tick,4549,4533,16,-16,150800,151300,54980,-305380,-310180,OK
810.514744,TraderOne,Tick,4549,4533,16,-16,150800,151300,54980,-305380,-310180,OK
810.764077,TraderOne,Tick,4549,4533,16,-16,150800,151300,54980,-305380,-310180,OK
811.008207,TraderOne,Tick,4549,4533,16,-16,150800,151300,54980,-305380,-310180,OK
811.207859,TraderOne,Tick,4549,4543,6,-6,151800,151300,54829,-306229,-304429,OK
811.546376,TraderOne,Tick,4549,4543,6,-6,151800,151300,54829,-306229,-304429,OK
811.707465,TraderOne,Tick,4549,4543,6,-6,151800,151400,54829,-306229,-304429,OK
811.99038,TraderOne,Tick,4549,4543,6,-6,151800,151500,54829,-306229,-304429,OK
812.208501,TraderOne,Tick,4559,4543,16,-16,150900,151500,54678,-306078,-310878,OK
812.45159,TraderOne,Tick,4559,4543,16,-16,150900,151500,54678,-306078,-310878,OK
812.767433,TraderOne,Tick,4559,4543,16,-16,150900,151400,54678,-306078,-310878,OK
813.047579,TraderOne,Tick,4561,4543,18,-18,151200,151400,54648,-305648,-309248,OK
813.238083,TraderOne,Tick,4561,4543,18,-18,151200,151700,54648,-305648,-311048,OK
813.513976,TraderOne,Tick,4561,4543,18,-18,151200,151900,54648,-305648,-311048,OK
813.77002,TraderOne,Tick,4571,4543,28,-28,151700,152100,54951,-304951,-313351,OK
814.042429,TraderOne,Tick,4581,4543,38,-38,151700,152100,55254,-303254,-314654,OK
814.288236,TraderOne,Tick,4581,4543,38,-38,151700,152100,55254,-303254,-314654,OK
814.548945,TraderOne,Tick,4581,4543,38,-38,151700,152100,55254,-303254,-314654,OK
814.777147,TraderOne,Tick,4581,4543,38,-38,151800,152100,55254,-303254,-314654,OK
814.979461,TraderOne,Tick,4581,4543,38,-38,151800,152100,55254,-303254,-314654,OK
815.240134,TraderOne,Tick,4581,4553,28,-28,151900,152100,55102,-307102,-312702,OK
815.497183,TraderOne,Tick,4581,4553,28,-28,151900,152100,55102,-307102,-312702,OK
815.768828,TraderOne,Tick,4591,4553,38,-38,151400,152100,54950,-303950,-315350,OK
816.003733,TraderOne,Tick,4591,4553,38,-38,151400,152100,54950,-303950,-315350,OK
816.223404,TraderOne,Tick,4591,4553,38,-38,151400,152100,54950,-303950,-315350,OK
816.473014,TraderOne,Tick,4601,4553,48,-48,151900,152100,55254,-301254,-310854,OK
816.735477,TraderOne,Tick,4601,4553,48,-48,151900,152100,55254,-301254,-310854,OK
816.955082,TraderOne,Tick,4601,4553,48,-48,151900,152100,55254,-301254,-310854,OK
817.261625,TraderOne,Tick,4601,4553,48,-48,151900,152100,55254,-301254,-310854,OK
817.511254,TraderOne,Tick,4601,4553,48,-48,151900,152100,55254,-301254,-310854,OK
817.733435,TraderOne,Tick,4611,4553,58,-58,151600,152100,55102,-297102,-314502,OK
818.049083,TraderOne,Tick,4611,4563,48,-48,151900,152100,54950,-302950,-312550,OK
818.208005,TraderOne,Tick,4611,4563,48,-48,151900,152100,54950,-302950,-312550,OK
818.499381,TraderOne,Tick,4611,4563,48,-48,151900,152400,54950,-302950,-317350,OK
818.797688,TraderOne,Tick,4621,4563,58,-58,151900,152400,55254,-299254,-316654,OK
819.026192,TraderOne,Tick,4631,4563,68,-68,151900,152400,55558,-294558,-314958,OK
819.280527,TraderOne,Tick,4631,4563,68,-68,151900,152300,55558,-294558,-314958,OK
819.454387,TraderOne,Tick,4631,4573,58,-58,151600,152300,55861,-299861,-317261,OK
819.795394,TraderOne,Tick,4631,4573,58,-58,151600,152300,55861,-299861,-317261,OK
819.978663,TraderOne,Tick,4631,4573,58,-58,151600,152300,55861,-299861,-317261,OK
820.280407,TraderOne,Tick,4631,4573,58,-58,151600,152300,55861,-299861,-317261,OK
820.537129,TraderOne,Tick,4631,4573,58,-58,151600,152300,55861,-299861,-317261,OK
820.740356,TraderOne,Tick,4641,4573,68,-68,151900,152300,56165,-295165,-315565,OK
821.014288,TraderOne,Tick,4641,4573,68,-68,151900,152300,56165,-295165,-315565,OK
821.234085,TraderOne,Tick,4641,4583,58,-58,151800,152300,56469,-301469,-318869,OK
821.538073,TraderOne,Tick,4651,4583,68,-68,151900,152300,56773,-296773,-317173,OK
821.728379,TraderOne,Tick,4651,4583,68,-68,151900,152300,56773,-296773,-317173,OK
822.03333,TraderOne,Tick,4651,4583,68,-68,151900,152500,56773,-296773,-317173,OK
822.20343,TraderOne,Tick,4651,4593,58,-58,151900,152500,56621,-303621,-321021,OK
822.526926,TraderOne,Tick,4651,4593,58,-58,151900,152500,56621,-303621,-321021,OK
822.790402,TraderOne,Tick,4651,4593,58,-58,151900,152500,56621,-303621,-321021,OK
822.983078,TraderOne,Tick,4651,4603,48,-48,151900,152500,56925,-308925,-323325,OK
823.232961,TraderOne,Tick,4651,4603,48,-48,151900,152300,56925,-308925,-323325,OK
823.507759,TraderOne,Tick,4651,4613,38,-38,152100,152100,56773,-311773,-311773,OK
823.721205,TraderOne,Tick,4651,4613,38,-38,152100,152100,56773,-311773,-311773,OK
823.96905,TraderOne,Tick,4651,4613,38,-38,152100,152200,56773,-311773,-315573,OK
824.290788,TraderOne,Tick,4651,4613,38,-38,152100,152200,56773,-311773,-315573,OK
824.484965,TraderOne,Tick,4651,4613,38,-38,152100,152200,56773,-311773,-315573,OK
824.768185,TraderOne,Tick,4651,4613,38,-38,152100,152000,56773,-311773,-307973,OK
824.982783,TraderOne,Tick,4661,4613,48,-48,151500,152000,56621,-308621,-323021,OK
825.222625,TraderOne,Tick,4661,4613,48,-48,151500,152000,56621,-308621,-323021,OK
825.472459,TraderOne,Tick,4661,4613,48,-48,151500,152000,56621,-308621,-323021,OK
825.755773,TraderOne,Tick,4661,4613,48,-48,151500,152000,56621,-308621,-323021,OK
825.954444,TraderOne,Tick,4661,4613,48,-48,151500,152000,56621,-308621,-323021,OK
826.254636,TraderOne,Tick,4661,4613,48,-48,151500,152000,56621,-308621,-323021,OK
826.459178,TraderOne,Tick,4661,4613,48,-48,151500,152000,56621,-308621,-323021,OK
826.718668,TraderOne,Tick,4661,4613,48,-48,151500,152000,56621,-308621,-323021,OK
826.952476,TraderOne,Tick,4661,4613,48,-48,151500,152000,56621,-308621,-323021,OK
827.245506,TraderOne,Tick,4671,4613,58,-58,151500,152000,56469,-304469,-321869,OK
827.495425,TraderOne,Tick,4671,4613,58,-58,151500,152000,56469,-304469,-321869,OK
827.728707,TraderOne,Tick,4681,4613,68,-68,151500,152000,56317,-299317,-319717,OK
827.972863,TraderOne,Tick,4681,4613,68,-68,151500,152000,56317,-299317,-319717,OK
828.215513,TraderOne,Tick,4681,4613,68,-68,151500,152000,56317,-299317,-319717,OK
828.533501,TraderOne,Tick,4681,4623,58,-58,151500,152300,56165,-309165,-326565,OK
828.767345,TraderOne,Tick,4681,4633,48,-48,152200,152300,56013,-314013,-318813,OK
828.980012,TraderOne,Tick,4681,4633,48,-48,152200,152300,56013,-314013,-318813,OK
829.243967,TraderOne,Tick,4681,4633,48,-48,152200,152500,56013,-314013,-328413,OK
829.502286,TraderOne,Tick,4681,4633,48,-48,152200,152500,56013,-314013,-328413,OK
829.795091,TraderOne,Tick,4681,4643,38,-38,152200,152500,55861,-317861,-329261,OK
829.954259,TraderOne,Tick,4681,4643,38,-38,152200,152400,55861,-317861,-325461,OK
830.275252,TraderOne,Tick,4681,4643,38,-38,152200,152400,55861,-317861,-325461,OK
830.459358,TraderOne,Tick,4691,4643,48,-48,151800,152400,55709,-314709,-329109,OK
830.72627,TraderOne,Tick,4701,4643,58,-58,151800,152500,55557,-310557,-327957,OK
831.0045,TraderOne,Tick,4701,4653,48,-48,152000,152500,55405,-315405,-329805,OK
831.252159,TraderOne,Tick,4701,4653,48,-48,152000,152500,55405,-315405,-329805,OK
831.500127,TraderOne,Tick,4701,4653,48,-48,152000,152500,55405,-315405,-329805,OK
831.727636,TraderOne,Tick,4701,4663,38,-38,152100,152600,55253,-319253,-330653,OK
832.016968,TraderOne,Tick,4711,4663,48,-48,152200,152600,55557,-316557,-330957,OK
832.218897,TraderOne,Tick,4711,4663,48,-48,152200,152600,55557,-316557,-330957,OK
832.537017,TraderOne,Tick,4711,4663,48,-48,152000,152500,55557,-316557,-330957,OK
832.794804,TraderOne,Tick,4711,4663,48,-48,152000,152500,55557,-316557,-330957,OK
832.959284,TraderOne,Tick,4711,4663,48,-48,152000,152600,55557,-316557,-330957,OK
833.255998,TraderOne,Tick,4721,4663,58,-58,152200,152600,55861,-312861,-330261,OK
833.476899,TraderOne,Tick,4721,4663,58,-58,152200,152600,55861,-312861,-330261,OK
833.71581,TraderOne,Tick,4721,4673,48,-48,152000,152600,56165,-319165,-333565,OK
834.000825,TraderOne,Tick,4721,4673,48,-48,152000,152600,56165,-319165,-333565,OK
834.20812,TraderOne,Tick,4721,4673,48,-48,152000,152600,56165,-319165,-333565,OK
834.525604,TraderOne,Tick,4721,4673,48,-48,152000,152600,56165,-319165,-333565,OK
834.741489,TraderOne,Tick,4721,4673,48,-48,152000,152400,56165,-319165,-333565,OK
834.966362,TraderOne,Tick,4721,4673,48,-48,152000,152400,56165,-319165,-333565,OK
835.204711,TraderOne,Tick,4721,4673,48,-48,152000,152400,56165,-319165,-333565,OK
835.482734,TraderOne,Tick,4721,4673,48,-48,152000,152400,56165,-319165,-333565,OK
835.755308,TraderOne,Tick,4721,4673,48,-48,152000,152400,56165,-319165,-333565,OK
836.031757,TraderOne,Tick,4721,4683,38,-38,152200,152400,56013,-323013,-330613,OK
836.233098,TraderOne,Tick,4721,4683,38,-38,152200,152400,56013,-323013,-330613,OK
836.510331,TraderOne,Tick,4721,4693,28,-28,152000,152200,55861,-326861,-332461,OK
836.788593,TraderOne,Tick,4721,4693,28,-28,152000,152200,55861,-326861,-332461,OK
837.029115,TraderOne,Tick,4721,4693,28,-28,152000,152200,55861,-326861,-332461,OK
837.295322,TraderOne,Tick,4731,4693,38,-38,151600,152200,55709,-323709,-335109,OK
837.524417,TraderOne,Tick,4731,4693,38,-38,151600,152200,55709,-323709,-335109,OK
837.751464,TraderOne,Tick,4731,4693,38,-38,151600,152200,55709,-323709,-335109,OK
837.986114,TraderOne,Tick,4731,4693,38,-38,151600,152200,55709,-323709,-335109,OK
838.237919,TraderOne,Tick,4731,4703,28,-28,152000,152200,55557,-327557,-333157,OK
838.538959,TraderOne,Tick,4731,4713,18,-18,152100,152200,55861,-329861,-331661,OK
838.713674,TraderOne,Tick,4731,4723,8,-8,152100,152200,56165,-330165,-330965,OK
838.961462,TraderOne,Tick,4731,4733,-2,2,152300,152100,56469,-330469,-330869,OK
839.259233,TraderOne,Tick,4731,4733,-2,2,152300,152100,56469,-330469,-330869,OK
839.466358,TraderOne,Tick,4735,4733,2,-2,152200,152100,56408,-330408,-330208,OK
839.78111,TraderOne,Tick,4735,4733,2,-2,152200,152100,56408,-330408,-330208,OK
840.023237,TraderOne,Tick,4735,4733,2,-2,152200,152100,56408,-330408,-330208,OK
840.243294,TraderOne,Tick,4735,4733,2,-2,152200,152100,56408,-330408,-330208,OK
840.491424,TraderOne,Tick,4735,4733,2,-2,152100,152100,56408,-330408,-330408,OK
840.792977,TraderOne,Tick,4745,4733,12,-12,152300,152100,56713,-329713,-327313,OK
840.964334,TraderOne,Tick,4754,4733,21,-21,152300,152100,56987,-328187,-323987,OK
841.246496,TraderOne,Tick,4754,4733,21,-21,152400,152100,56987,-328187,-321887,OK
841.458995,TraderOne,Tick,4754,4733,21,-21,152400,152400,56987,-328187,-328187,OK
841.727375,TraderOne,Tick,4754,4733,21,-21,152400,152400,56987,-328187,-328187,OK
842.042081,TraderOne,Tick,4754,4733,21,-21,152400,152400,56987,-328187,-328187,OK
842.249582,TraderOne,Tick,4754,4743,11,-11,152100,152400,57291,-330491,-333791,OK
842.47073,TraderOne,Tick,4754,4743,11,-11,152100,152400,57291,-330491,-333791,OK
842.75749,TraderOne,Tick,4754,4743,11,-11,152100,152400,57291,-330491,-333791,OK
843.029094,TraderOne,Tick,4754,4743,11,-11,152100,152400,57291,-330491,-333791,OK
843.262198,TraderOne,Tick,4754,4743,11,-11,152100,152400,57291,-330491,-333791,OK
843.528536,TraderOne,Tick,4754,4743,11,-11,152100,152400,57291,-330491,-333791,OK
843.745973,TraderOne,Tick,4754,4743,11,-11,152100,152400,57291,-330491,-333791,OK
844.020067,TraderOne,Tick,4754,4743,11,-11,152100,152400,57291,-330491,-333791,OK
844.254289,TraderOne,Tick,4754,4743,11,-11,152100,152700,57291,-330491,-333791,OK
844.531271,TraderOne,Tick,4764,4743,21,-21,152400,153000,57596,-327796,-334096,OK
844.747447,TraderOne,Tick,4774,4743,31,-31,152400,153100,57901,-323101,-332401,OK
844.953867,TraderOne,Tick,4784,4743,41,-41,152500,153100,58206,-318406,-330706,OK
845.254243,TraderOne,Tick,4794,4743,51,-51,152500,152900,58511,-314711,-330011,OK
845.52677,TraderOne,Tick,4794,4753,41,-41,152300,152900,58816,-320016,-332316,OK
845.73812,TraderOne,Tick,4794,4753,41,-41,152300,152900,58816,-320016,-332316,OK
846.026698,TraderOne,Tick,4794,4753,41,-41,152100,152400,58816,-320016,-332316,OK
846.275964,TraderOne,Tick,4794,4753,41,-41,152100,152400,58816,-320016,-332316,OK
846.497224,TraderOne,Tick,4794,4753,41,-41,152100,152400,58816,-320016,-332316,OK
846.746561,TraderOne,Tick,4794,4753,41,-41,152100,152400,58816,-320016,-332316,OK
847.025427,TraderOne,Tick,4794,4763,31,-31,152500,152400,58664,-321864,-318764,OK
847.257266,TraderOne,Tick,4794,4763,31,-31,152500,152700,58664,-321864,-328064,OK
847.510798,TraderOne,Tick,4794,4763,31,-31,152500,152700,58664,-321864,-328064,OK
847.783,TraderOne,Tick,4794,4763,31,-31,152500,152700,58664,-321864,-328064,OK
847.963058,TraderOne,Tick,4794,4763,31,-31,152500,152700,58664,-321864,-328064,OK
848.238098,TraderOne,Tick,4804,4763,41,-41,152500,152700,58969,-319169,-327369,OK
848.460059,TraderOne,Tick,4810,4763,47,-47,152500,152700,59152,-316952,-326352,OK
848.73889,TraderOne,Tick,4810,4763,47,-47,152500,152700,59152,-316952,-326352,OK
848.963635,TraderOne,Tick,4820,4763,57,-57,152600,152700,59457,-313257,-318957,OK
849.285549,TraderOne,Tick,4820,4763,57,-57,152600,152900,59457,-313257,-330357,OK
849.496078,TraderOne,Tick,4820,4773,47,-47,152600,153100,59762,-318562,-332662,OK
849.740032,TraderOne,Tick,4820,4773,47,-47,152600,153100,59762,-318562,-332662,OK
849.98663,TraderOne,Tick,4820,4773,47,-47,152700,153100,59762,-318562,-332662,OK
850.248296,TraderOne,Tick,4820,4773,47,-47,152700,153100,59762,-318562,-332662,OK
850.534306,TraderOne,Tick,4820,4773,47,-47,152700,153100,59762,-318562,-332662,OK
850.709937,TraderOne,Tick,4825,4773,52,-52,152600,153200,59915,-315715,-331315,OK
851.043908,TraderOne,Tick,4835,4773,62,-62,152700,153200,60220,-311020,-329620,OK
851.254989,TraderOne,Tick,4835,4773,62,-62,152700,153200,60220,-311020,-329620,OK
851.452517,TraderOne,Tick,4835,4773,62,-62,152700,153500,60220,-311020,-329620,OK
851.707159,TraderOne,Tick,4845,4783,62,-62,153200,153800,60372,-309172,-327772,OK
851.963968,TraderOne,Tick,4845,4783,62,-62,153200,153700,60372,-309172,-327772,OK
852.242039,TraderOne,Tick,4845,4783,62,-62,153200,153700,60372,-309172,-327772,OK
852.471901,TraderOne,Tick,4845,4783,62,-62,153200,153700,60372,-309172,-327772,OK
852.78559,TraderOne,Tick,4855,4783,72,-72,153000,153600,60219,-305019,-326619,OK
853.007111,TraderOne,Tick,4855,4793,62,-62,153000,153600,60525,-312325,-330925,OK
853.261782,TraderOne,Tick,4855,4803,52,-52,153400,154100,60372,-320172,-335772,OK
853.517208,TraderOne,Tick,4855,4803,52,-52,153400,154100,60372,-320172,-335772,OK
853.757359,TraderOne,Tick,4855,4803,52,-52,153400,154000,60372,-320172,-335772,OK
854.049427,TraderOne,Tick,4855,4803,52,-52,153400,154000,60372,-320172,-335772,OK
854.253469,TraderOne,Tick,4855,4813,42,-42,153500,153900,60219,-326019,-338619,OK
854.479395,TraderOne,Tick,4855,4813,42,-42,153500,153900,60219,-326019,-338619,OK
854.711204,TraderOne,Tick,4855,4813,42,-42,153500,153900,60219,-326019,-338619,OK
854.957507,TraderOne,Tick,4855,4813,42,-42,153500,153900,60219,-326019,-338619,OK
855.292651,TraderOne,Tick,4855,4813,42,-42,153500,153900,60219,-326019,-338619,OK
855.48773,TraderOne,Tick,4855,4813,42,-42,153500,153900,60219,-326019,-338619,OK
855.71633,TraderOne,Tick,4855,4813,42,-42,153500,153900,60219,-326019,-338619,OK
855.952626,TraderOne,Tick,4855,4813,42,-42,153500,153800,60219,-326019,-338619,OK
856.274982,TraderOne,Tick,4855,4813,42,-42,153500,153800,60219,-326019,-338619,OK
856.493143,TraderOne,Tick,4855,4813,42,-42,153500,153800,60219,-326019,-338619,OK
856.730149,TraderOne,Tick,4855,4823,32,-32,153300,153900,60066,-330866,-340466,OK
857.033122,TraderOne,Tick,4855,4823,32,-32,153300,154000,60066,-330866,-340466,OK
857.250482,TraderOne,Tick,4855,4823,32,-32,153300,154000,60066,-330866,-340466,OK
857.461712,TraderOne,Tick,4865,4823,42,-42,153700,154000,60373,-328173,-340773,OK
857.749541,TraderOne,Tick,4875,4823,52,-52,153700,154000,60219,-324019,-339619,OK
857.971789,TraderOne,Tick,4875,4823,52,-52,153700,154000,60219,-324019,-339619,OK
858.211461,TraderOne,Tick,4875,4823,52,-52,153700,154000,60219,-324019,-339619,OK
858.486823,TraderOne,Tick,4875,4823,52,-52,153700,154000,60219,-324019,-339619,OK
858.77553,TraderOne,Tick,4875,4833,42,-42,153700,154000,60065,-327865,-340465,OK
859.04592,TraderOne,Tick,4875,4833,42,-42,153700,154000,60065,-327865,-340465,OK
859.259098,TraderOne,Tick,4885,4833,52,-52,153200,153600,59912,-324712,-340312,OK
859.458023,TraderOne,Tick,4885,4843,42,-42,153200,153800,60218,-330018,-342618,OK
859.794902,TraderOne,Tick,4885,4843,42,-42,153200,153800,60218,-330018,-342618,OK
860.015717,TraderOne,Tick,4885,4843,42,-42,153200,153600,60218,-330018,-342618,OK
860.240033,TraderOne,Tick,4885,4853,32,-32,153700,153600,60065,-332865,-329665,OK
860.450068,TraderOne,Tick,4885,4853,32,-32,153700,153600,60065,-332865,-329665,OK
860.793585,TraderOne,Tick,4885,4853,32,-32,153700,153600,60065,-332865,-329665,OK
861.033103,TraderOne,Tick,4885,4853,32,-32,153700,153600,60065,-332865,-329665,OK
861.226618,TraderOne,Tick,4885,4863,22,-22,153700,153600,59912,-336712,-334512,OK
861.456071,TraderOne,Tick,4885,4863,22,-22,153700,153700,59912,-336712,-336712,OK
861.755091,TraderOne,Tick,4885,4863,22,-22,153700,153700,59912,-336712,-336712,OK
862.006621,TraderOne,Tick,4885,4863,22,-22,153700,153600,59912,-336712,-334512,OK
862.213914,TraderOne,Tick,4885,4873,12,-12,153900,153600,59758,-338558,-334958,OK
862.463144,TraderOne,Tick,4895,4876,19,-19,153600,153600,59559,-336659,-336659,OK
862.767922,TraderOne,Tick,4895,4876,19,-19,153600,153600,59559,-336659,-336659,OK
863.026325,TraderOne,Tick,4895,4876,19,-19,153600,153300,59559,-336659,-330959,OK
863.216218,TraderOne,Tick,4895,4876,19,-19,153600,153000,59559,-336659,-330959,OK
863.531671,TraderOne,Tick,4895,4886,9,-9,153000,153000,59406,-337506,-337506,OK
863.704728,TraderOne,Tick,4895,4896,-1,1,153200,153000,59712,-337812,-338012,OK
864.039458,TraderOne,Tick,4905,4906,-1,1,152900,153000,59865,-338965,-338865,OK
864.265487,TraderOne,Tick,4905,4916,-11,11,153400,153000,59804,-337704,-341004,OK
864.53675,TraderOne,Tick,4905,4916,-11,11,153400,153000,59804,-337704,-341004,OK
864.768397,TraderOne,Tick,4905,4916,-11,11,153400,153000,59804,-337704,-341004,OK
864.985585,TraderOne,Tick,4905,4926,-21,21,153400,153000,59651,-335551,-341851,OK
865.243122,TraderOne,Tick,4913,4926,-13,13,153100,153000,59529,-338629,-339929,OK
865.526998,TraderOne,Tick,4913,4926,-13,13,153100,153000,59529,-338629,-339929,OK
865.723671,TraderOne,Tick,4913,4926,-13,13,153100,153000,59529,-338629,-339929,OK
866.043039,TraderOne,Tick,4913,4936,-23,23,153400,153000,59376,-336476,-343376,OK
866.203495,TraderOne,Tick,4913,4936,-23,23,153400,153000,59376,-336476,-343376,OK
866.472701,TraderOne,Tick,4913,4936,-23,23,153400,152900,59376,-336476,-343376,OK
866.749291,TraderOne,Tick,4923,4956,-33,33,152900,152800,58917,-333017,-336317,OK
867.014867,TraderOne,Tick,4923,4956,-33,33,152900,152900,58917,-333017,-333017,OK
867.274855,TraderOne,Tick,4923,4956,-33,33,152900,152900,58917,-333017,-333017,OK
867.498317,TraderOne,Tick,4933,4956,-23,23,152600,152900,58764,-336864,-329964,OK
867.730099,TraderOne,Tick,4933,4956,-23,23,152600,152900,58764,-336864,-329964,OK
868.00166,TraderOne,Tick,4943,4956,-13,13,153200,152900,58611,-339711,-343611,OK
868.297171,TraderOne,Tick,4953,4957,-4,4,152600,153200,58902,-339802,-338602,OK
868.500695,TraderOne,Tick,4953,4957,-4,4,152600,153200,58902,-339802,-338602,OK
868.714628,TraderOne,Tick,4953,4957,-4,4,152600,153200,58902,-339802,-338602,OK
869.00575,TraderOne,Tick,4953,4957,-4,4,152600,153200,58902,-339802,-338602,OK
869.258499,TraderOne,Tick,4953,4957,-4,4,152600,153200,58902,-339802,-338602,OK
869.454322,TraderOne,Tick,4953,4957,-4,4,152600,153200,58902,-339802,-338602,OK
869.738905,TraderOne,Tick,4953,4957,-4,4,152600,153200,58902,-339802,-338602,OK
869.979753,TraderOne,Tick,4953,4957,-4,4,152600,153200,58902,-339802,-338602,OK
870.213014,TraderOne,Tick,4953,4957,-4,4,152600,153200,58902,-339802,-338602,OK
870.457692,TraderOne,Tick,4953,4957,-4,4,152600,153200,58902,-339802,-338602,OK
870.744262,TraderOne,Tick,4953,4961,-8,8,153400,153200,58841,-338941,-340541,OK
871.043578,TraderOne,Tick,4953,4971,-18,18,153200,153200,59147,-338247,-338247,OK
871.282584,TraderOne,Tick,4953,4971,-18,18,153200,153200,59147,-338247,-338247,OK
871.53707,TraderOne,Tick,4953,4971,-18,18,153200,153200,59147,-338247,-338247,OK
871.73974,TraderOne,Tick,4953,4971,-18,18,153200,153200,59147,-338247,-338247,OK
872.012002,TraderOne,Tick,4953,4971,-18,18,153200,153200,59147,-338247,-338247,OK
872.232261,TraderOne,Tick,4953,4971,-18,18,153200,153200,59147,-338247,-338247,OK
872.451567,TraderOne,Tick,4953,4971,-18,18,153200,152500,59147,-338247,-343647,OK
872.74403,TraderOne,Tick,4953,4981,-28,28,152900,152500,59453,-335553,-343953,OK
872.980453,TraderOne,Tick,4953,4991,-38,38,152900,152500,59759,-331859,-343259,OK
873.251501,TraderOne,Tick,4963,4991,-28,28,152900,152200,59606,-339706,-348106,OK
873.477281,TraderOne,Tick,4963,5001,-38,38,152600,152200,59911,-336011,-347411,OK
873.774755,TraderOne,Tick,4963,5001,-38,38,152600,152300,59911,-336011,-347411,OK
874.017721,TraderOne,Tick,4963,5001,-38,38,152600,152400,59911,-336011,-343611,OK
874.249907,TraderOne,Tick,4963,5011,-48,48,153000,152400,59758,-331858,-346258,OK
874.461943,TraderOne,Tick,4963,5021,-58,58,153000,152400,59605,-326705,-344105,OK
874.798194,TraderOne,Tick,4973,5021,-48,48,152900,152400,59452,-333552,-347952,OK
875.012695,TraderOne,Tick,4983,5021,-38,38,152700,152400,59299,-337399,-348799,OK
875.212874,TraderOne,Tick,4993,5021,-28,28,152700,152500,59604,-340704,-346304,OK
875.498926,TraderOne,Tick,5003,5021,-18,18,152700,152500,59909,-344009,-347609,OK
875.707726,TraderOne,Tick,5003,5021,-18,18,152700,152500,59909,-344009,-347609,OK
875.988892,TraderOne,Tick,5003,5021,-18,18,152700,152500,59909,-344009,-347609,OK
876.245689,TraderOne,Tick,5003,5021,-18,18,152700,152500,59909,-344009,-347609,OK
876.469169,TraderOne,Tick,5003,5031,-28,28,152600,152500,60214,-341314,-344114,OK
876.759252,TraderOne,Tick,5003,5041,-38,38,152600,152500,60519,-338619,-342419,OK
876.975624,TraderOne,Tick,5003,5051,-48,48,152600,152500,60824,-334924,-339724,OK
877.245551,TraderOne,Tick,5003,5051,-48,48,152600,152500,60824,-334924,-339724,OK
877.512876,TraderOne,Tick,5003,5061,-58,58,152800,152500,60671,-329771,-347171,OK
877.770259,TraderOne,Tick,5003,5061,-58,58,152800,152500,60671,-329771,-347171,OK
877.975562,TraderOne,Tick,5003,5061,-58,58,152800,152500,60671,-329771,-347171,OK
878.274586,TraderOne,Tick,5013,5061,-48,48,152300,152500,60518,-335618,-326018,OK
878.518967,TraderOne,Tick,5013,5061,-48,48,152300,152500,60518,-335618,-326018,OK
878.797104,TraderOne,Tick,5013,5071,-58,58,152700,152500,60365,-330465,-342065,OK
878.955893,TraderOne,Tick,5013,5071,-58,58,152700,152500,60365,-330465,-342065,OK
879.293217,TraderOne,Tick,5013,5071,-58,58,152700,152500,60365,-330465,-342065,OK
879.451497,TraderOne,Tick,5023,5071,-48,48,152800,152500,60212,-336312,-350712,OK
879.791236,TraderOne,Tick,5023,5071,-48,48,152800,152300,60212,-336312,-350712,OK
879.971144,TraderOne,Tick,5023,5071,-48,48,152800,152000,60212,-336312,-350712,OK
880.26192,TraderOne,Tick,5033,5071,-38,38,152300,151700,60060,-343160,-354560,OK
880.452827,TraderOne,Tick,5033,5081,-48,48,152100,151500,60364,-339464,-353864,OK
880.761502,TraderOne,Tick,5033,5091,-58,58,152100,151500,60668,-333768,-351168,OK
881.041415,TraderOne,Tick,5033,5091,-58,58,152100,151500,60668,-333768,-351168,OK
881.272356,TraderOne,Tick,5043,5091,-48,48,152200,151500,60972,-341072,-355472,OK
881.530641,TraderOne,Tick,5043,5091,-48,48,152200,151500,60972,-341072,-355472,OK
881.711397,TraderOne,Tick,5043,5091,-48,48,152000,151500,60972,-341072,-355472,OK
881.985481,TraderOne,Tick,5043,5100,-57,57,151900,151500,61245,-336845,-353945,OK
882.29989,TraderOne,Tick,5053,5100,-47,47,152000,151500,61549,-341149,-355249,OK
882.479049,TraderOne,Tick,5053,5100,-47,47,152300,151500,61549,-341149,-355249,OK
882.769867,TraderOne,Tick,5062,5110,-48,48,152300,151500,61260,-340360,-354760,OK
883.022408,TraderOne,Tick,5062,5110,-48,48,152300,151500,61260,-340360,-354760,OK
883.282122,TraderOne,Tick,5062,5110,-48,48,152300,151500,61260,-340360,-354760,OK
883.523406,TraderOne,Tick,5062,5110,-48,48,152300,151500,61260,-340360,-354760,OK
883.703929,TraderOne,Tick,5072,5110,-38,38,152300,151500,61565,-343665,-355065,OK
884.030683,TraderOne,Tick,5082,5110,-28,28,152300,151500,61870,-346970,-355370,OK
884.242408,TraderOne,Tick,5092,5110,-18,18,152300,152200,62175,-349275,-351075,OK
884.498995,TraderOne,Tick,5092,5110,-18,18,152300,152200,62175,-349275,-351075,OK
884.706833,TraderOne,Tick,5092,5110,-18,18,152300,152200,62175,-349275,-351075,OK
885.000868,TraderOne,Tick,5102,5110,-8,8,152300,152200,62480,-351580,-352380,OK
885.233466,TraderOne,Tick,5112,5110,2,-2,151700,152200,62556,-351156,-351756,OK
885.478592,TraderOne,Tick,5112,5110,2,-2,151700,152200,62556,-351156,-351756,OK
885.712876,TraderOne,Tick,5112,5110,2,-2,151700,152200,62556,-351156,-351756,OK
885.961552,TraderOne,Tick,5112,5110,2,-2,151700,152200,62556,-351156,-351756,OK
886.22415,TraderOne,Tick,5122,5110,12,-12,152300,152200,62404,-351004,-349804,OK
886.502539,TraderOne,Tick,5132,5110,22,-22,152300,152200,62252,-349852,-347652,OK
886.731888,TraderOne,Tick,5142,5110,32,-32,152000,152200,62556,-346156,-352556,OK
887.033348,TraderOne,Tick,5152,5110,42,-42,152000,152200,62860,-342460,-350860,OK
887.21918,TraderOne,Tick,5152,5120,32,-32,153000,152200,62708,-345308,-335708,OK
887.511665,TraderOne,Tick,5152,5130,22,-22,152300,152200,62556,-348156,-345956,OK
887.752543,TraderOne,Tick,5152,5140,12,-12,152900,152200,62862,-345462,-341862,OK
887.957964,TraderOne,Tick,5152,5141,11,-11,152900,152200,62893,-345093,-341793,OK
888.253135,TraderOne,Tick,5162,5141,21,-21,152300,152200,62741,-344941,-342841,OK
888.488705,TraderOne,Tick,5162,5141,21,-21,152300,152200,62741,-344941,-342841,OK
888.73746,TraderOne,Tick,5162,5151,11,-11,153000,152200,62589,-345789,-342489,OK
889.03509,TraderOne,Tick,5172,5151,21,-21,152200,152100,62437,-346637,-344537,OK
889.219624,TraderOne,Tick,5172,5161,11,-11,153000,152000,62285,-346485,-343185,OK
889.527862,TraderOne,Tick,5172,5171,1,-1,152600,152000,62133,-347333,-347033,OK
889.799718,TraderOne,Tick,5172,5171,1,-1,152600,152000,62133,-347333,-347033,OK
890.045255,TraderOne,Tick,5172,5171,1,-1,152600,152000,62133,-347333,-347033,OK
890.284592,TraderOne,Tick,5172,5181,-9,9,152400,151900,61981,-347181,-349881,OK
890.46575,TraderOne,Tick,5172,5181,-9,9,152400,151900,61981,-347181,-349881,OK
890.790083,TraderOne,Tick,5182,5181,1,-1,151400,152000,61829,-348029,-348329,OK
890.962026,TraderOne,Tick,5192,5181,11,-11,151400,152000,61677,-347877,-351177,OK
891.263159,TraderOne,Tick,5192,5181,11,-11,151400,152000,61677,-347877,-351177,OK
891.47114,TraderOne,Tick,5202,5191,11,-11,151800,152000,61373,-348573,-350773,OK
891.799196,TraderOne,Tick,5212,5191,21,-21,151500,152000,61676,-344876,-351176,OK
891.983855,TraderOne,Tick,5222,5191,31,-31,151500,152000,61979,-340179,-349479,OK
892.239438,TraderOne,Tick,5223,5191,32,-32,151500,152000,62009,-339809,-349409,OK
892.494273,TraderOne,Tick,5223,5191,32,-32,151500,152000,62009,-339809,-349409,OK
892.798855,TraderOne,Tick,5223,5201,22,-22,152600,152000,61857,-342657,-336057,OK
892.970923,TraderOne,Tick,5223,5201,22,-22,152600,152100,61857,-342657,-336057,OK
893.207689,TraderOne,Tick,5223,5201,22,-22,152600,152100,61857,-342657,-336057,OK
893.529434,TraderOne,Tick,5223,5201,22,-22,152600,152100,61857,-342657,-336057,OK
893.725941,TraderOne,Tick,5223,5201,22,-22,152600,151900,61857,-342657,-336057,OK
893.961717,TraderOne,Tick,5223,5211,12,-12,151600,151900,61705,-344505,-348105,OK
894.226821,TraderOne,Tick,5223,5221,2,-2,151700,151700,62008,-345808,-345808,OK
894.500276,TraderOne,Tick,5223,5231,-8,8,151800,151700,62312,-345112,-345912,OK
894.776005,TraderOne,Tick,5223,5231,-8,8,151800,151700,62312,-345112,-345912,OK
895.006445,TraderOne,Tick,5223,5231,-8,8,151800,151600,62312,-345112,-346712,OK
895.267924,TraderOne,Tick,5223,5241,-18,18,151800,151600,62616,-343416,-347016,OK
895.535071,TraderOne,Tick,5223,5241,-18,18,151800,151500,62616,-343416,-348816,OK
895.718183,TraderOne,Tick,5223,5251,-28,28,151800,151500,62920,-340720,-349120,OK
895.968122,TraderOne,Tick,5223,5251,-28,28,151800,151500,62920,-340720,-349120,OK
896.271961,TraderOne,Tick,5223,5271,-48,48,151800,151500,63072,-333872,-348272,OK
896.49573,TraderOne,Tick,5233,5271,-38,38,151900,151500,63376,-339176,-350576,OK
896.75369,TraderOne,Tick,5233,5271,-38,38,151800,151500,63376,-339176,-350576,OK
896.964166,TraderOne,Tick,5243,5271,-28,28,151900,151500,63680,-342480,-350880,OK
897.226596,TraderOne,Tick,5253,5271,-18,18,151900,151500,63984,-345784,-351184,OK
897.492827,TraderOne,Tick,5253,5271,-18,18,151900,151500,63984,-345784,-351184,OK
897.70125,TraderOne,Tick,5253,5271,-18,18,151900,151500,63984,-345784,-351184,OK
897.957956,TraderOne,Tick,5253,5271,-18,18,151900,151700,63984,-345784,-349384,OK
898.241973,TraderOne,Tick,5254,5271,-17,17,151900,151700,64014,-345914,-349314,OK
898.483047,TraderOne,Tick,5254,5281,-27,27,152400,151700,63862,-343762,-351862,OK
898.784293,TraderOne,Tick,5254,5291,-37,37,152400,151700,63710,-340610,-351710,OK
899.046759,TraderOne,Tick,5254,5291,-37,37,152400,151700,63710,-340610,-351710,OK
899.247402,TraderOne,Tick,5254,5291,-37,37,152400,151700,63710,-340610,-351710,OK
899.471994,TraderOne,Tick,5254,5291,-37,37,152400,151800,63710,-340610,-351710,OK
899.775346,TraderOne,Tick,5254,5291,-37,37,152400,151600,63710,-340610,-351710,OK
900.046343,TraderOne,Tick,5254,5291,-37,37,152400,151600,63710,-340610,-351710,OK
