Time,Team,Operation,BuyVolume,SellVolume,EtfPosition,FuturePosition,EtfPrice,FuturePrice,TotalFees,AccountBalance,ProfitOrLoss,Status
1.5e-05,TraderOne,Tick,0,0,0,0,,,0,0,0,OK
0.237688,TraderOne,Tick,0,0,0,0,,,0,0,0,OK
0.467014,TraderOne,Tick,0,0,0,0,,,0,0,0,OK
0.703456,TraderOne,Tick,0,0,0,0,,,0,0,0,OK
0.988978,TraderOne,Tick,0,10,-10,10,147600,147100,-147,147,-1853,OK
1.245001,TraderOne,Tick,1,10,-9,9,147000,147100,-118,218,1118,OK
1.464755,TraderOne,Tick,1,10,-9,9,147000,147100,-118,218,1118,OK
1.718528,TraderOne,Tick,1,10,-9,9,147000,147100,-118,218,1118,OK
1.966636,TraderOne,Tick,1,10,-9,9,147000,147100,-118,218,1118,OK
2.238768,TraderOne,Tick,1,10,-9,9,147000,146900,-118,218,-682,OK
2.514093,TraderOne,Tick,11,10,1,-1,146400,146900,-265,-1635,-1835,OK
2.704957,TraderOne,Tick,11,10,1,-1,146400,146900,-265,-1635,-1835,OK
3.01045,TraderOne,Tick,11,10,1,-1,146400,146900,-265,-1635,-1835,OK
3.224638,TraderOne,Tick,11,10,1,-1,146400,146900,-265,-1635,-1835,OK
3.486287,TraderOne,Tick,11,20,-9,9,147500,146900,-412,-1488,-3288,OK
3.760856,TraderOne,Tick,21,20,1,-1,146300,146900,-559,-2341,-2541,OK
3.976087,TraderOne,Tick,21,20,1,-1,146300,146900,-559,-2341,-2541,OK
4.259806,TraderOne,Tick,21,20,1,-1,146300,146900,-559,-2341,-2541,OK
4.548326,TraderOne,Tick,31,20,11,-11,146300,146900,-706,-2194,-4394,OK
4.71438,TraderOne,Tick,31,20,11,-11,146300,146900,-706,-2194,-4394,OK
5.01883,TraderOne,Tick,31,20,11,-11,146300,146900,-706,-2194,-4394,OK
5.26118,TraderOne,Tick,31,20,11,-11,146300,146800,-706,-2194,-4394,OK
5.50756,TraderOne,Tick,31,20,11,-11,146300,146800,-706,-2194,-4394,OK
5.700206,TraderOne,Tick,31,20,11,-11,146300,146800,-706,-2194,-4394,OK
6.0491,TraderOne,Tick,31,30,1,-1,147000,146800,-412,-2488,-2288,OK
6.238306,TraderOne,Tick,31,40,-9,9,147000,146800,-118,-1782,-3582,OK
6.505174,TraderOne,Tick,31,50,-19,19,147000,146800,176,924,-2876,OK
6.798492,TraderOne,Tick,31,60,-29,29,147200,146700,470,3630,-2170,OK
6.971112,TraderOne,Tick,31,60,-29,29,147200,146900,470,3630,-2170,OK
7.209623,TraderOne,Tick,31,60,-29,29,147200,146900,470,3630,-2170,OK
7.463188,TraderOne,Tick,31,60,-29,29,147200,146900,470,3630,-2170,OK
7.738753,TraderOne,Tick,31,60,-29,29,147200,146900,470,3630,-2170,OK
8.005707,TraderOne,Tick,31,60,-29,29,147200,146900,470,3630,-2170,OK
8.267537,TraderOne,Tick,41,60,-19,19,147000,146900,323,777,-1123,OK
8.471426,TraderOne,Tick,41,60,-19,19,147000,146900,323,777,-1123,OK
8.730807,TraderOne,Tick,41,60,-19,19,147000,146900,323,777,-1123,OK
8.997897,TraderOne,Tick,51,60,-9,9,146700,146900,176,-1076,724,OK
9.256923,TraderOne,Tick,61,60,1,-1,146400,146900,469,1631,1431,OK
9.532807,TraderOne,Tick,71,60,11,-11,146400,146900,762,4338,2138,OK
9.788935,TraderOne,Tick,81,60,21,-21,146400,146900,1055,5045,845,OK
10.0365,TraderOne,Tick,81,60,21,-21,146400,146900,1055,5045,845,OK
10.269758,TraderOne,Tick,91,60,31,-31,146400,146900,1348,6752,552,OK
10.498295,TraderOne,Tick,101,60,41,-41,146400,146900,1641,10459,2259,OK
10.762562,TraderOne,Tick,111,60,51,-51,146400,147000,1934,15166,4966,OK
11.021595,TraderOne,Tick,111,70,41,-41,147300,147000,1787,9313,17513,OK
11.229264,TraderOne,Tick,111,70,41,-41,147300,147000,1787,9313,17513,OK
11.523329,TraderOne,Tick,111,70,41,-41,147300,147000,1787,9313,17513,OK
11.788152,TraderOne,Tick,111,80,31,-31,147400,147200,1640,6460,12660,OK
11.959537,TraderOne,Tick,111,80,31,-31,147400,147200,1640,6460,12660,OK
12.22593,TraderOne,Tick,111,80,31,-31,147400,147200,1640,6460,12660,OK
12.476494,TraderOne,Tick,111,80,31,-31,147400,147200,1640,6460,12660,OK
12.763731,TraderOne,Tick,111,80,31,-31,147400,147200,1640,6460,12660,OK
13.018031,TraderOne,Tick,111,80,31,-31,147400,147200,1640,6460,12660,OK
13.236823,TraderOne,Tick,111,80,31,-31,146600,147200,1640,6460,260,OK
13.482178,TraderOne,Tick,111,80,31,-31,146600,147200,1640,6460,260,OK
13.736913,TraderOne,Tick,111,80,31,-31,146600,147200,1640,6460,260,OK
14.037833,TraderOne,Tick,111,80,31,-31,146600,147200,1640,6460,260,OK
14.233604,TraderOne,Tick,111,80,31,-31,146600,147200,1640,6460,260,OK
14.458318,TraderOne,Tick,111,80,31,-31,146600,147200,1640,6460,260,OK
14.758285,TraderOne,Tick,111,80,31,-31,146600,147200,1640,6460,260,OK
15.029773,TraderOne,Tick,111,80,31,-31,146600,147200,1640,6460,260,OK
15.291497,TraderOne,Tick,111,80,31,-31,146600,147200,1640,6460,260,OK
15.508559,TraderOne,Tick,111,90,21,-21,146900,146800,1493,4607,6707,OK
15.748424,TraderOne,Tick,111,90,21,-21,146900,146800,1493,4607,6707,OK
16.043392,TraderOne,Tick,111,100,11,-11,146900,146900,1346,754,754,OK
16.272609,TraderOne,Tick,111,100,11,-11,146900,146900,1346,754,754,OK
16.454444,TraderOne,Tick,111,100,11,-11,146900,146900,1346,754,754,OK
16.770742,TraderOne,Tick,111,100,11,-11,146900,146900,1346,754,754,OK
17.017409,TraderOne,Tick,111,100,11,-11,146900,146900,1346,754,754,OK
17.272505,TraderOne,Tick,111,100,11,-11,146900,146900,1346,754,754,OK
17.466843,TraderOne,Tick,111,100,11,-11,146900,146900,1346,754,754,OK
17.7107,TraderOne,Tick,121,100,21,-21,146900,146900,1640,1460,1460,OK
18.001274,TraderOne,Tick,131,100,31,-31,146600,146900,1493,3607,-2593,OK
18.245828,TraderOne,Tick,131,100,31,-31,146600,146900,1493,3607,-2593,OK
18.539712,TraderOne,Tick,131,100,31,-31,146600,147100,1493,3607,-2593,OK
18.701973,TraderOne,Tick,131,100,31,-31,146600,147100,1493,3607,-2593,OK
19.034018,TraderOne,Tick,131,100,31,-31,146600,147100,1493,3607,-2593,OK
19.223677,TraderOne,Tick,131,100,31,-31,146600,147100,1493,3607,-2593,OK
19.534592,TraderOne,Tick,131,100,31,-31,146600,147200,1493,3607,-2593,OK
19.772575,TraderOne,Tick,131,100,31,-31,146600,147200,1493,3607,-2593,OK
19.999286,TraderOne,Tick,131,100,31,-31,146600,147200,1493,3607,-2593,OK
20.271913,TraderOne,Tick,141,100,41,-41,146900,147200,1787,6313,-1887,OK
20.48154,TraderOne,Tick,151,100,51,-51,147000,147900,2081,10019,-181,OK
20.786782,TraderOne,Tick,161,110,51,-51,147500,147900,2228,12872,2672,OK
21.009372,TraderOne,Tick,161,116,45,-45,147600,147900,2405,10895,1895,OK
21.21688,TraderOne,Tick,161,116,45,-45,147600,147900,2405,10895,1895,OK
21.495074,TraderOne,Tick,161,116,45,-45,147600,147900,2405,10895,1895,OK
21.727809,TraderOne,Tick,161,116,45,-45,147600,147900,2405,10895,1895,OK
21.957794,TraderOne,Tick,161,116,45,-45,147600,148000,2405,10895,1895,OK
22.254832,TraderOne,Tick,161,116,45,-45,147600,148000,2405,10895,1895,OK
22.516318,TraderOne,Tick,161,116,45,-45,147600,148100,2405,10895,1895,OK
22.713844,TraderOne,Tick,161,116,45,-45,147600,148200,2405,10895,1895,OK
22.98286,TraderOne,Tick,171,116,55,-55,147700,148000,2700,13600,2600,OK
23.220884,TraderOne,Tick,171,116,55,-55,147700,148000,2700,13600,2600,OK
23.544376,TraderOne,Tick,171,126,45,-45,147400,147700,2995,10305,1305,OK
23.750396,TraderOne,Tick,171,126,45,-45,147400,147700,2995,10305,1305,OK
24.028133,TraderOne,Tick,171,126,45,-45,147400,147700,2995,10305,1305,OK
24.223954,TraderOne,Tick,181,126,55,-55,147400,147700,3290,14010,3010,OK
24.529553,TraderOne,Tick,181,126,55,-55,147400,147700,3290,14010,3010,OK
24.709589,TraderOne,Tick,181,126,55,-55,147400,147700,3290,14010,3010,OK
24.954927,TraderOne,Tick,181,126,55,-55,147400,148100,3290,14010,3010,OK
25.221266,TraderOne,Tick,191,126,65,-65,147700,148200,3585,18715,5715,OK
25.461882,TraderOne,Tick,191,136,55,-55,147600,147900,3880,12420,1420,OK
25.776759,TraderOne,Tick,191,136,55,-55,147700,147900,3880,12420,1420,OK
26.018587,TraderOne,Tick,191,136,55,-55,147700,147900,3880,12420,1420,OK
26.316707,TraderOne,Tick,191,136,55,-55,147700,147900,3880,12420,1420,OK
26.530482,TraderOne,Tick,201,136,65,-65,147400,147900,3733,17567,4567,OK
26.76459,TraderOne,Tick,201,136,65,-65,147400,147900,3733,17567,4567,OK
27.012445,TraderOne,Tick,201,146,55,-55,147400,147900,4028,11272,272,OK
27.311438,TraderOne,Tick,201,146,55,-55,147400,147900,4028,11272,272,OK
27.509741,TraderOne,Tick,201,146,55,-55,147400,147900,4028,11272,272,OK
27.741225,TraderOne,Tick,201,146,55,-55,147400,147800,4028,11272,272,OK
27.992442,TraderOne,Tick,211,156,55,-55,147200,147800,3733,11567,567,OK
28.306702,TraderOne,Tick,211,166,45,-55,147700,147800,3586,1484714,2214,OK
28.508857,TraderOne,Tick,211,166,45,-45,147700,147800,3586,7714,3214,OK
28.751688,TraderOne,Tick,211,166,45,-45,147700,147600,3586,7714,12214,OK
29.035467,TraderOne,Tick,211,166,45,-45,147700,147600,3586,7714,12214,OK
29.26812,TraderOne,Tick,211,166,45,-45,147700,147600,3586,7714,12214,OK
29.515282,TraderOne,Tick,211,166,45,-45,147700,147600,3586,7714,12214,OK
29.710873,TraderOne,Tick,211,176,35,-35,147100,147600,3880,4420,-2580,OK
29.964742,TraderOne,Tick,211,186,25,-25,147700,147600,3733,1567,4067,OK
30.287787,TraderOne,Tick,221,186,35,-35,147000,147600,3586,4714,-2286,OK
30.456192,TraderOne,Tick,221,186,35,-35,147000,147600,3586,4714,-2286,OK
30.71173,TraderOne,Tick,221,186,35,-35,147000,147400,3586,4714,-2286,OK
30.95611,TraderOne,Tick,231,186,45,-45,147000,147400,3880,7420,-1580,OK
31.209847,TraderOne,Tick,231,186,45,-45,147000,147400,3880,7420,-1580,OK
31.502123,TraderOne,Tick,241,186,55,-55,147000,147400,4174,11126,126,OK
31.761979,TraderOne,Tick,241,186,55,-55,147000,147400,4174,11126,126,OK
31.983217,TraderOne,Tick,251,186,65,-65,147000,147400,4027,16273,3273,OK
32.300351,TraderOne,Tick,251,186,65,-65,147000,147400,4027,16273,3273,OK
32.464444,TraderOne,Tick,251,186,65,-65,147000,147400,4027,16273,3273,OK
32.728217,TraderOne,Tick,251,186,65,-65,147000,147600,4027,16273,3273,OK
32.956413,TraderOne,Tick,251,196,55,-55,147000,147600,4321,10979,-21,OK
33.301437,TraderOne,Tick,251,206,45,-45,146900,147600,4615,5685,-3315,OK
33.532554,TraderOne,Tick,251,216,35,-35,146900,147600,4909,1391,-5609,OK
33.771566,TraderOne,Tick,251,216,35,-35,146900,147600,4909,1391,-5609,OK
33.957241,TraderOne,Tick,251,216,35,-35,146900,147600,4909,1391,-5609,OK
34.226525,TraderOne,Tick,251,216,35,-35,146900,147200,4909,1391,-5609,OK
34.532703,TraderOne,Tick,251,216,35,-35,146900,147200,4909,1391,-5609,OK
34.713489,TraderOne,Tick,251,216,35,-35,146900,147200,4909,1391,-5609,OK
35.025356,TraderOne,Tick,251,216,35,-35,146900,147200,4909,1391,-5609,OK
35.223001,TraderOne,Tick,251,216,35,-35,146900,147300,4909,1391,-5609,OK
35.543445,TraderOne,Tick,251,226,25,-25,147100,147000,4762,-3462,-962,OK
35.77481,TraderOne,Tick,251,236,15,-15,147200,147000,5056,-5756,-2756,OK
36.023591,TraderOne,Tick,251,236,15,-15,147200,147000,5056,-5756,-2756,OK
36.23033,TraderOne,Tick,251,236,15,-15,147200,147000,5056,-5756,-2756,OK
36.489911,TraderOne,Tick,251,243,8,-8,147200,147000,5262,-6662,-5062,OK
36.764333,TraderOne,Tick,251,243,8,-8,147200,147000,5262,-6662,-5062,OK
36.963026,TraderOne,Tick,251,243,8,-8,147200,147000,5262,-6662,-5062,OK
37.239098,TraderOne,Tick,251,243,8,-8,147200,147000,5262,-6662,-5062,OK
37.45319,TraderOne,Tick,251,243,8,-8,147200,147300,5262,-6662,-7462,OK
37.727082,TraderOne,Tick,251,243,8,-8,147200,147300,5262,-6662,-7462,OK
38.003145,TraderOne,Tick,251,243,8,-8,147200,147300,5262,-6662,-7462,OK
38.219504,TraderOne,Tick,251,243,8,-8,147200,147300,5262,-6662,-7462,OK
38.53948,TraderOne,Tick,251,243,8,-8,147200,147300,5262,-6662,-7462,OK
38.757544,TraderOne,Tick,251,243,8,-8,147200,147300,5262,-6662,-7462,OK
39.038551,TraderOne,Tick,261,243,18,-18,147500,147300,5557,-6957,-3357,OK
39.251474,TraderOne,Tick,261,243,18,-18,147500,147300,5557,-6957,-3357,OK
39.489865,TraderOne,Tick,261,253,8,-8,147700,147300,5409,-7809,-6209,OK
39.705734,TraderOne,Tick,261,253,8,-8,147700,147300,5409,-7809,-6209,OK
39.982341,TraderOne,Tick,261,253,8,-8,147700,147300,5409,-7809,-6209,OK
40.246458,TraderOne,Tick,261,253,8,-8,147700,147300,5409,-7809,-6209,OK
40.536515,TraderOne,Tick,261,263,-2,2,147700,147300,5261,-7661,-8061,OK
40.718894,TraderOne,Tick,261,263,-2,2,147700,147300,5261,-7661,-8061,OK
41.023638,TraderOne,Tick,261,263,-2,2,147700,147300,5261,-7661,-8061,OK
41.220953,TraderOne,Tick,261,263,-2,2,147700,147300,5261,-7661,-8061,OK
41.460125,TraderOne,Tick,261,263,-2,2,147700,147300,5261,-7661,-8061,OK
41.708055,TraderOne,Tick,261,263,-2,2,147700,147300,5261,-7661,-8061,OK
42.005752,TraderOne,Tick,261,263,-2,2,147700,147200,5261,-7661,-8061,OK
42.279148,TraderOne,Tick,261,271,-10,10,147500,147200,5143,-6743,-8743,OK
42.525535,TraderOne,Tick,261,271,-10,10,147500,147200,5143,-6743,-8743,OK
42.785173,TraderOne,Tick,261,271,-10,10,147500,147200,5143,-6743,-8743,OK
42.957445,TraderOne,Tick,261,271,-10,10,147500,147200,5143,-6743,-8743,OK
43.209349,TraderOne,Tick,261,271,-10,10,147500,147200,5143,-6743,-8743,OK
43.494359,TraderOne,Tick,261,271,-10,10,147500,147200,5143,-6743,-8743,OK
43.752605,TraderOne,Tick,261,271,-10,10,147500,147400,5143,-6743,-7743,OK
44.018104,TraderOne,Tick,261,271,-10,10,147500,147400,5143,-6743,-7743,OK
44.298614,TraderOne,Tick,261,271,-10,10,147500,147400,5143,-6743,-7743,OK
44.457145,TraderOne,Tick,261,271,-10,10,147500,147400,5143,-6743,-7743,OK
44.78048,TraderOne,Tick,261,271,-10,10,147500,147400,5143,-6743,-7743,OK
45.0362,TraderOne,Tick,261,271,-10,10,147700,147400,5143,-6743,-8743,OK
45.27162,TraderOne,Tick,261,271,-10,10,147700,147500,5143,-6743,-8743,OK
45.50824,TraderOne,Tick,261,271,-10,10,147700,147500,5143,-6743,-8743,OK
45.739828,TraderOne,Tick,261,271,-10,10,147700,147500,5143,-6743,-8743,OK
46.035796,TraderOne,Tick,261,271,-10,10,147700,147500,5143,-6743,-8743,OK
46.262831,TraderOne,Tick,261,271,-10,10,147700,147500,5143,-6743,-8743,OK
46.535585,TraderOne,Tick,261,271,-10,10,147700,147500,5143,-6743,-8743,OK
46.766709,TraderOne,Tick,261,281,-20,20,147400,147500,5438,-6038,-4038,OK
47.031015,TraderOne,Tick,261,289,-28,28,147400,147500,5674,-4674,-1874,OK
47.263937,TraderOne,Tick,261,289,-28,28,147400,147500,5674,-4674,-1874,OK
47.544704,TraderOne,Tick,261,299,-38,38,147700,147500,5526,-2526,-10126,OK
47.743374,TraderOne,Tick,261,299,-38,38,147700,147500,5526,-2526,-10126,OK
47.954349,TraderOne,Tick,261,299,-38,38,147700,147500,5526,-2526,-10126,OK
48.295222,TraderOne,Tick,271,299,-28,28,147100,147500,5378,-7378,-1778,OK
48.53866,TraderOne,Tick,271,299,-28,28,147100,147500,5378,-7378,-1778,OK
48.720452,TraderOne,Tick,271,299,-28,28,147100,147500,5378,-7378,-1778,OK
48.988577,TraderOne,Tick,271,299,-28,28,147100,147500,5378,-7378,-1778,OK
49.218133,TraderOne,Tick,271,299,-28,28,147100,147500,5378,-7378,-1778,OK
49.478539,TraderOne,Tick,281,299,-18,18,147700,147500,5673,-10673,-14273,OK
49.79846,TraderOne,Tick,281,299,-18,18,147700,147500,5673,-10673,-14273,OK
50.001674,TraderOne,Tick,281,299,-18,18,147700,147500,5673,-10673,-14273,OK
50.279557,TraderOne,Tick,281,299,-18,18,147700,147500,5673,-10673,-14273,OK
50.525037,TraderOne,Tick,281,299,-18,18,147800,147500,5673,-10673,-14273,OK
50.78277,TraderOne,Tick,281,299,-18,18,147800,147500,5673,-10673,-14273,OK
50.984511,TraderOne,Tick,281,299,-18,18,147800,147500,5673,-10673,-14273,OK
51.231645,TraderOne,Tick,281,299,-18,18,147800,147500,5673,-10673,-14273,OK
51.495008,TraderOne,Tick,281,299,-18,18,147800,147500,5673,-10673,-14273,OK
51.713134,TraderOne,Tick,281,299,-18,18,147800,147500,5673,-10673,-14273,OK
51.965987,TraderOne,Tick,281,299,-18,18,147800,147300,5673,-10673,-14273,OK
52.246305,TraderOne,Tick,281,299,-18,18,147800,147300,5673,-10673,-14273,OK
52.527938,TraderOne,Tick,281,299,-18,18,147800,147300,5673,-10673,-14273,OK
52.767308,TraderOne,Tick,281,299,-18,18,147800,147300,5673,-10673,-14273,OK
53.00546,TraderOne,Tick,281,299,-18,18,147800,147300,5673,-10673,-14273,OK
53.226823,TraderOne,Tick,281,299,-18,18,147800,147300,5673,-10673,-14273,OK
53.470036,TraderOne,Tick,281,299,-18,18,147800,147300,5673,-10673,-14273,OK
53.768914,TraderOne,Tick,281,299,-18,18,147800,147300,5673,-10673,-14273,OK
54.010202,TraderOne,Tick,281,309,-28,28,147900,147300,5525,-8525,-14125,OK
54.302411,TraderOne,Tick,281,309,-28,28,147900,147200,5525,-8525,-14125,OK
54.504262,TraderOne,Tick,281,309,-28,28,147900,147200,5525,-8525,-14125,OK
54.797622,TraderOne,Tick,281,309,-28,28,147900,147200,5525,-8525,-14125,OK
55.040847,TraderOne,Tick,281,309,-28,28,147900,147200,5525,-8525,-14125,OK
55.25458,TraderOne,Tick,291,309,-18,18,147300,147300,5378,-10378,-10378,OK
55.510827,TraderOne,Tick,291,309,-18,18,147300,146900,5378,-10378,-13978,OK
55.779551,TraderOne,Tick,301,309,-8,8,147300,146900,5231,-14231,-15831,OK
56.00483,TraderOne,Tick,301,319,-18,18,147300,147100,5526,-12526,-16126,OK
56.257127,TraderOne,Tick,301,319,-18,18,147300,147100,5526,-12526,-16126,OK
56.514688,TraderOne,Tick,301,328,-27,27,147300,147100,5791,-10991,-16391,OK
56.759438,TraderOne,Tick,301,328,-27,27,147300,147100,5791,-10991,-16391,OK
57.004128,TraderOne,Tick,301,328,-27,27,147300,147100,5791,-10991,-16391,OK
57.274121,TraderOne,Tick,301,328,-27,27,147300,147100,5791,-10991,-16391,OK
57.478378,TraderOne,Tick,301,328,-27,27,147300,146800,5791,-10991,-16391,OK
57.782532,TraderOne,Tick,301,338,-37,37,147100,146600,6085,-7285,-14685,OK
58.047994,TraderOne,Tick,301,345,-44,44,147100,146600,6291,-4691,-13491,OK
58.290608,TraderOne,Tick,301,345,-44,44,147100,146700,6291,-4691,-13491,OK
58.53782,TraderOne,Tick,301,345,-44,44,147100,146700,6291,-4691,-13491,OK
58.750521,TraderOne,Tick,311,345,-34,34,147200,146700,6585,-9985,-16785,OK
59.018542,TraderOne,Tick,311,345,-34,34,147200,146700,6585,-9985,-16785,OK
59.267393,TraderOne,Tick,311,355,-44,44,147000,146700,6879,-6279,-15079,OK
59.526636,TraderOne,Tick,311,355,-44,44,147000,146500,6879,-6279,-15079,OK
59.752085,TraderOne,Tick,311,355,-44,44,147000,146500,6879,-6279,-15079,OK
60.026258,TraderOne,Tick,311,355,-44,44,147000,146500,6879,-6279,-15079,OK
60.214958,TraderOne,Tick,311,355,-44,44,147000,146700,6879,-6279,-15079,OK
60.545587,TraderOne,Tick,311,355,-44,44,147000,146700,6879,-6279,-15079,OK
60.757927,TraderOne,Tick,311,355,-44,44,147000,146600,6879,-6279,-15079,OK
60.966905,TraderOne,Tick,311,355,-44,44,147000,146500,6879,-6279,-15079,OK
61.208905,TraderOne,Tick,311,355,-44,44,147000,146500,6879,-6279,-15079,OK
61.476012,TraderOne,Tick,311,355,-44,44,147000,146500,6879,-6279,-15079,OK
61.783972,TraderOne,Tick,311,355,-44,44,147000,146500,6879,-6279,-15079,OK
62.046736,TraderOne,Tick,311,355,-44,44,147000,146500,6879,-6279,-15079,OK
62.252749,TraderOne,Tick,311,355,-44,44,147000,146300,6879,-6279,-15079,OK
62.451423,TraderOne,Tick,311,365,-54,54,146800,146300,7173,-573,-11373,OK
62.713899,TraderOne,Tick,321,365,-44,44,146800,146300,7467,-6867,-15667,OK
63.014406,TraderOne,Tick,331,365,-34,34,146800,146300,7320,-12720,-19520,OK
63.234614,TraderOne,Tick,331,365,-34,34,146800,146300,7320,-12720,-19520,OK
63.483745,TraderOne,Tick,331,365,-34,34,146800,146300,7320,-12720,-19520,OK
63.754988,TraderOne,Tick,331,365,-34,34,146800,146300,7320,-12720,-19520,OK
63.95991,TraderOne,Tick,331,365,-34,34,146800,146300,7320,-12720,-19520,OK
64.285781,TraderOne,Tick,341,365,-24,24,146700,146300,7614,-16014,-20814,OK
64.516531,TraderOne,Tick,341,365,-24,24,146700,146300,7614,-16014,-20814,OK
64.747941,TraderOne,Tick,341,365,-24,24,146700,146300,7614,-16014,-20814,OK
64.990133,TraderOne,Tick,341,365,-24,24,146700,146300,7614,-16014,-20814,OK
65.209155,TraderOne,Tick,341,365,-24,24,146700,146900,7614,-16014,-11214,OK
65.531829,TraderOne,Tick,341,365,-24,24,146700,146900,7614,-16014,-11214,OK
65.790097,TraderOne,Tick,341,365,-24,24,146700,146900,7614,-16014,-11214,OK
66.014054,TraderOne,Tick,351,365,-14,14,146600,146900,7467,-18867,-16067,OK
66.280378,TraderOne,Tick,351,365,-14,14,146600,146900,7467,-18867,-16067,OK
66.46754,TraderOne,Tick,351,375,-24,24,147300,146900,7320,-15720,-20520,OK
66.760252,TraderOne,Tick,361,375,-14,14,146500,146900,7173,-17573,-14773,OK
67.030449,TraderOne,Tick,361,375,-14,14,146500,146900,7173,-17573,-14773,OK
67.294499,TraderOne,Tick,361,375,-14,14,146500,146900,7173,-17573,-14773,OK
67.487386,TraderOne,Tick,371,375,-4,4,146900,146900,7026,-19426,-19426,OK
67.705423,TraderOne,Tick,371,375,-4,4,146900,146900,7026,-19426,-19426,OK
67.958055,TraderOne,Tick,371,375,-4,4,146900,146900,7026,-19426,-19426,OK
68.247809,TraderOne,Tick,371,385,-14,14,146900,146900,6879,-19279,-19279,OK
68.465257,TraderOne,Tick,381,395,-14,14,146500,146900,7026,-18426,-15626,OK
68.714672,TraderOne,Tick,381,395,-14,14,146500,147200,7026,-18426,-15626,OK
68.986594,TraderOne,Tick,381,395,-14,14,146500,147200,7026,-18426,-15626,OK
69.302571,TraderOne,Tick,381,405,-24,24,147500,147200,6879,-16279,-21079,OK
69.469067,TraderOne,Tick,381,405,-24,24,147500,147200,6879,-16279,-21079,OK
69.788347,TraderOne,Tick,381,405,-24,24,147500,147300,6879,-16279,-21079,OK
69.978493,TraderOne,Tick,381,405,-24,24,147500,147300,6879,-16279,-21079,OK
70.232721,TraderOne,Tick,381,405,-24,24,147500,147300,6879,-16279,-21079,OK
70.512033,TraderOne,Tick,381,405,-24,24,147500,147300,6879,-16279,-21079,OK
70.771085,TraderOne,Tick,391,405,-14,14,146500,147300,6732,-19132,-16332,OK
71.007043,TraderOne,Tick,391,405,-14,14,146500,147300,6732,-19132,-16332,OK
71.269829,TraderOne,Tick,391,405,-14,14,146500,147300,6732,-19132,-16332,OK
71.514202,TraderOne,Tick,391,405,-14,14,146500,147300,6732,-19132,-16332,OK
71.775262,TraderOne,Tick,391,405,-14,14,146500,147300,6732,-19132,-16332,OK
72.031083,TraderOne,Tick,391,405,-14,14,146500,147300,6732,-19132,-16332,OK
72.201937,TraderOne,Tick,391,405,-14,14,146500,147300,6732,-19132,-16332,OK
72.508125,TraderOne,Tick,391,415,-24,24,147500,147300,6584,-17984,-22784,OK
72.725712,TraderOne,Tick,391,415,-24,24,147500,147300,6584,-17984,-22784,OK
72.953374,TraderOne,Tick,391,415,-24,24,147600,147300,6584,-17984,-22784,OK
73.280325,TraderOne,Tick,391,415,-24,24,147600,147300,6584,-17984,-22784,OK
73.537149,TraderOne,Tick,391,415,-24,24,147600,147200,6584,-17984,-22784,OK
73.790035,TraderOne,Tick,401,415,-14,14,147600,147200,6879,-21279,-24079,OK
73.97516,TraderOne,Tick,401,415,-14,14,147600,147200,6879,-21279,-24079,OK
74.301775,TraderOne,Tick,411,415,-4,4,147600,147200,7174,-23574,-24374,OK
74.494243,TraderOne,Tick,411,425,-14,14,147500,147200,7469,-21869,-24669,OK
74.739786,TraderOne,Tick,411,425,-14,14,147500,147200,7469,-21869,-24669,OK
75.034325,TraderOne,Tick,411,425,-14,14,147500,147400,7469,-21869,-23269,OK
75.278592,TraderOne,Tick,411,425,-14,14,147500,147400,7469,-21869,-23269,OK
75.537139,TraderOne,Tick,411,425,-14,14,147500,147400,7469,-21869,-23269,OK
75.780707,TraderOne,Tick,411,425,-14,14,147500,147400,7469,-21869,-23269,OK
75.975614,TraderOne,Tick,411,425,-14,14,147500,147400,7469,-21869,-23269,OK
76.23753,TraderOne,Tick,411,425,-14,14,147500,147400,7469,-21869,-23269,OK
76.512885,TraderOne,Tick,411,425,-14,14,147500,147500,7469,-21869,-21869,OK
76.722468,TraderOne,Tick,421,425,-4,4,147600,147600,7764,-23164,-23164,OK
77.035895,TraderOne,Tick,421,425,-4,4,147600,147600,7764,-23164,-23164,OK
77.225435,TraderOne,Tick,421,435,-14,14,147500,147600,8059,-22459,-21059,OK
77.459761,TraderOne,Tick,421,435,-14,14,147500,147600,8059,-22459,-21059,OK
77.738245,TraderOne,Tick,431,435,-4,4,147400,147600,7912,-24312,-23512,OK
78.011175,TraderOne,Tick,431,435,-4,4,147400,147600,7912,-24312,-23512,OK
78.24502,TraderOne,Tick,431,435,-4,4,147400,147600,7912,-24312,-23512,OK
78.509157,TraderOne,Tick,441,435,6,-6,147400,147600,8207,-25607,-26807,OK
78.72989,TraderOne,Tick,441,435,6,-6,147400,147600,8207,-25607,-26807,OK
78.98647,TraderOne,Tick,441,435,6,-6,147400,147600,8207,-25607,-26807,OK
79.260962,TraderOne,Tick,451,435,16,-16,147400,147600,8502,-23902,-27102,OK
79.509589,TraderOne,Tick,452,435,17,-17,147400,147600,8531,-23731,-27131,OK
79.815054,TraderOne,Tick,462,435,27,-27,147600,148600,8826,-21026,-26426,OK
80.035084,TraderOne,Tick,472,435,37,-37,147900,148400,9122,-16322,-23722,OK
80.291335,TraderOne,Tick,482,435,47,-47,147900,148400,9418,-13618,-23018,OK
80.477168,TraderOne,Tick,492,435,57,-57,147900,148400,9714,-9914,-21314,OK
80.733784,TraderOne,Tick,492,435,57,-57,147900,148400,9714,-9914,-21314,OK
81.013471,TraderOne,Tick,492,435,57,-57,147900,148400,9714,-9914,-21314,OK
81.30054,TraderOne,Tick,492,435,57,-57,147900,148200,9714,-9914,-21314,OK
81.507887,TraderOne,Tick,492,445,47,-47,148000,148400,9566,-18766,-28166,OK
81.752813,TraderOne,Tick,502,445,57,-57,148100,148400,9862,-15062,-26462,OK
81.991963,TraderOne,Tick,512,445,67,-67,148000,148400,9714,-9914,-23314,OK
82.269908,TraderOne,Tick,512,445,67,-67,148000,148400,9714,-9914,-23314,OK
82.522616,TraderOne,Tick,512,455,57,-57,148200,148800,9566,-16766,-28166,OK
82.744177,TraderOne,Tick,512,455,57,-57,148200,148800,9566,-16766,-28166,OK
82.954262,TraderOne,Tick,512,455,57,-57,148200,148800,9566,-16766,-28166,OK
83.233714,TraderOne,Tick,512,455,57,-57,148300,148800,9566,-16766,-28166,OK
83.492081,TraderOne,Tick,512,455,57,-57,148300,148800,9566,-16766,-28166,OK
83.778238,TraderOne,Tick,512,455,57,-57,148300,148800,9566,-16766,-28166,OK
84.029585,TraderOne,Tick,512,455,57,-57,148400,149000,9566,-16766,-28166,OK
84.294862,TraderOne,Tick,512,455,57,-57,148400,149000,9566,-16766,-28166,OK
84.513632,TraderOne,Tick,512,455,57,-57,148400,149000,9566,-16766,-28166,OK
84.709321,TraderOne,Tick,512,455,57,-57,148400,149200,9566,-16766,-28166,OK
84.96812,TraderOne,Tick,522,455,67,-67,148600,149200,9863,-11063,-24463,OK
85.22784,TraderOne,Tick,522,465,57,-57,148600,149200,10160,-17360,-28760,OK
85.544289,TraderOne,Tick,522,475,47,-47,148800,149200,10011,-22211,-31611,OK
85.777074,TraderOne,Tick,522,475,47,-47,148800,149200,10011,-22211,-31611,OK
86.022193,TraderOne,Tick,532,475,57,-57,148800,149600,10309,-17509,-28909,OK
86.266308,TraderOne,Tick,532,485,47,-47,149000,149600,10160,-24360,-33760,OK
86.493258,TraderOne,Tick,532,485,47,-47,149000,149600,10160,-24360,-33760,OK
86.794591,TraderOne,Tick,532,495,37,-37,149600,149600,10011,-27211,-27211,OK
86.976725,TraderOne,Tick,532,495,37,-37,149600,149600,10011,-27211,-27211,OK
87.225301,TraderOne,Tick,532,495,37,-37,149600,149600,10011,-27211,-27211,OK
87.530264,TraderOne,Tick,532,495,37,-37,149600,149700,10011,-27211,-30911,OK
87.759404,TraderOne,Tick,532,495,37,-37,149600,149500,10011,-27211,-23511,OK
88.016462,TraderOne,Tick,532,495,37,-37,149600,149500,10011,-27211,-23511,OK
88.205719,TraderOne,Tick,532,495,37,-37,149600,149500,10011,-27211,-23511,OK
88.471174,TraderOne,Tick,532,495,37,-37,149600,149500,10011,-27211,-23511,OK
88.707565,TraderOne,Tick,532,495,37,-37,149600,149200,10011,-27211,-19811,OK
89.04212,TraderOne,Tick,532,495,37,-37,149600,149100,10011,-27211,-19811,OK
89.284352,TraderOne,Tick,532,495,37,-37,149600,149100,10011,-27211,-19811,OK
89.475024,TraderOne,Tick,532,495,37,-37,149600,148900,10011,-27211,-19811,OK
89.750305,TraderOne,Tick,532,495,37,-37,149600,148900,10011,-27211,-19811,OK
90.040553,TraderOne,Tick,532,495,37,-37,149600,148900,10011,-27211,-19811,OK
90.248028,TraderOne,Tick,532,495,37,-37,149600,149100,10011,-27211,-19811,OK
90.511565,TraderOne,Tick,532,495,37,-37,149600,149100,10011,-27211,-19811,OK
90.746488,TraderOne,Tick,532,495,37,-37,149600,149100,10011,-27211,-19811,OK
91.051129,TraderOne,Tick,532,505,27,-27,148800,149100,9862,-30062,-35462,OK
91.281888,TraderOne,Tick,532,515,17,-17,149400,149100,10161,-27361,-23961,OK
91.492516,TraderOne,Tick,532,520,12,-12,149400,148900,10310,-25510,-23110,OK
91.782622,TraderOne,Tick,532,525,7,-7,149600,148900,10236,-26436,-25036,OK
92.011992,TraderOne,Tick,532,529,3,-3,149500,148900,10356,-24956,-24356,OK
92.252644,TraderOne,Tick,542,529,13,-13,148500,148900,10207,-24807,-27407,OK
92.465076,TraderOne,Tick,542,529,13,-13,148500,148900,10207,-24807,-27407,OK
92.741738,TraderOne,Tick,542,529,13,-13,148500,148900,10207,-24807,-27407,OK
93.029762,TraderOne,Tick,542,529,13,-13,148500,149200,10207,-24807,-27407,OK
93.223683,TraderOne,Tick,542,529,13,-13,148500,149200,10207,-24807,-27407,OK
93.511774,TraderOne,Tick,542,529,13,-13,148500,149200,10207,-24807,-27407,OK
93.794047,TraderOne,Tick,542,529,13,-13,148500,149200,10207,-24807,-27407,OK
94.013877,TraderOne,Tick,542,529,13,-13,148500,149200,10207,-24807,-27407,OK
94.25652,TraderOne,Tick,542,529,13,-13,148500,149200,10207,-24807,-27407,OK
94.454632,TraderOne,Tick,542,529,13,-13,148500,149200,10207,-24807,-27407,OK
94.74798,TraderOne,Tick,542,529,13,-13,148500,149200,10207,-24807,-27407,OK
94.973453,TraderOne,Tick,542,529,13,-13,148500,149200,10207,-24807,-27407,OK
95.2102,TraderOne,Tick,542,529,13,-13,148500,149200,10207,-24807,-27407,OK
95.453832,TraderOne,Tick,542,529,13,-13,148500,149200,10207,-24807,-27407,OK
95.714865,TraderOne,Tick,542,529,13,-13,148500,149200,10207,-24807,-27407,OK
96.032544,TraderOne,Tick,542,529,13,-13,148500,149200,10207,-24807,-27407,OK
96.223706,TraderOne,Tick,542,529,13,-13,148500,149200,10207,-24807,-27407,OK
96.513991,TraderOne,Tick,542,529,13,-13,148500,149200,10207,-24807,-27407,OK
96.766106,TraderOne,Tick,548,529,19,-19,149600,149200,10387,-24387,-20587,OK
97.048214,TraderOne,Tick,548,529,19,-19,149600,149200,10387,-24387,-20587,OK
97.225911,TraderOne,Tick,548,529,19,-19,149600,149200,10387,-24387,-20587,OK
97.501798,TraderOne,Tick,558,539,19,-19,149800,149600,10087,-24087,-20287,OK
97.79176,TraderOne,Tick,558,539,19,-19,149800,149900,10087,-24087,-25987,OK
97.953118,TraderOne,Tick,558,539,19,-19,149800,149800,10087,-24087,-24087,OK
98.290771,TraderOne,Tick,558,539,19,-19,149800,149800,10087,-24087,-24087,OK
98.482499,TraderOne,Tick,568,539,29,-29,149200,149800,9937,-22937,-31637,OK
98.786389,TraderOne,Tick,568,539,29,-29,149800,149800,9937,-22937,-22937,OK
99.004065,TraderOne,Tick,568,539,29,-29,149800,149900,9937,-22937,-25837,OK
99.253704,TraderOne,Tick,568,539,29,-29,149800,150100,9937,-22937,-31637,OK
99.512444,TraderOne,Tick,578,539,39,-39,149800,150000,10237,-21237,-29037,OK
99.787893,TraderOne,Tick,578,539,39,-39,149800,150000,10237,-21237,-29037,OK
100.023511,TraderOne,Tick,578,549,29,-29,149900,150000,10087,-24087,-26987,OK
100.29491,TraderOne,Tick,578,549,29,-29,149900,149900,10087,-24087,-24087,OK
100.477041,TraderOne,Tick,578,549,29,-29,149900,149900,10087,-24087,-24087,OK
100.772912,TraderOne,Tick,578,549,29,-29,149900,149900,10087,-24087,-24087,OK
100.993218,TraderOne,Tick,578,549,29,-29,149900,149900,10087,-24087,-24087,OK
101.206625,TraderOne,Tick,588,549,39,-39,149400,149900,9937,-21937,-33637,OK
101.521675,TraderOne,Tick,588,549,39,-39,149400,150100,9937,-21937,-33637,OK
101.792799,TraderOne,Tick,588,549,39,-39,149400,150100,9937,-21937,-33637,OK
101.952452,TraderOne,Tick,588,549,39,-39,149400,150100,9937,-21937,-33637,OK
102.231637,TraderOne,Tick,588,549,39,-39,149400,150100,9937,-21937,-33637,OK
102.5021,TraderOne,Tick,588,549,39,-39,149400,150300,9937,-21937,-33637,OK
102.729281,TraderOne,Tick,598,549,49,-49,149900,150300,10237,-19237,-33937,OK
102.967282,TraderOne,Tick,598,549,49,-49,149900,150300,10237,-19237,-33937,OK
103.28034,TraderOne,Tick,598,549,49,-49,149900,150300,10237,-19237,-33937,OK
103.493298,TraderOne,Tick,602,559,43,-53,149900,150300,10027,1481973,-33927,OK
103.756226,TraderOne,Tick,602,561,41,-41,150100,150300,10087,-22687,-30887,OK
103.999484,TraderOne,Tick,602,561,41,-41,150100,150400,10087,-22687,-34987,OK
104.237527,TraderOne,Tick,602,561,41,-41,150100,150200,10087,-22687,-26787,OK
104.517095,TraderOne,Tick,602,561,41,-41,150100,150200,10087,-22687,-26787,OK
104.796698,TraderOne,Tick,602,561,41,-41,150100,150200,10087,-22687,-26787,OK
105.050763,TraderOne,Tick,602,561,41,-41,150100,150200,10087,-22687,-26787,OK
105.227932,TraderOne,Tick,602,561,41,-41,150100,150200,10087,-22687,-26787,OK
105.507279,TraderOne,Tick,602,561,41,-41,150100,150200,10087,-22687,-26787,OK
105.795608,TraderOne,Tick,602,561,41,-41,150100,150200,10087,-22687,-26787,OK
105.971501,TraderOne,Tick,602,561,41,-41,150100,150300,10087,-22687,-30887,OK
106.255283,TraderOne,Tick,602,571,31,-31,150000,150500,9937,-28537,-37837,OK
106.545974,TraderOne,Tick,602,571,31,-31,150200,150500,9937,-28537,-37837,OK
106.781857,TraderOne,Tick,602,571,31,-31,150200,150400,9937,-28537,-34737,OK
107.013707,TraderOne,Tick,602,571,31,-31,150200,150300,9937,-28537,-31637,OK
107.245788,TraderOne,Tick,602,571,31,-31,150200,150300,9937,-28537,-31637,OK
107.482505,TraderOne,Tick,602,571,31,-31,150200,150400,9937,-28537,-34737,OK
107.761447,TraderOne,Tick,602,571,31,-31,150200,150400,9937,-28537,-34737,OK
108.034676,TraderOne,Tick,602,571,31,-31,150200,150400,9937,-28537,-34737,OK
108.239739,TraderOne,Tick,602,571,31,-31,150200,150300,9937,-28537,-31637,OK
108.55452,TraderOne,Tick,602,571,31,-31,150200,150100,9937,-28537,-25437,OK
108.798336,TraderOne,Tick,612,571,41,-41,149600,150100,9787,-26387,-38687,OK
108.992574,TraderOne,Tick,612,571,41,-41,149600,150100,9787,-26387,-38687,OK
109.233924,TraderOne,Tick,612,571,41,-41,149600,150100,9787,-26387,-38687,OK
109.458642,TraderOne,Tick,612,571,41,-41,149600,150100,9787,-26387,-38687,OK
109.763758,TraderOne,Tick,612,581,31,-31,149800,150100,9637,-30237,-39537,OK
110.029111,TraderOne,Tick,612,591,21,-21,150100,150500,9937,-30537,-36837,OK
110.215159,TraderOne,Tick,622,591,31,-31,150200,150500,10237,-28837,-38137,OK
110.507864,TraderOne,Tick,622,591,31,-31,150200,150500,10237,-28837,-38137,OK
110.704501,TraderOne,Tick,632,591,41,-41,150200,150700,10537,-26137,-38437,OK
111.013103,TraderOne,Tick,642,591,51,-51,150200,150600,10837,-22437,-37737,OK
111.241957,TraderOne,Tick,642,591,51,-51,150200,150600,10837,-22437,-37737,OK
111.46348,TraderOne,Tick,642,601,41,-41,150200,150600,11137,-27737,-40037,OK
111.748837,TraderOne,Tick,642,601,41,-41,150100,150600,11137,-27737,-40037,OK
112.043078,TraderOne,Tick,642,601,41,-41,150100,150600,11137,-27737,-40037,OK
112.298717,TraderOne,Tick,642,601,41,-41,150100,150500,11137,-27737,-40037,OK
112.474327,TraderOne,Tick,642,611,31,-31,150100,150400,11437,-32037,-41337,OK
112.771815,TraderOne,Tick,642,611,31,-31,150100,150500,11437,-32037,-41337,OK
113.00679,TraderOne,Tick,651,611,40,-40,150200,150700,11707,-27807,-39807,OK
113.238824,TraderOne,Tick,651,611,40,-40,150200,150600,11707,-27807,-39807,OK
113.51318,TraderOne,Tick,651,621,30,-30,150200,150500,12007,-32107,-41107,OK
113.75757,TraderOne,Tick,651,621,30,-30,150200,150500,12007,-32107,-41107,OK
113.995961,TraderOne,Tick,651,621,30,-30,150200,150500,12007,-32107,-41107,OK
114.217272,TraderOne,Tick,651,621,30,-30,150200,150600,12007,-32107,-41107,OK
114.498487,TraderOne,Tick,651,621,30,-30,150500,150500,12007,-32107,-32107,OK
114.797405,TraderOne,Tick,651,621,30,-30,150500,150500,12007,-32107,-32107,OK
114.9828,TraderOne,Tick,651,621,30,-30,150500,150900,12007,-32107,-41107,OK
115.201322,TraderOne,Tick,651,621,30,-30,150500,150500,12007,-32107,-32107,OK
115.451059,TraderOne,Tick,651,628,23,-23,150100,150500,12217,-34417,-41317,OK
115.764214,TraderOne,Tick,651,628,23,-23,150100,150500,12217,-34417,-41317,OK
115.977554,TraderOne,Tick,651,628,23,-23,150100,150400,12217,-34417,-41317,OK
116.226098,TraderOne,Tick,651,638,13,-13,150600,150500,12067,-36267,-34967,OK
116.488385,TraderOne,Tick,651,638,13,-13,150600,150800,12067,-36267,-38867,OK
116.703567,TraderOne,Tick,651,638,13,-13,150600,150800,12067,-36267,-38867,OK
116.973215,TraderOne,Tick,661,638,23,-23,150000,150500,11917,-36117,-43017,OK
117.280032,TraderOne,Tick,661,638,23,-23,150000,150300,11917,-36117,-43017,OK
117.529601,TraderOne,Tick,661,638,23,-23,150000,150300,11917,-36117,-43017,OK
117.769785,TraderOne,Tick,661,638,23,-23,150000,150300,11917,-36117,-43017,OK
118.040731,TraderOne,Tick,661,638,23,-23,150000,150300,11917,-36117,-43017,OK
118.267444,TraderOne,Tick,661,648,13,-13,150300,150500,11767,-37967,-40567,OK
118.493242,TraderOne,Tick,661,655,6,-6,150500,150500,11978,-38178,-38178,OK
118.778697,TraderOne,Tick,661,655,6,-6,150500,150300,11978,-38178,-36978,OK
118.989647,TraderOne,Tick,671,655,16,-16,150200,150300,11828,-37028,-38628,OK
119.218946,TraderOne,Tick,681,655,26,-26,150200,150300,12128,-36328,-38928,OK
119.517574,TraderOne,Tick,681,655,26,-26,150200,150200,12128,-36328,-36328,OK
119.77115,TraderOne,Tick,681,655,26,-26,150200,150100,12128,-36328,-33728,OK
120.073334,TraderOne,Tick,681,655,26,-26,150200,150600,12128,-36328,-44128,OK
120.205412,TraderOne,Tick,691,655,36,-36,150200,150600,12428,-32628,-43428,OK
120.549708,TraderOne,Tick,691,665,26,-26,150400,150600,12729,-35929,-41129,OK
120.79739,TraderOne,Tick,691,675,16,-16,150400,150600,13030,-38230,-41430,OK
121.046013,TraderOne,Tick,691,675,16,-16,150400,150600,13030,-38230,-41430,OK
121.262866,TraderOne,Tick,701,675,26,-26,150000,150600,12880,-37080,-44880,OK
121.538632,TraderOne,Tick,701,675,26,-26,150000,150600,12880,-37080,-44880,OK
121.775167,TraderOne,Tick,701,675,26,-26,150000,150600,12880,-37080,-44880,OK
121.97552,TraderOne,Tick,711,675,36,-36,150400,150600,13181,-37381,-44581,OK
122.24701,TraderOne,Tick,711,675,36,-36,150100,150600,13181,-37381,-48181,OK
122.522387,TraderOne,Tick,711,675,36,-36,150100,150500,13181,-37381,-48181,OK
122.757918,TraderOne,Tick,711,675,36,-36,150100,150500,13181,-37381,-48181,OK
122.95666,TraderOne,Tick,711,675,36,-36,150100,150500,13181,-37381,-48181,OK
123.270169,TraderOne,Tick,711,675,36,-36,150100,150400,13181,-37381,-48181,OK
123.485961,TraderOne,Tick,711,675,36,-36,150100,150400,13181,-37381,-48181,OK
123.715394,TraderOne,Tick,711,685,26,-26,150400,150400,13031,-40231,-40231,OK
123.977929,TraderOne,Tick,711,695,16,-16,150400,150400,12881,-42081,-42081,OK
124.272463,TraderOne,Tick,711,705,6,-6,150600,150400,13182,-43382,-42182,OK
124.49115,TraderOne,Tick,711,705,6,-6,150600,150400,13182,-43382,-42182,OK
124.763611,TraderOne,Tick,711,705,6,-6,150600,150400,13182,-43382,-42182,OK
125.023415,TraderOne,Tick,711,705,6,-6,150600,150400,13182,-43382,-42182,OK
125.289299,TraderOne,Tick,711,705,6,-6,150600,150400,13182,-43382,-42182,OK
125.481766,TraderOne,Tick,711,705,6,-6,150400,150400,13182,-43382,-43382,OK
125.70769,TraderOne,Tick,711,705,6,-6,150400,150400,13182,-43382,-43382,OK
125.991223,TraderOne,Tick,721,705,16,-16,150500,150700,13483,-43683,-46883,OK
126.27045,TraderOne,Tick,731,705,26,-26,150500,151100,13784,-42984,-50784,OK
126.462887,TraderOne,Tick,741,705,36,-36,150500,151200,14085,-38285,-49085,OK
126.732448,TraderOne,Tick,751,705,46,-46,150500,151000,14386,-33586,-47386,OK
127.040868,TraderOne,Tick,751,715,36,-36,150500,151000,14687,-37887,-48687,OK
127.279424,TraderOne,Tick,751,715,36,-36,150500,151000,14687,-37887,-48687,OK
127.545582,TraderOne,Tick,751,715,36,-36,150500,150700,14687,-37887,-45087,OK
127.774778,TraderOne,Tick,751,725,26,-26,150400,150400,14988,-40188,-40188,OK
128.01215,TraderOne,Tick,751,735,16,-16,150400,150300,15289,-40489,-38889,OK
128.226701,TraderOne,Tick,751,745,6,-6,150400,150300,15590,-40790,-40190,OK
128.546726,TraderOne,Tick,751,745,6,-6,150400,150200,15590,-40790,-39590,OK
128.774824,TraderOne,Tick,751,745,6,-6,150400,150200,15590,-40790,-39590,OK
128.957274,TraderOne,Tick,751,745,6,-6,150400,150200,15590,-40790,-39590,OK
129.29661,TraderOne,Tick,751,745,6,-6,150400,150200,15590,-40790,-39590,OK
129.491715,TraderOne,Tick,751,755,-4,4,150900,150400,15440,-41640,-42840,OK
129.777673,TraderOne,Tick,751,755,-4,4,150900,150400,15440,-41640,-42840,OK
130.009324,TraderOne,Tick,751,755,-4,4,150900,150400,15440,-41640,-42840,OK
130.273836,TraderOne,Tick,751,755,-4,4,150900,150400,15440,-41640,-42840,OK
130.467539,TraderOne,Tick,751,755,-4,4,150900,150400,15440,-41640,-42840,OK
130.702638,TraderOne,Tick,751,755,-4,4,150900,150400,15440,-41640,-42840,OK
130.990509,TraderOne,Tick,761,755,6,-6,149800,150400,15290,-43490,-45290,OK
131.298044,TraderOne,Tick,761,755,6,-6,149800,150100,15290,-43490,-45290,OK
131.534355,TraderOne,Tick,761,755,6,-6,149800,150100,15290,-43490,-45290,OK
131.788622,TraderOne,Tick,761,755,6,-6,149800,150100,15290,-43490,-45290,OK
131.998577,TraderOne,Tick,761,765,-4,4,150800,150100,15140,-43340,-44540,OK
132.215816,TraderOne,Tick,761,765,-4,4,150800,149800,15140,-43340,-44540,OK
132.513609,TraderOne,Tick,761,765,-4,4,150800,149800,15140,-43340,-44540,OK
132.741566,TraderOne,Tick,761,775,-14,14,149800,149600,15440,-41640,-44440,OK
132.990936,TraderOne,Tick,761,785,-24,24,149800,149600,15740,-39940,-44740,OK
133.220382,TraderOne,Tick,761,795,-34,34,150200,149600,15590,-37790,-44590,OK
133.484762,TraderOne,Tick,761,795,-34,34,150200,149600,15590,-37790,-44590,OK
133.717672,TraderOne,Tick,771,795,-24,24,149600,149500,15440,-41640,-44040,OK
134.00984,TraderOne,Tick,771,795,-24,24,149600,149600,15440,-41640,-41640,OK
134.277173,TraderOne,Tick,771,795,-24,24,149600,149600,15440,-41640,-41640,OK
134.507187,TraderOne,Tick,771,795,-24,24,149600,149700,15440,-41640,-39240,OK
134.743304,TraderOne,Tick,771,795,-24,24,149600,149700,15440,-41640,-39240,OK
134.989586,TraderOne,Tick,771,795,-24,24,149600,149800,15440,-41640,-36840,OK
135.290127,TraderOne,Tick,781,797,-16,14,150200,149800,15260,254940,-49460,OK
135.49245,TraderOne,Tick,791,797,-6,6,149900,149900,15110,-45710,-45710,OK
135.74868,TraderOne,Tick,791,797,-6,6,149300,149900,15110,-45710,-43910,OK
136.006062,TraderOne,Tick,791,797,-6,6,149300,149900,15110,-45710,-43910,OK
136.237091,TraderOne,Tick,791,797,-6,6,149300,149900,15110,-45710,-43910,OK
136.462752,TraderOne,Tick,791,797,-6,6,149300,149900,15110,-45710,-43910,OK
136.711905,TraderOne,Tick,791,797,-6,6,149300,149800,15110,-45710,-43910,OK
137.045661,TraderOne,Tick,791,797,-6,6,149300,149600,15110,-45710,-44510,OK
137.228013,TraderOne,Tick,791,797,-6,6,149300,149600,15110,-45710,-44510,OK
137.529501,TraderOne,Tick,791,797,-6,6,149300,149600,15110,-45710,-44510,OK
137.709255,TraderOne,Tick,791,797,-6,6,149300,149300,15110,-45710,-45710,OK
138.008415,TraderOne,Tick,791,797,-6,6,149300,149300,15110,-45710,-45710,OK
138.277949,TraderOne,Tick,791,797,-6,6,149300,149300,15110,-45710,-45710,OK
138.541086,TraderOne,Tick,791,797,-6,6,149300,149300,15110,-45710,-45710,OK
138.747701,TraderOne,Tick,791,797,-6,6,149300,149100,15110,-45710,-46910,OK
139.01037,TraderOne,Tick,791,797,-6,6,149300,149100,15110,-45710,-46910,OK
139.219305,TraderOne,Tick,791,797,-6,6,149300,149100,15110,-45710,-46910,OK
139.488766,TraderOne,Tick,791,797,-6,6,149300,149300,15110,-45710,-45710,OK
139.750622,TraderOne,Tick,791,797,-6,6,149300,149300,15110,-45710,-45710,OK
139.966763,TraderOne,Tick,791,797,-6,6,149300,149300,15110,-45710,-45710,OK
140.240555,TraderOne,Tick,801,797,4,-4,149600,149300,15409,-47009,-46209,OK
140.479371,TraderOne,Tick,801,807,-6,6,149800,149300,15259,-46859,-48059,OK
140.793901,TraderOne,Tick,801,814,-13,13,149900,149300,15469,-46369,-48969,OK
141.04374,TraderOne,Tick,801,814,-13,13,149900,149300,15469,-46369,-48969,OK
141.220836,TraderOne,Tick,801,814,-13,13,149900,149300,15469,-46369,-48969,OK
141.535452,TraderOne,Tick,801,824,-23,23,150200,149300,15319,-44219,-48819,OK
141.742797,TraderOne,Tick,801,824,-23,23,150200,149500,15319,-44219,-48819,OK
142.011707,TraderOne,Tick,801,824,-23,23,150200,149500,15319,-44219,-48819,OK
142.241398,TraderOne,Tick,801,824,-23,23,150200,149500,15319,-44219,-48819,OK
142.486578,TraderOne,Tick,801,824,-23,23,150200,149500,15319,-44219,-48819,OK
142.744951,TraderOne,Tick,801,834,-33,33,150200,149500,15169,-41069,-47669,OK
142.968118,TraderOne,Tick,801,834,-33,33,150200,149500,15169,-41069,-47669,OK
143.26594,TraderOne,Tick,801,834,-33,33,150200,149500,15169,-41069,-47669,OK
143.520591,TraderOne,Tick,801,834,-33,33,150200,149700,15169,-41069,-47669,OK
143.786005,TraderOne,Tick,811,834,-23,33,149200,149700,15019,-1541919,-40319,OK
143.981271,TraderOne,Tick,811,834,-23,23,149200,149700,15019,-45919,-41319,OK
144.26054,TraderOne,Tick,811,834,-23,23,149200,149700,15019,-45919,-41319,OK
144.521624,TraderOne,Tick,821,834,-13,13,149100,149700,14869,-48769,-46169,OK
144.76511,TraderOne,Tick,821,834,-13,13,149100,149700,14869,-48769,-46169,OK
145.043446,TraderOne,Tick,821,834,-13,13,149100,149700,14869,-48769,-46169,OK
145.262033,TraderOne,Tick,821,834,-13,13,149100,149700,14869,-48769,-46169,OK
145.538577,TraderOne,Tick,821,834,-13,13,149100,149700,14869,-48769,-46169,OK
145.714425,TraderOne,Tick,821,834,-13,13,149100,149700,14869,-48769,-46169,OK
145.993175,TraderOne,Tick,821,834,-13,13,149100,149700,14869,-48769,-46169,OK
146.244964,TraderOne,Tick,821,834,-13,13,149100,149500,14869,-48769,-46169,OK
146.497412,TraderOne,Tick,821,834,-13,13,149100,149500,14869,-48769,-46169,OK
146.737434,TraderOne,Tick,821,834,-13,13,149100,149700,14869,-48769,-46169,OK
147.00063,TraderOne,Tick,821,834,-13,13,149100,149700,14869,-48769,-46169,OK
147.237337,TraderOne,Tick,821,834,-13,13,149100,149700,14869,-48769,-46169,OK
147.529974,TraderOne,Tick,821,834,-13,13,149100,149600,14869,-48769,-46169,OK
147.787234,TraderOne,Tick,821,834,-13,13,149100,149600,14869,-48769,-46169,OK
147.996094,TraderOne,Tick,821,834,-13,13,149100,149600,14869,-48769,-46169,OK
148.214153,TraderOne,Tick,821,834,-13,13,149100,149600,14869,-48769,-46169,OK
148.548762,TraderOne,Tick,821,834,-13,13,149100,149600,14869,-48769,-46169,OK
148.793266,TraderOne,Tick,821,834,-13,13,149100,149600,14869,-48769,-46169,OK
148.995513,TraderOne,Tick,821,834,-13,13,149100,149600,14869,-48769,-46169,OK
149.273351,TraderOne,Tick,821,834,-13,13,149100,149600,14869,-48769,-46169,OK
149.506729,TraderOne,Tick,821,844,-23,23,150600,150100,14719,-44619,-51519,OK
149.716714,TraderOne,Tick,821,844,-23,23,150600,150100,14719,-44619,-51519,OK
149.969214,TraderOne,Tick,821,844,-23,23,150600,150100,14719,-44619,-51519,OK
150.245046,TraderOne,Tick,821,844,-23,23,150600,150100,14719,-44619,-51519,OK
150.459481,TraderOne,Tick,821,844,-23,23,150600,150100,14719,-44619,-51519,OK
150.753835,TraderOne,Tick,821,844,-23,23,150600,150100,14719,-44619,-51519,OK
151.050119,TraderOne,Tick,821,844,-23,23,150600,150100,14719,-44619,-51519,OK
151.263819,TraderOne,Tick,821,844,-23,23,150600,150100,14719,-44619,-51519,OK
151.540792,TraderOne,Tick,821,844,-23,23,150600,150100,14719,-44619,-51519,OK
151.757327,TraderOne,Tick,821,844,-23,23,150600,150100,14719,-44619,-51519,OK
151.976882,TraderOne,Tick,821,844,-23,23,150600,150100,14719,-44619,-51519,OK
152.269964,TraderOne,Tick,821,844,-23,23,150600,150100,14719,-44619,-51519,OK
152.462995,TraderOne,Tick,821,844,-23,23,150600,150100,14719,-44619,-51519,OK
152.766536,TraderOne,Tick,821,844,-23,23,150600,150100,14719,-44619,-51519,OK
153.044141,TraderOne,Tick,821,854,-33,33,150400,150100,14569,-41469,-51369,OK
153.291694,TraderOne,Tick,821,854,-33,33,150400,149800,14569,-41469,-51369,OK
153.491504,TraderOne,Tick,821,854,-33,33,150400,149800,14569,-41469,-51369,OK
153.704088,TraderOne,Tick,821,854,-33,33,150400,149800,14569,-41469,-51369,OK
154.028101,TraderOne,Tick,821,854,-33,33,150400,150100,14569,-41469,-51369,OK
154.215119,TraderOne,Tick,821,854,-33,33,150400,150100,14569,-41469,-51369,OK
154.478359,TraderOne,Tick,821,854,-33,33,150400,150100,14569,-41469,-51369,OK
154.711258,TraderOne,Tick,821,854,-33,33,150400,150100,14569,-41469,-51369,OK
155.001296,TraderOne,Tick,831,854,-23,23,150600,150100,14870,-44770,-51670,OK
155.278099,TraderOne,Tick,841,854,-13,13,150600,150100,15171,-48071,-51971,OK
155.481505,TraderOne,Tick,841,854,-13,13,150600,150300,15171,-48071,-51971,OK
155.723774,TraderOne,Tick,841,854,-13,13,150600,150300,15171,-48071,-51971,OK
156.036431,TraderOne,Tick,841,854,-13,13,150600,150300,15171,-48071,-51971,OK
156.223636,TraderOne,Tick,841,854,-13,13,150600,150300,15171,-48071,-51971,OK
156.46329,TraderOne,Tick,841,854,-13,13,150600,150300,15171,-48071,-51971,OK
156.780362,TraderOne,Tick,841,854,-13,13,150600,150300,15171,-48071,-51971,OK
157.004459,TraderOne,Tick,841,854,-13,13,150600,150300,15171,-48071,-51971,OK
157.23103,TraderOne,Tick,841,854,-13,13,150600,150300,15171,-48071,-51971,OK
157.481996,TraderOne,Tick,841,854,-13,13,150600,150300,15171,-48071,-51971,OK
157.755772,TraderOne,Tick,841,854,-13,13,150600,150300,15171,-48071,-51971,OK
158.042317,TraderOne,Tick,841,854,-13,13,150600,150300,15171,-48071,-51971,OK
158.207421,TraderOne,Tick,841,854,-13,13,150600,150300,15171,-48071,-51971,OK
158.493567,TraderOne,Tick,841,854,-13,13,150500,150300,15171,-48071,-50671,OK
158.769636,TraderOne,Tick,841,854,-13,13,150500,150300,15171,-48071,-50671,OK
159.049669,TraderOne,Tick,851,854,-3,3,150600,150400,15472,-50372,-50972,OK
159.241387,TraderOne,Tick,851,864,-13,13,150500,150400,15773,-49673,-50973,OK
159.497331,TraderOne,Tick,851,864,-13,13,150500,150400,15773,-49673,-50973,OK
159.751246,TraderOne,Tick,860,864,-4,4,150600,150400,16044,-51744,-52544,OK
159.974312,TraderOne,Tick,860,864,-4,4,150600,150400,16044,-51744,-52544,OK
160.209284,TraderOne,Tick,860,866,-6,6,150700,150400,16014,-51314,-53114,OK
160.454157,TraderOne,Tick,860,872,-12,12,150600,150400,15924,-50024,-52424,OK
160.772546,TraderOne,Tick,860,872,-12,12,150600,150200,15924,-50024,-53624,OK
161.008986,TraderOne,Tick,860,880,-20,20,150500,150200,16165,-47865,-53865,OK
161.285394,TraderOne,Tick,860,880,-20,20,150500,150200,16165,-47865,-53865,OK
161.536954,TraderOne,Tick,860,880,-20,20,150500,150200,16165,-47865,-53865,OK
161.805548,TraderOne,Tick,860,880,-20,20,150500,150200,16165,-47865,-53865,OK
161.972382,TraderOne,Tick,860,880,-20,20,150500,150200,16165,-47865,-53865,OK
162.280752,TraderOne,Tick,860,880,-20,20,150800,150800,16165,-47865,-47865,OK
162.48345,TraderOne,Tick,864,880,-16,16,150900,150800,16286,-48786,-50386,OK
162.735421,TraderOne,Tick,864,880,-16,16,150900,150800,16286,-48786,-50386,OK
163.036288,TraderOne,Tick,864,880,-16,16,150900,150700,16286,-48786,-51986,OK
163.264483,TraderOne,Tick,874,880,-6,6,150800,150800,16135,-49635,-49635,OK
163.45223,TraderOne,Tick,875,880,-5,5,150700,150800,16165,-49665,-49165,OK
163.768142,TraderOne,Tick,875,880,-5,5,150700,150800,16165,-49665,-49165,OK
164.020203,TraderOne,Tick,875,880,-5,5,150700,150800,16165,-49665,-49165,OK
164.285312,TraderOne,Tick,885,880,5,-5,151000,151000,16467,-51967,-51967,OK
164.544884,TraderOne,Tick,885,880,5,-5,151000,150900,16467,-51967,-51467,OK
164.793098,TraderOne,Tick,885,880,5,-5,151000,150900,16467,-51967,-51467,OK
164.993177,TraderOne,Tick,885,880,5,-5,151000,151000,16467,-51967,-51967,OK
165.213488,TraderOne,Tick,885,880,5,-5,151000,151000,16467,-51967,-51967,OK
165.535585,TraderOne,Tick,885,890,-5,5,151400,151000,16316,-50816,-52316,OK
165.704065,TraderOne,Tick,885,890,-5,5,151400,151000,16316,-50816,-52316,OK
166.036535,TraderOne,Tick,885,890,-5,5,151400,151000,16316,-50816,-52316,OK
166.265512,TraderOne,Tick,885,895,-10,10,151300,151100,16240,-49740,-51740,OK
166.453645,TraderOne,Tick,885,895,-10,10,151300,151100,16240,-49740,-51740,OK
166.781193,TraderOne,Tick,885,895,-10,10,151300,151100,16240,-49740,-51740,OK
167.006785,TraderOne,Tick,885,895,-10,10,151300,151100,16240,-49740,-51740,OK
167.296311,TraderOne,Tick,885,895,-10,10,151300,151100,16240,-49740,-51740,OK
167.490272,TraderOne,Tick,885,895,-10,10,151300,151100,16240,-49740,-51740,OK
167.717185,TraderOne,Tick,885,895,-10,10,151400,151100,16240,-49740,-52740,OK
167.972915,TraderOne,Tick,885,895,-10,10,151500,151100,16240,-49740,-52740,OK
168.222195,TraderOne,Tick,885,895,-10,10,151500,151100,16240,-49740,-52740,OK
168.511029,TraderOne,Tick,885,895,-10,10,151500,151100,16240,-49740,-52740,OK
168.721712,TraderOne,Tick,885,895,-10,10,151500,151100,16240,-49740,-52740,OK
169.039307,TraderOne,Tick,885,895,-10,10,151500,151100,16240,-49740,-52740,OK
169.292212,TraderOne,Tick,885,905,-20,20,151100,150500,16089,-48589,-54589,OK
169.547489,TraderOne,Tick,885,905,-20,20,151100,150500,16089,-48589,-54589,OK
169.778916,TraderOne,Tick,885,905,-20,20,151100,150800,16089,-48589,-54589,OK
169.960669,TraderOne,Tick,885,905,-20,20,151100,150700,16089,-48589,-54589,OK
170.260048,TraderOne,Tick,885,905,-20,20,151100,150700,16089,-48589,-54589,OK
170.481395,TraderOne,Tick,885,905,-20,20,151100,150700,16089,-48589,-54589,OK
170.79558,TraderOne,Tick,885,905,-20,20,151100,150500,16089,-48589,-54589,OK
171.026894,TraderOne,Tick,885,905,-20,20,151100,150500,16089,-48589,-54589,OK
171.259826,TraderOne,Tick,885,905,-20,20,151100,150500,16089,-48589,-54589,OK
171.514918,TraderOne,Tick,889,905,-16,16,150600,150500,16029,-48929,-50529,OK
171.720509,TraderOne,Tick,889,905,-16,16,150600,150500,16029,-48929,-50529,OK
172.041161,TraderOne,Tick,899,915,-16,16,151200,150500,15727,-48627,-53427,OK
172.2247,TraderOne,Tick,899,915,-16,16,151200,150500,15727,-48627,-53427,OK
172.473796,TraderOne,Tick,899,915,-16,16,151200,150500,15727,-48627,-53427,OK
172.781678,TraderOne,Tick,899,925,-26,26,151000,150500,15576,-46476,-54276,OK
173.029563,TraderOne,Tick,899,925,-26,26,151000,150500,15576,-46476,-54276,OK
173.201967,TraderOne,Tick,899,925,-26,26,151000,150500,15576,-46476,-54276,OK
173.535758,TraderOne,Tick,899,925,-26,26,151000,150500,15576,-46476,-54276,OK
173.796258,TraderOne,Tick,899,925,-26,26,151000,150500,15576,-46476,-54276,OK
174.043023,TraderOne,Tick,899,925,-26,26,151000,150500,15576,-46476,-54276,OK
174.26882,TraderOne,Tick,899,925,-26,26,151000,150500,15576,-46476,-54276,OK
174.539616,TraderOne,Tick,899,925,-26,26,151000,150500,15576,-46476,-54276,OK
174.752975,TraderOne,Tick,899,925,-26,26,151000,150600,15576,-46476,-54276,OK
174.989536,TraderOne,Tick,909,925,-16,16,150800,150600,15878,-48778,-51978,OK
175.28227,TraderOne,Tick,919,925,-6,6,150800,150600,16180,-51080,-52280,OK
175.484621,TraderOne,Tick,919,925,-6,6,150800,150600,16180,-51080,-52280,OK
175.724192,TraderOne,Tick,919,925,-6,6,150800,150600,16180,-51080,-52280,OK
175.960296,TraderOne,Tick,919,925,-6,6,150800,150600,16180,-51080,-52280,OK
176.243422,TraderOne,Tick,919,925,-6,6,150800,150600,16180,-51080,-52280,OK
176.488826,TraderOne,Tick,929,925,4,-4,150700,150600,16029,-51929,-51529,OK
176.782701,TraderOne,Tick,929,925,4,-4,150700,150600,16029,-51929,-51529,OK
177.035345,TraderOne,Tick,929,925,4,-4,150700,150600,16029,-51929,-51529,OK
177.202407,TraderOne,Tick,929,925,4,-4,150700,150600,16029,-51929,-51529,OK
177.529021,TraderOne,Tick,929,935,-6,6,151200,150600,15878,-51778,-53578,OK
177.732038,TraderOne,Tick,929,935,-6,6,151200,150300,15878,-51778,-53578,OK
177.95462,TraderOne,Tick,929,935,-6,6,151200,150300,15878,-51778,-53578,OK
178.217833,TraderOne,Tick,929,935,-6,6,151200,150300,15878,-51778,-53578,OK
178.472605,TraderOne,Tick,929,935,-6,6,151200,150200,15878,-51778,-53578,OK
178.783436,TraderOne,Tick,929,945,-16,16,150400,150200,16179,-50079,-53279,OK
179.051338,TraderOne,Tick,929,955,-26,26,150400,150200,16480,-48380,-53580,OK
179.244622,TraderOne,Tick,929,955,-26,26,150400,150200,16480,-48380,-53580,OK
179.484657,TraderOne,Tick,929,955,-26,26,150400,149900,16480,-48380,-56180,OK
179.793002,TraderOne,Tick,929,955,-26,26,150400,149900,16480,-48380,-56180,OK
180.015035,TraderOne,Tick,929,955,-26,26,150100,149900,16480,-48380,-53580,OK
180.206631,TraderOne,Tick,938,965,-27,27,150100,149800,16195,-48695,-56795,OK
180.511377,TraderOne,Tick,938,965,-27,27,150100,149800,16195,-48695,-56795,OK
180.714952,TraderOne,Tick,938,965,-27,27,150100,149900,16195,-48695,-54095,OK
181.040034,TraderOne,Tick,938,965,-27,27,150100,149900,16195,-48695,-54095,OK
181.235989,TraderOne,Tick,938,965,-27,27,150100,150000,16195,-48695,-51395,OK
181.479549,TraderOne,Tick,948,965,-17,17,149700,149900,16045,-52545,-49145,OK
181.796802,TraderOne,Tick,948,965,-17,17,149700,149900,16045,-52545,-49145,OK
181.994074,TraderOne,Tick,948,975,-27,27,150100,149900,16345,-52845,-58245,OK
182.203336,TraderOne,Tick,948,975,-27,27,150100,149900,16345,-52845,-58245,OK
182.541254,TraderOne,Tick,948,975,-27,27,150100,149900,16345,-52845,-58245,OK
182.786303,TraderOne,Tick,948,975,-27,27,150100,149900,16345,-52845,-58245,OK
183.033307,TraderOne,Tick,948,975,-27,27,150100,149900,16345,-52845,-58245,OK
183.258887,TraderOne,Tick,948,975,-27,27,150100,149900,16345,-52845,-58245,OK
183.475158,TraderOne,Tick,948,975,-27,27,150100,150000,16345,-52845,-55545,OK
183.768566,TraderOne,Tick,958,975,-17,17,149700,150000,16195,-55695,-50595,OK
183.997562,TraderOne,Tick,958,975,-17,17,149700,150000,16195,-55695,-50595,OK
184.243373,TraderOne,Tick,958,975,-17,17,149700,149700,16195,-55695,-55695,OK
184.493388,TraderOne,Tick,968,975,-7,17,149700,149700,16045,-1554545,-57545,OK
184.768998,TraderOne,Tick,978,975,3,-3,149700,149700,16344,-55844,-55844,OK
185.0302,TraderOne,Tick,988,975,13,-13,149700,150000,16643,-55143,-59043,OK
185.281012,TraderOne,Tick,988,975,13,-13,149700,150000,16643,-55143,-59043,OK
185.527893,TraderOne,Tick,998,975,23,-23,149700,150000,16942,-54442,-61342,OK
185.706473,TraderOne,Tick,998,975,23,-23,149700,150000,16942,-54442,-61342,OK
186.017695,TraderOne,Tick,998,975,23,-23,149700,150000,16942,-54442,-61342,OK
186.243512,TraderOne,Tick,998,975,23,-23,149600,149800,16942,-54442,-59042,OK
186.545286,TraderOne,Tick,998,985,13,-13,149600,149800,17241,-57741,-60341,OK
186.797292,TraderOne,Tick,998,985,13,-13,149600,149800,17241,-57741,-60341,OK
186.985142,TraderOne,Tick,1008,985,23,-23,149700,149800,17540,-57040,-59340,OK
187.271789,TraderOne,Tick,1008,985,23,-23,149700,149800,17540,-57040,-59340,OK
187.457782,TraderOne,Tick,1008,985,23,-23,149700,149800,17540,-57040,-59340,OK
187.784094,TraderOne,Tick,1008,985,23,-23,149700,150000,17540,-57040,-63940,OK
188.034801,TraderOne,Tick,1018,985,33,-33,149700,150000,17839,-54339,-64239,OK
188.261911,TraderOne,Tick,1028,985,43,-43,149700,150100,18138,-51638,-64538,OK
188.461927,TraderOne,Tick,1028,985,43,-43,149700,150100,18138,-51638,-64538,OK
188.745163,TraderOne,Tick,1028,985,43,-43,149700,150100,18138,-51638,-64538,OK
188.98882,TraderOne,Tick,1028,985,43,-43,149700,150200,18138,-51638,-64538,OK
189.251227,TraderOne,Tick,1028,985,43,-43,149700,150200,18138,-51638,-64538,OK
189.454072,TraderOne,Tick,1028,985,43,-43,149700,150200,18138,-51638,-64538,OK
189.763878,TraderOne,Tick,1038,985,53,-53,150000,150200,17988,-48488,-59088,OK
190.005184,TraderOne,Tick,1038,985,53,-53,150000,150200,17988,-48488,-59088,OK
190.237904,TraderOne,Tick,1038,985,53,-53,150000,150300,17988,-48488,-64388,OK
190.550927,TraderOne,Tick,1038,985,53,-53,150000,150300,17988,-48488,-64388,OK
190.742474,TraderOne,Tick,1038,985,53,-53,150000,150300,17988,-48488,-64388,OK
191.041713,TraderOne,Tick,1038,985,53,-53,149500,150300,17988,-48488,-64388,OK
191.209003,TraderOne,Tick,1038,985,53,-53,149500,150400,17988,-48488,-64388,OK
191.495195,TraderOne,Tick,1048,985,63,-63,150000,150700,18288,-42788,-61688,OK
191.735935,TraderOne,Tick,1048,985,63,-63,150000,150800,18288,-42788,-61688,OK
191.999131,TraderOne,Tick,1048,995,53,-53,150200,150800,18588,-49088,-64988,OK
192.248831,TraderOne,Tick,1048,995,53,-53,150200,150700,18588,-49088,-64988,OK
192.490892,TraderOne,Tick,1048,995,53,-53,150200,150700,18588,-49088,-64988,OK
192.752123,TraderOne,Tick,1048,995,53,-53,150300,150700,18588,-49088,-64988,OK
192.968022,TraderOne,Tick,1048,995,53,-53,150300,150500,18588,-49088,-59688,OK
193.268272,TraderOne,Tick,1048,1005,43,-43,150200,150500,18888,-54388,-67288,OK
193.533866,TraderOne,Tick,1048,1005,43,-43,150200,150500,18888,-54388,-67288,OK
193.7992,TraderOne,Tick,1048,1005,43,-43,150200,150500,18888,-54388,-67288,OK
194.007377,TraderOne,Tick,1048,1015,33,-33,150100,150500,18738,-62238,-72138,OK
194.271008,TraderOne,Tick,1048,1015,33,-33,150100,150500,18738,-62238,-72138,OK
194.49005,TraderOne,Tick,1048,1015,33,-33,150100,150500,18738,-62238,-72138,OK
194.787837,TraderOne,Tick,1048,1015,33,-33,150100,150500,18738,-62238,-72138,OK
195.007202,TraderOne,Tick,1048,1015,33,-33,150100,150600,18738,-62238,-72138,OK
195.23662,TraderOne,Tick,1048,1015,33,-33,150100,150600,18738,-62238,-72138,OK
195.522538,TraderOne,Tick,1048,1015,33,-33,150100,150600,18738,-62238,-72138,OK
195.790069,TraderOne,Tick,1048,1015,33,-33,150100,150600,18738,-62238,-72138,OK
196.021462,TraderOne,Tick,1048,1015,33,-33,150100,150600,18738,-62238,-72138,OK
196.243507,TraderOne,Tick,1048,1015,33,-33,150100,150600,18738,-62238,-72138,OK
196.542914,TraderOne,Tick,1058,1015,43,-43,149800,150600,18588,-60088,-72988,OK
196.765301,TraderOne,Tick,1058,1015,43,-43,149800,150100,18588,-60088,-72988,OK
197.049634,TraderOne,Tick,1058,1015,43,-43,149800,150000,18588,-60088,-68688,OK
197.280945,TraderOne,Tick,1058,1015,43,-43,149800,150000,18588,-60088,-68688,OK
197.476775,TraderOne,Tick,1058,1025,33,-33,149500,150000,18887,-64387,-74287,OK
197.786177,TraderOne,Tick,1058,1025,33,-33,149500,149800,18887,-64387,-74287,OK
197.959128,TraderOne,Tick,1058,1025,33,-33,149500,149600,18887,-64387,-67687,OK
198.263347,TraderOne,Tick,1058,1035,23,-23,149500,149700,19186,-67686,-72286,OK
198.506168,TraderOne,Tick,1058,1045,13,-13,149500,149500,19485,-69985,-69985,OK
198.709165,TraderOne,Tick,1058,1045,13,-13,149500,149500,19485,-69985,-69985,OK
199.002745,TraderOne,Tick,1058,1055,3,-3,149500,149500,19784,-71284,-71284,OK
199.248979,TraderOne,Tick,1058,1055,3,-3,149500,149500,19784,-71284,-71284,OK
199.513978,TraderOne,Tick,1058,1055,3,-3,149500,149500,19784,-71284,-71284,OK
199.731596,TraderOne,Tick,1058,1055,3,-3,149500,149500,19784,-71284,-71284,OK
199.986326,TraderOne,Tick,1058,1055,3,-3,149500,149500,19784,-71284,-71284,OK
200.225568,TraderOne,Tick,1058,1055,3,-3,149500,149600,19784,-71284,-71584,OK
200.456141,TraderOne,Tick,1058,1059,-1,1,149700,149600,19724,-71224,-71324,OK
200.762496,TraderOne,Tick,1058,1059,-1,1,149700,149600,19724,-71224,-71324,OK
200.978478,TraderOne,Tick,1058,1059,-1,1,149700,149600,19724,-71224,-71324,OK
201.228388,TraderOne,Tick,1058,1060,-2,2,149900,149600,19709,-71109,-71509,OK
201.462464,TraderOne,Tick,1058,1060,-2,2,149900,149800,19709,-71109,-71309,OK
201.778937,TraderOne,Tick,1068,1060,8,-8,149300,150000,19559,-69959,-72359,OK
201.972767,TraderOne,Tick,1068,1060,8,-8,149300,150000,19559,-69959,-72359,OK
202.279866,TraderOne,Tick,1068,1060,8,-8,149300,150200,19559,-69959,-72359,OK
202.490638,TraderOne,Tick,1068,1060,8,-8,149300,150200,19559,-69959,-72359,OK
202.73061,TraderOne,Tick,1078,1060,18,-18,150500,150600,19860,-70260,-72060,OK
202.957616,TraderOne,Tick,1088,1060,28,-28,150500,150600,20161,-69561,-72361,OK
203.289907,TraderOne,Tick,1088,1060,28,-28,150500,150600,20161,-69561,-72361,OK
203.533695,TraderOne,Tick,1088,1060,28,-28,150500,150600,20161,-69561,-72361,OK
203.72056,TraderOne,Tick,1088,1060,28,-28,150500,150600,20161,-69561,-72361,OK
203.985376,TraderOne,Tick,1088,1060,28,-28,150500,150600,20161,-69561,-72361,OK
204.224969,TraderOne,Tick,1098,1060,38,-38,150200,150600,20011,-67411,-78811,OK
204.545863,TraderOne,Tick,1098,1060,38,-38,150200,150600,20011,-67411,-78811,OK
204.776986,TraderOne,Tick,1098,1060,38,-38,150200,150600,20011,-67411,-78811,OK
205.051881,TraderOne,Tick,1107,1060,47,-47,149900,150100,19876,-66376,-75776,OK
205.245078,TraderOne,Tick,1107,1070,37,-37,149700,149700,20175,-66675,-66675,OK
205.511282,TraderOne,Tick,1107,1080,27,-27,150400,149700,20025,-69525,-64125,OK
205.737394,TraderOne,Tick,1107,1080,27,-27,150400,149700,20025,-69525,-64125,OK
206.044708,TraderOne,Tick,1107,1090,17,-17,150300,149800,19875,-72375,-67275,OK
206.287457,TraderOne,Tick,1107,1090,17,-17,150300,149800,19875,-72375,-67275,OK
206.523356,TraderOne,Tick,1107,1090,17,-17,150300,149800,19875,-72375,-67275,OK
206.736568,TraderOne,Tick,1107,1090,17,-17,150300,149800,19875,-72375,-67275,OK
207.02468,TraderOne,Tick,1107,1090,17,-17,150300,149800,19875,-72375,-67275,OK
207.29532,TraderOne,Tick,1107,1090,17,-17,150300,149800,19875,-72375,-67275,OK
207.486336,TraderOne,Tick,1107,1090,17,-17,150300,149800,19875,-72375,-67275,OK
207.727158,TraderOne,Tick,1107,1090,17,-17,150300,149800,19875,-72375,-67275,OK
207.983876,TraderOne,Tick,1107,1090,17,-17,150300,149800,19875,-72375,-67275,OK
208.213168,TraderOne,Tick,1117,1100,17,-17,149200,149800,20024,-72524,-77624,OK
208.514155,TraderOne,Tick,1117,1110,7,-7,149800,149800,19874,-73374,-73374,OK
208.736276,TraderOne,Tick,1117,1110,7,-7,149800,149800,19874,-73374,-73374,OK
208.999891,TraderOne,Tick,1117,1110,7,-7,149800,149800,19874,-73374,-73374,OK
209.280929,TraderOne,Tick,1117,1110,7,-7,149800,149800,19874,-73374,-73374,OK
209.48057,TraderOne,Tick,1117,1110,7,-7,149800,149800,19874,-73374,-73374,OK
209.728817,TraderOne,Tick,1117,1120,-3,3,150300,149800,19724,-73224,-74124,OK
210.012498,TraderOne,Tick,1117,1120,-3,3,150300,149800,19724,-73224,-74124,OK
210.282707,TraderOne,Tick,1117,1120,-3,3,150300,149800,19724,-73224,-74124,OK
210.512062,TraderOne,Tick,1117,1120,-3,3,150300,149800,19724,-73224,-74124,OK
210.754177,TraderOne,Tick,1117,1120,-3,3,150300,149800,19724,-73224,-74124,OK
211.023267,TraderOne,Tick,1117,1130,-13,13,150400,149900,19574,-72074,-75974,OK
211.23237,TraderOne,Tick,1117,1139,-22,22,150200,149900,19844,-69644,-76244,OK
211.498062,TraderOne,Tick,1117,1139,-22,22,150200,149900,19844,-69644,-76244,OK
211.79512,TraderOne,Tick,1127,1139,-12,12,149900,149600,19694,-74494,-76894,OK
211.991538,TraderOne,Tick,1137,1139,-2,2,149100,149600,19993,-76793,-76393,OK
212.229102,TraderOne,Tick,1140,1139,1,-1,149700,149700,20083,-77483,-77483,OK
212.51042,TraderOne,Tick,1140,1139,1,-1,149700,149700,20083,-77483,-77483,OK
212.719292,TraderOne,Tick,1140,1149,-9,9,150200,149700,19933,-75333,-77133,OK
213.004968,TraderOne,Tick,1140,1149,-9,9,150200,149700,19933,-75333,-77133,OK
213.206533,TraderOne,Tick,1140,1149,-9,9,150200,149300,19933,-75333,-77133,OK
213.469595,TraderOne,Tick,1140,1149,-9,9,150200,149300,19933,-75333,-77133,OK
213.753181,TraderOne,Tick,1140,1149,-9,9,150200,149300,19933,-75333,-77133,OK
214.001192,TraderOne,Tick,1140,1149,-9,9,150200,149300,19933,-75333,-77133,OK
214.20789,TraderOne,Tick,1140,1149,-9,9,150200,149300,19933,-75333,-77133,OK
214.529208,TraderOne,Tick,1140,1149,-9,9,150200,149600,19933,-75333,-77133,OK
214.701813,TraderOne,Tick,1140,1149,-9,9,150200,149600,19933,-75333,-77133,OK
215.002042,TraderOne,Tick,1140,1149,-9,9,150200,149600,19933,-75333,-77133,OK
215.209202,TraderOne,Tick,1140,1149,-9,9,150200,149600,19933,-75333,-77133,OK
215.507538,TraderOne,Tick,1140,1149,-9,9,150200,149600,19933,-75333,-77133,OK
215.747804,TraderOne,Tick,1140,1149,-9,9,150200,149600,19933,-75333,-77133,OK
215.958808,TraderOne,Tick,1146,1149,-3,3,149300,149600,19843,-75843,-75243,OK
216.279711,TraderOne,Tick,1146,1149,-3,3,149300,149400,19843,-75843,-75543,OK
216.495008,TraderOne,Tick,1146,1149,-3,3,149300,149600,19843,-75843,-75243,OK
216.783163,TraderOne,Tick,1156,1149,7,-7,149700,150000,20142,-75142,-77242,OK
217.028191,TraderOne,Tick,1166,1149,17,-17,149900,150000,20127,-74527,-76227,OK
217.202955,TraderOne,Tick,1176,1149,27,-27,149500,150000,20426,-70826,-78926,OK
217.512465,TraderOne,Tick,1186,1149,37,-37,149500,150100,20725,-67125,-78225,OK
217.756001,TraderOne,Tick,1186,1149,37,-37,149500,150100,20725,-67125,-78225,OK
218.033297,TraderOne,Tick,1186,1149,37,-37,149500,149900,20725,-67125,-78225,OK
218.279788,TraderOne,Tick,1186,1149,37,-37,149500,149900,20725,-67125,-78225,OK
218.503692,TraderOne,Tick,1186,1149,37,-37,149500,149900,20725,-67125,-78225,OK
218.754199,TraderOne,Tick,1186,1149,37,-37,149500,149900,20725,-67125,-78225,OK
218.979605,TraderOne,Tick,1186,1149,37,-37,149500,149900,20725,-67125,-78225,OK
219.222394,TraderOne,Tick,1186,1159,27,-27,150500,149900,20575,-69975,-61875,OK
219.533763,TraderOne,Tick,1186,1169,17,-17,150400,149900,20425,-72825,-67725,OK
219.77033,TraderOne,Tick,1186,1169,17,-17,150400,149900,20425,-72825,-67725,OK
219.973565,TraderOne,Tick,1186,1179,7,-7,150500,149900,20275,-73675,-71575,OK
220.270826,TraderOne,Tick,1186,1179,7,-7,150500,149900,20275,-73675,-71575,OK
220.512082,TraderOne,Tick,1186,1179,7,-7,150500,149900,20275,-73675,-71575,OK
220.720289,TraderOne,Tick,1186,1179,7,-7,150500,149900,20275,-73675,-71575,OK
221.011579,TraderOne,Tick,1186,1189,-3,3,150500,150000,20125,-73525,-74425,OK
221.261444,TraderOne,Tick,1186,1189,-3,3,150500,150000,20125,-73525,-74425,OK
221.512751,TraderOne,Tick,1186,1189,-3,3,150500,150100,20125,-73525,-74425,OK
221.712755,TraderOne,Tick,1186,1189,-3,3,150500,150100,20125,-73525,-74425,OK
221.99973,TraderOne,Tick,1186,1189,-3,3,150500,150100,20125,-73525,-74425,OK
222.219878,TraderOne,Tick,1186,1189,-3,3,150500,150100,20125,-73525,-74425,OK
222.52326,TraderOne,Tick,1186,1189,-3,3,150500,150100,20125,-73525,-74425,OK
222.734632,TraderOne,Tick,1196,1189,7,-7,149500,150100,19975,-74375,-76475,OK
223.012408,TraderOne,Tick,1196,1189,7,-7,149500,150000,19975,-74375,-76475,OK
223.263501,TraderOne,Tick,1196,1199,-3,3,150100,150000,20275,-74675,-74975,OK
223.544193,TraderOne,Tick,1196,1199,-3,3,150100,150000,20275,-74675,-74975,OK
223.701634,TraderOne,Tick,1196,1209,-13,13,150200,150000,20125,-74525,-77125,OK
224.028676,TraderOne,Tick,1196,1219,-23,23,150400,150000,20426,-72826,-79726,OK
224.216804,TraderOne,Tick,1196,1225,-29,29,150400,150000,20606,-70606,-79306,OK
224.457559,TraderOne,Tick,1196,1225,-29,29,150400,150000,20606,-70606,-79306,OK
224.770623,TraderOne,Tick,1196,1225,-29,29,150400,149800,20606,-70606,-79306,OK
225.044824,TraderOne,Tick,1196,1235,-39,39,150100,149400,20906,-64906,-72706,OK
225.206845,TraderOne,Tick,1196,1235,-39,39,150100,149500,20906,-64906,-72706,OK
225.512935,TraderOne,Tick,1196,1235,-39,39,150100,149500,20906,-64906,-72706,OK
225.763187,TraderOne,Tick,1196,1235,-39,39,150100,149500,20906,-64906,-72706,OK
226.046108,TraderOne,Tick,1206,1235,-29,29,149300,149500,20756,-68756,-62956,OK
226.272448,TraderOne,Tick,1206,1235,-29,29,149300,149500,20756,-68756,-62956,OK
226.458537,TraderOne,Tick,1206,1235,-29,29,149300,149500,20756,-68756,-62956,OK
226.789806,TraderOne,Tick,1206,1245,-39,39,150300,149500,20606,-66606,-74406,OK
226.971898,TraderOne,Tick,1206,1245,-39,39,150300,149500,20606,-66606,-74406,OK
227.251199,TraderOne,Tick,1206,1245,-39,39,150300,149500,20606,-66606,-74406,OK
227.510851,TraderOne,Tick,1216,1245,-29,29,150400,150200,20907,-69907,-75707,OK
227.713715,TraderOne,Tick,1221,1245,-24,24,150500,150200,21057,-71557,-78757,OK
227.979527,TraderOne,Tick,1231,1245,-14,14,150600,150800,21358,-69858,-67058,OK
228.23197,TraderOne,Tick,1241,1245,-4,4,150600,150600,21659,-69159,-69159,OK
228.530177,TraderOne,Tick,1251,1245,6,-6,150600,150600,21960,-68460,-68460,OK
228.793138,TraderOne,Tick,1261,1245,16,-16,150600,150600,22261,-68761,-68761,OK
228.9847,TraderOne,Tick,1265,1245,20,-20,150500,150600,22201,-67901,-69901,OK
229.272358,TraderOne,Tick,1265,1245,20,-20,150500,150600,22201,-67901,-69901,OK
229.509826,TraderOne,Tick,1265,1245,20,-20,150500,150600,22201,-67901,-69901,OK
229.715824,TraderOne,Tick,1265,1245,20,-20,150500,150600,22201,-67901,-69901,OK
230.050348,TraderOne,Tick,1265,1245,20,-20,150600,150600,22201,-67901,-67901,OK
230.293999,TraderOne,Tick,1265,1245,20,-20,150600,150700,22201,-67901,-69901,OK
230.468432,TraderOne,Tick,1265,1245,20,-20,150600,150700,22201,-67901,-69901,OK
230.762306,TraderOne,Tick,1265,1245,20,-20,150600,150700,22201,-67901,-69901,OK
230.986006,TraderOne,Tick,1265,1245,20,-20,150600,150700,22201,-67901,-69901,OK
231.258165,TraderOne,Tick,1265,1245,20,-20,150600,150700,22201,-67901,-69901,OK
231.523939,TraderOne,Tick,1265,1245,20,-20,150600,150700,22201,-67901,-69901,OK
231.727132,TraderOne,Tick,1265,1245,20,-20,150600,150700,22201,-67901,-69901,OK
232.03274,TraderOne,Tick,1265,1245,20,-20,150600,150700,22201,-67901,-69901,OK
232.234436,TraderOne,Tick,1265,1245,20,-20,150600,150700,22201,-67901,-69901,OK
232.537004,TraderOne,Tick,1265,1245,20,-20,150600,150700,22201,-67901,-69901,OK
232.734253,TraderOne,Tick,1275,1245,30,-30,150600,150700,22502,-65202,-68202,OK
233.011222,TraderOne,Tick,1275,1245,30,-30,150600,150700,22502,-65202,-68202,OK
233.242447,TraderOne,Tick,1285,1245,40,-40,150700,151100,22804,-62004,-74004,OK
233.532991,TraderOne,Tick,1285,1245,40,-40,150700,151100,22804,-62004,-74004,OK
233.817784,TraderOne,Tick,1285,1245,40,-40,150700,151100,22804,-62004,-74004,OK
233.957052,TraderOne,Tick,1295,1245,50,-50,150700,151100,23105,-59305,-74305,OK
234.2462,TraderOne,Tick,1295,1245,50,-50,150700,151100,23105,-59305,-74305,OK
234.503129,TraderOne,Tick,1295,1255,40,-50,150700,151200,22954,1447846,-76154,OK
234.798769,TraderOne,Tick,1305,1255,50,-50,150800,151200,23256,-62456,-77456,OK
235.025946,TraderOne,Tick,1315,1255,60,-60,150800,151400,23558,-57758,-75758,OK
235.23772,TraderOne,Tick,1315,1265,50,-50,150900,151500,23407,-65607,-80607,OK
235.523987,TraderOne,Tick,1315,1265,50,-50,150900,151500,23407,-65607,-80607,OK
235.787767,TraderOne,Tick,1315,1275,40,-40,151100,151600,23256,-72456,-84456,OK
236.04294,TraderOne,Tick,1325,1275,50,-50,151200,151600,23558,-68758,-83758,OK
236.243624,TraderOne,Tick,1325,1275,50,-50,151200,151600,23558,-68758,-83758,OK
236.513905,TraderOne,Tick,1325,1275,50,-50,151000,151600,23558,-68758,-83758,OK
236.741271,TraderOne,Tick,1325,1285,40,-40,151300,151600,23407,-73607,-85607,OK
237.050496,TraderOne,Tick,1335,1285,50,-50,151000,151600,23256,-69456,-84456,OK
237.218947,TraderOne,Tick,1335,1285,50,-50,151000,151600,23256,-69456,-84456,OK
237.495099,TraderOne,Tick,1335,1285,50,-50,151000,151700,23256,-69456,-84456,OK
237.768338,TraderOne,Tick,1335,1285,50,-50,151000,151700,23256,-69456,-84456,OK
238.000407,TraderOne,Tick,1335,1285,50,-50,151000,151700,23256,-69456,-84456,OK
238.289246,TraderOne,Tick,1335,1285,50,-50,151000,151700,23256,-69456,-84456,OK
238.475573,TraderOne,Tick,1335,1285,50,-50,151000,151700,23256,-69456,-84456,OK
238.708672,TraderOne,Tick,1335,1285,50,-50,151000,151700,23256,-69456,-84456,OK
238.986706,TraderOne,Tick,1335,1285,50,-50,151000,151700,23256,-69456,-84456,OK
239.251058,TraderOne,Tick,1335,1285,50,-50,151000,151500,23256,-69456,-84456,OK
239.544542,TraderOne,Tick,1335,1295,40,-40,151300,151500,23105,-74305,-82305,OK
239.707797,TraderOne,Tick,1335,1295,40,-40,151300,151600,23105,-74305,-86305,OK
239.98378,TraderOne,Tick,1335,1295,40,-40,151300,151500,23105,-74305,-82305,OK
240.268442,TraderOne,Tick,1335,1295,40,-40,151300,151400,23105,-74305,-78305,OK
240.49274,TraderOne,Tick,1335,1305,30,-30,151400,151400,22954,-77154,-77154,OK
240.720016,TraderOne,Tick,1335,1305,30,-30,151400,151400,22954,-77154,-77154,OK
240.999829,TraderOne,Tick,1335,1305,30,-30,151400,151500,22954,-77154,-80154,OK
241.23691,TraderOne,Tick,1335,1305,30,-30,151400,151500,22954,-77154,-80154,OK
241.491579,TraderOne,Tick,1335,1305,30,-30,151400,151500,22954,-77154,-80154,OK
241.745448,TraderOne,Tick,1335,1305,30,-30,151400,151500,22954,-77154,-80154,OK
242.024427,TraderOne,Tick,1355,1305,50,-50,150900,151300,22652,-71852,-86852,OK
242.250796,TraderOne,Tick,1355,1305,50,-50,150800,151300,22652,-71852,-86852,OK
242.508987,TraderOne,Tick,1355,1315,40,-40,150800,151300,22954,-77154,-89154,OK
242.761952,TraderOne,Tick,1355,1315,40,-40,150800,151300,22954,-77154,-89154,OK
242.962523,TraderOne,Tick,1355,1315,40,-40,150800,151300,22954,-77154,-89154,OK
243.225508,TraderOne,Tick,1355,1315,40,-40,150800,151300,22954,-77154,-89154,OK
243.558189,TraderOne,Tick,1355,1315,40,-40,150800,151300,22954,-77154,-89154,OK
243.735117,TraderOne,Tick,1355,1315,40,-40,150800,151300,22954,-77154,-89154,OK
243.981697,TraderOne,Tick,1355,1315,40,-40,150800,151500,22954,-77154,-89154,OK
244.252684,TraderOne,Tick,1355,1315,40,-40,150800,151500,22954,-77154,-89154,OK
244.518142,TraderOne,Tick,1355,1315,40,-40,150800,151500,22954,-77154,-89154,OK
244.798702,TraderOne,Tick,1355,1315,40,-40,150800,151500,22954,-77154,-89154,OK
245.018923,TraderOne,Tick,1355,1315,40,-40,150800,151500,22954,-77154,-89154,OK
245.252288,TraderOne,Tick,1355,1315,40,-40,150800,151400,22954,-77154,-89154,OK
245.543508,TraderOne,Tick,1355,1325,30,-30,151400,151800,22803,-84003,-93003,OK
245.712581,TraderOne,Tick,1365,1325,40,-40,151400,151800,23106,-81306,-93306,OK
245.979629,TraderOne,Tick,1365,1325,40,-40,151400,151800,23106,-81306,-93306,OK
246.204331,TraderOne,Tick,1365,1325,40,-40,151400,151800,23106,-81306,-93306,OK
246.53163,TraderOne,Tick,1365,1325,40,-40,151400,151800,23106,-81306,-93306,OK
246.736905,TraderOne,Tick,1365,1325,40,-40,151400,151800,23106,-81306,-93306,OK
247.040195,TraderOne,Tick,1369,1325,44,-44,151400,152100,23227,-79827,-93027,OK
247.282237,TraderOne,Tick,1379,1325,54,-54,151700,152100,23530,-74130,-90330,OK
247.479091,TraderOne,Tick,1379,1335,44,-44,151600,152100,23833,-79433,-92633,OK
247.738468,TraderOne,Tick,1389,1335,54,-54,151400,152100,23681,-75281,-91481,OK
247.974942,TraderOne,Tick,1389,1335,54,-54,151400,152100,23681,-75281,-91481,OK
248.215015,TraderOne,Tick,1389,1335,54,-54,151500,152100,23681,-75281,-91481,OK
248.532313,TraderOne,Tick,1389,1335,54,-54,151500,152100,23681,-75281,-91481,OK
248.795495,TraderOne,Tick,1389,1345,44,-44,151800,152100,23529,-80129,-93329,OK
248.957631,TraderOne,Tick,1389,1345,44,-44,151800,152100,23529,-80129,-93329,OK
249.277882,TraderOne,Tick,1399,1355,44,-44,152000,152900,23681,-86281,-99481,OK
249.547917,TraderOne,Tick,1409,1355,54,-54,152400,152800,23985,-78585,-94785,OK
249.715439,TraderOne,Tick,1409,1365,44,-44,152400,152700,24290,-83890,-97090,OK
250.03271,TraderOne,Tick,1409,1375,34,-34,152400,152700,24595,-88195,-98395,OK
250.205443,TraderOne,Tick,1409,1375,34,-34,152400,152700,24595,-88195,-98395,OK
250.456935,TraderOne,Tick,1409,1385,24,-24,152600,152700,24443,-91043,-93443,OK
250.786433,TraderOne,Tick,1409,1385,24,-24,152600,152700,24443,-91043,-93443,OK
250.986137,TraderOne,Tick,1409,1385,24,-24,152600,152500,24443,-91043,-88643,OK
251.245289,TraderOne,Tick,1419,1385,34,-34,152000,152500,24291,-88891,-99091,OK
251.492793,TraderOne,Tick,1419,1385,34,-34,152000,152600,24291,-88891,-99091,OK
251.763948,TraderOne,Tick,1419,1385,34,-34,152000,152500,24291,-88891,-99091,OK
252.032766,TraderOne,Tick,1419,1385,34,-34,152000,152500,24291,-88891,-99091,OK
252.280865,TraderOne,Tick,1419,1385,34,-34,152000,152500,24291,-88891,-99091,OK
252.545818,TraderOne,Tick,1419,1385,34,-34,152000,152500,24291,-88891,-99091,OK
252.727238,TraderOne,Tick,1419,1395,24,-24,152600,152500,24139,-90739,-88339,OK
253.039141,TraderOne,Tick,1429,1395,34,-34,152200,152500,23987,-89587,-99787,OK
253.250564,TraderOne,Tick,1429,1395,34,-34,152200,152500,23987,-89587,-99787,OK
253.464612,TraderOne,Tick,1429,1395,34,-34,152200,152500,23987,-89587,-99787,OK
253.781094,TraderOne,Tick,1429,1395,34,-34,152200,152500,23987,-89587,-99787,OK
254.009025,TraderOne,Tick,1429,1395,34,-34,152200,152600,23987,-89587,-99787,OK
254.216029,TraderOne,Tick,1434,1395,39,-39,152200,152500,24139,-88239,-99939,OK
254.491595,TraderOne,Tick,1434,1405,29,-29,152600,152500,23987,-91087,-88187,OK
254.736165,TraderOne,Tick,1434,1405,29,-29,152600,152500,23987,-91087,-88187,OK
254.957804,TraderOne,Tick,1434,1405,29,-29,152600,152500,23987,-91087,-88187,OK
255.214927,TraderOne,Tick,1434,1405,29,-29,152600,152500,23987,-91087,-88187,OK
255.457036,TraderOne,Tick,1434,1405,29,-29,152600,152500,23987,-91087,-88187,OK
255.721151,TraderOne,Tick,1434,1405,29,-29,152600,152500,23987,-91087,-88187,OK
256.017,TraderOne,Tick,1434,1405,29,-29,152600,152200,23987,-91087,-82387,OK
256.212858,TraderOne,Tick,1434,1405,29,-29,152600,152100,23987,-91087,-82387,OK
256.52598,TraderOne,Tick,1434,1405,29,-29,152600,152000,23987,-91087,-82387,OK
256.704346,TraderOne,Tick,1434,1405,29,-29,152600,152000,23987,-91087,-82387,OK
257.01185,TraderOne,Tick,1434,1405,29,-29,152600,152000,23987,-91087,-82387,OK
257.298768,TraderOne,Tick,1444,1405,39,-39,151400,152000,23835,-88935,-100635,OK
257.523578,TraderOne,Tick,1444,1405,39,-39,151400,152000,23835,-88935,-100635,OK
257.743071,TraderOne,Tick,1454,1405,49,-49,151700,152000,24138,-87238,-101938,OK
257.964747,TraderOne,Tick,1454,1405,49,-49,151700,152000,24138,-87238,-101938,OK
258.271972,TraderOne,Tick,1454,1415,39,-39,151700,151900,23986,-91086,-98886,OK
258.540992,TraderOne,Tick,1454,1415,39,-39,151700,151800,23986,-91086,-94986,OK
258.758367,TraderOne,Tick,1454,1415,39,-39,151700,151700,23986,-91086,-91086,OK
259.049486,TraderOne,Tick,1454,1425,29,-29,151700,151700,23834,-93934,-93934,OK
259.231918,TraderOne,Tick,1454,1425,29,-29,151700,151600,23834,-93934,-91034,OK
259.467599,TraderOne,Tick,1454,1425,29,-29,151700,151600,23834,-93934,-91034,OK
259.772366,TraderOne,Tick,1454,1425,29,-29,151700,151600,23834,-93934,-91034,OK
260.035335,TraderOne,Tick,1454,1425,29,-29,151700,151600,23834,-93934,-91034,OK
260.293132,TraderOne,Tick,1464,1425,39,-39,151300,151600,23683,-91783,-103483,OK
260.543273,TraderOne,Tick,1464,1435,29,-29,151300,151600,23986,-95086,-103786,OK
260.760569,TraderOne,Tick,1464,1435,29,-29,151300,151800,23986,-95086,-103786,OK
261.043739,TraderOne,Tick,1464,1435,29,-29,151300,151800,23986,-95086,-103786,OK
261.2566,TraderOne,Tick,1464,1435,29,-29,151300,151800,23986,-95086,-103786,OK
261.507573,TraderOne,Tick,1464,1435,29,-29,151300,151800,23986,-95086,-103786,OK
261.755167,TraderOne,Tick,1464,1445,19,-19,152000,151800,23834,-96934,-93134,OK
262.049298,TraderOne,Tick,1474,1445,29,-29,151600,151800,23682,-96782,-102582,OK
262.302978,TraderOne,Tick,1484,1445,39,-39,151600,151800,23985,-96085,-103885,OK
262.541365,TraderOne,Tick,1484,1445,39,-39,151600,151800,23985,-96085,-103885,OK
262.701479,TraderOne,Tick,1484,1445,39,-39,151600,151800,23985,-96085,-103885,OK
263.048467,TraderOne,Tick,1484,1445,39,-39,151600,152200,23985,-96085,-107785,OK
263.229391,TraderOne,Tick,1494,1445,49,-49,151600,152200,24288,-92388,-107088,OK
263.512767,TraderOne,Tick,1503,1445,58,-58,151600,152200,24561,-89061,-106461,OK
263.799264,TraderOne,Tick,1503,1455,48,-48,151500,152200,24864,-94364,-108764,OK
263.963502,TraderOne,Tick,1503,1455,48,-48,151500,152200,24864,-94364,-108764,OK
264.295995,TraderOne,Tick,1503,1455,48,-48,151500,152200,24864,-94364,-108764,OK
264.549344,TraderOne,Tick,1503,1455,48,-48,151500,152200,24864,-94364,-108764,OK
264.77613,TraderOne,Tick,1503,1455,48,-48,151500,151800,24864,-94364,-108764,OK
265.0277,TraderOne,Tick,1503,1455,48,-48,151500,151800,24864,-94364,-108764,OK
265.249445,TraderOne,Tick,1503,1455,48,-48,151500,151800,24864,-94364,-108764,OK
265.543581,TraderOne,Tick,1503,1455,48,-48,151500,151800,24864,-94364,-108764,OK
265.732874,TraderOne,Tick,1503,1455,48,-48,151500,151800,24864,-94364,-108764,OK
265.962946,TraderOne,Tick,1503,1465,38,-38,152100,151800,24712,-100212,-88812,OK
266.286028,TraderOne,Tick,1503,1465,38,-38,152100,151800,24712,-100212,-88812,OK
266.539435,TraderOne,Tick,1503,1471,32,-32,151800,151800,24621,-101921,-101921,OK
266.76537,TraderOne,Tick,1503,1471,32,-32,151800,151800,24621,-101921,-101921,OK
266.986178,TraderOne,Tick,1503,1471,32,-32,151800,152200,24621,-101921,-111521,OK
267.231752,TraderOne,Tick,1503,1471,32,-32,151800,152200,24621,-101921,-111521,OK
267.524823,TraderOne,Tick,1503,1481,22,-22,152100,152200,24469,-105769,-107969,OK
267.714616,TraderOne,Tick,1503,1481,22,-22,152100,152200,24469,-105769,-107969,OK
267.978903,TraderOne,Tick,1503,1481,22,-22,152100,152200,24469,-105769,-107969,OK
268.216173,TraderOne,Tick,1513,1481,32,-32,152300,152200,24774,-104074,-100874,OK
268.53719,TraderOne,Tick,1513,1481,32,-32,152300,152200,24774,-104074,-100874,OK
268.711416,TraderOne,Tick,1513,1481,32,-32,152300,152600,24774,-104074,-113674,OK
268.957542,TraderOne,Tick,1513,1481,32,-32,152300,152600,24774,-104074,-113674,OK
269.20589,TraderOne,Tick,1513,1481,32,-32,152300,152600,24774,-104074,-113674,OK
269.54086,TraderOne,Tick,1513,1481,32,-32,152300,153000,24774,-104074,-113674,OK
269.700446,TraderOne,Tick,1518,1481,37,-37,152300,153000,24926,-102726,-113826,OK
269.978866,TraderOne,Tick,1528,1481,47,-47,152100,153000,24774,-99574,-113674,OK
270.277829,TraderOne,Tick,1528,1481,47,-47,152100,153000,24774,-99574,-113674,OK
270.545246,TraderOne,Tick,1528,1481,47,-47,152100,152900,24774,-99574,-113674,OK
270.734553,TraderOne,Tick,1528,1481,47,-47,152100,152900,24774,-99574,-113674,OK
271.009841,TraderOne,Tick,1528,1481,47,-47,152100,153000,24774,-99574,-113674,OK
271.206174,TraderOne,Tick,1538,1481,57,-57,152600,153000,25079,-95879,-112979,OK
271.520522,TraderOne,Tick,1538,1491,47,-47,152700,153300,24926,-102726,-116826,OK
271.787203,TraderOne,Tick,1548,1501,47,-47,153100,153600,25079,-103879,-117979,OK
272.00343,TraderOne,Tick,1558,1507,51,-51,153100,153600,25294,-102494,-117794,OK
272.238147,TraderOne,Tick,1558,1507,51,-51,153100,153600,25294,-102494,-117794,OK
272.535332,TraderOne,Tick,1558,1517,41,-41,153600,153600,25600,-106800,-106800,OK
272.705382,TraderOne,Tick,1568,1517,51,-51,152800,153600,25447,-103647,-118947,OK
272.966656,TraderOne,Tick,1568,1517,51,-51,152800,153600,25447,-103647,-118947,OK
273.260701,TraderOne,Tick,1568,1517,51,-51,152800,153600,25447,-103647,-118947,OK
273.496055,TraderOne,Tick,1578,1517,61,-61,152600,153600,25294,-98494,-116794,OK
273.705812,TraderOne,Tick,1578,1527,51,-51,152700,153600,25599,-104799,-120099,OK
273.982813,TraderOne,Tick,1578,1537,41,-41,153800,153600,25446,-108646,-100446,OK
274.295124,TraderOne,Tick,1578,1537,41,-41,153800,153600,25446,-108646,-100446,OK
274.526353,TraderOne,Tick,1578,1537,41,-41,153800,152900,25446,-108646,-96346,OK
274.79496,TraderOne,Tick,1578,1547,31,-31,152500,152900,25751,-112951,-122251,OK
275.001292,TraderOne,Tick,1578,1547,31,-31,152500,152700,25751,-112951,-119151,OK
275.214024,TraderOne,Tick,1578,1557,21,-21,152300,152700,26056,-115256,-121556,OK
275.491195,TraderOne,Tick,1578,1566,12,-12,152600,152700,25919,-118719,-119919,OK
275.745387,TraderOne,Tick,1578,1566,12,-12,152600,152700,25919,-118719,-119919,OK
276.046058,TraderOne,Tick,1578,1566,12,-12,152600,152700,25919,-118719,-119919,OK
276.213821,TraderOne,Tick,1578,1566,12,-12,152600,153000,25919,-118719,-122319,OK
276.54307,TraderOne,Tick,1578,1566,12,-12,152600,153100,25919,-118719,-122319,OK
276.725602,TraderOne,Tick,1578,1566,12,-12,152600,153100,25919,-118719,-122319,OK
277.003345,TraderOne,Tick,1588,1566,22,-22,152400,153100,25766,-118566,-125166,OK
277.271573,TraderOne,Tick,1588,1566,22,-22,152400,153100,25766,-118566,-125166,OK
277.532415,TraderOne,Tick,1588,1566,22,-22,152400,152900,25766,-118566,-125166,OK
277.728339,TraderOne,Tick,1588,1566,22,-22,152400,152900,25766,-118566,-125166,OK
278.010373,TraderOne,Tick,1588,1566,22,-22,152400,152900,25766,-118566,-125166,OK
278.235844,TraderOne,Tick,1588,1566,22,-22,152400,152900,25766,-118566,-125166,OK
278.529457,TraderOne,Tick,1588,1566,22,-22,152400,153000,25766,-118566,-125166,OK
278.791232,TraderOne,Tick,1588,1566,22,-22,152400,153200,25766,-118566,-125166,OK
278.967043,TraderOne,Tick,1588,1566,22,-22,152400,153200,25766,-118566,-125166,OK
279.293063,TraderOne,Tick,1588,1566,22,-22,152400,153200,25766,-118566,-125166,OK
279.54134,TraderOne,Tick,1588,1566,22,-22,152400,153200,25766,-118566,-125166,OK
279.739531,TraderOne,Tick,1588,1566,22,-22,152400,153200,25766,-118566,-125166,OK
279.97674,TraderOne,Tick,1588,1566,22,-22,152400,153200,25766,-118566,-125166,OK
280.243644,TraderOne,Tick,1588,1566,22,-22,152400,153000,25766,-118566,-125166,OK
280.455037,TraderOne,Tick,1588,1576,12,-12,152800,152800,26072,-118872,-118872,OK
280.789491,TraderOne,Tick,1588,1586,2,-2,152800,152800,26378,-119178,-119178,OK
280.995666,TraderOne,Tick,1588,1586,2,-2,152800,152600,26378,-119178,-118778,OK
281.248507,TraderOne,Tick,1588,1596,-8,8,152800,152700,26684,-118484,-119284,OK
281.520475,TraderOne,Tick,1588,1596,-8,8,152800,152700,26684,-118484,-119284,OK
281.731818,TraderOne,Tick,1588,1596,-8,8,152800,152700,26684,-118484,-119284,OK
282.001559,TraderOne,Tick,1588,1596,-8,8,152800,152700,26684,-118484,-119284,OK
282.2683,TraderOne,Tick,1594,1596,-2,2,152800,152700,26592,-118992,-119192,OK
282.535382,TraderOne,Tick,1594,1596,-2,2,152800,152700,26592,-118992,-119192,OK
282.73975,TraderOne,Tick,1594,1596,-2,2,152800,152800,26592,-118992,-118992,OK
283.046957,TraderOne,Tick,1594,1596,-2,2,152800,152800,26592,-118992,-118992,OK
283.261788,TraderOne,Tick,1594,1596,-2,2,152800,152800,26592,-118992,-118992,OK
283.473595,TraderOne,Tick,1594,1596,-2,2,152800,152800,26592,-118992,-118992,OK
283.728138,TraderOne,Tick,1594,1596,-2,2,152800,152800,26592,-118992,-118992,OK
284.032501,TraderOne,Tick,1604,1596,8,-8,152300,152800,26439,-119839,-122239,OK
284.297962,TraderOne,Tick,1604,1606,-2,2,153400,152800,26286,-119686,-120286,OK
284.517699,TraderOne,Tick,1604,1606,-2,2,153400,152800,26286,-119686,-120286,OK
284.716889,TraderOne,Tick,1614,1606,8,-8,152400,152800,26133,-120533,-122933,OK
285.012407,TraderOne,Tick,1614,1606,8,-8,152400,153100,26133,-120533,-122933,OK
285.276491,TraderOne,Tick,1623,1616,7,-17,153900,153500,25842,1415458,-117442,OK
285.492953,TraderOne,Tick,1623,1616,7,-7,153900,153500,25842,-120542,-118442,OK
285.793359,TraderOne,Tick,1623,1616,7,-7,153900,153700,25842,-120542,-119142,OK
286.034557,TraderOne,Tick,1623,1616,7,-7,153900,153800,25842,-120542,-119842,OK
286.219989,TraderOne,Tick,1623,1616,7,-7,153900,153600,25842,-120542,-118442,OK
286.511545,TraderOne,Tick,1623,1616,7,-7,153900,153600,25842,-120542,-118442,OK
286.792968,TraderOne,Tick,1623,1626,-3,3,153900,153600,25688,-120388,-121288,OK
287.049701,TraderOne,Tick,1623,1626,-3,3,153900,153500,25688,-120388,-121288,OK
287.203782,TraderOne,Tick,1623,1626,-3,3,153900,153500,25688,-120388,-121288,OK
287.509036,TraderOne,Tick,1628,1626,2,-2,153600,153600,25611,-120811,-120811,OK
287.798676,TraderOne,Tick,1628,1626,2,-2,153600,153600,25611,-120811,-120811,OK
288.051079,TraderOne,Tick,1628,1626,2,-2,153600,153600,25611,-120811,-120811,OK
288.295446,TraderOne,Tick,1628,1626,2,-2,153600,153400,25611,-120811,-120411,OK
288.539118,TraderOne,Tick,1628,1626,2,-2,153600,153400,25611,-120811,-120411,OK
288.752231,TraderOne,Tick,1628,1626,2,-2,153600,153400,25611,-120811,-120411,OK
288.973473,TraderOne,Tick,1628,1626,2,-2,153600,153400,25611,-120811,-120411,OK
289.29698,TraderOne,Tick,1628,1626,2,-2,153600,153400,25611,-120811,-120411,OK
289.48264,TraderOne,Tick,1628,1626,2,-2,153600,153400,25611,-120811,-120411,OK
289.747963,TraderOne,Tick,1628,1626,2,-2,153600,153400,25611,-120811,-120411,OK
290.005848,TraderOne,Tick,1628,1626,2,-2,153600,153400,25611,-120811,-120411,OK
290.295496,TraderOne,Tick,1628,1626,2,-2,153400,153500,25611,-120811,-121011,OK
290.516149,TraderOne,Tick,1628,1626,2,-2,153400,153500,25611,-120811,-121011,OK
290.719485,TraderOne,Tick,1628,1626,2,-2,153400,153500,25611,-120811,-121011,OK
290.98656,TraderOne,Tick,1636,1636,0,0,153400,153500,25334,-120534,-120534,OK
291.25596,TraderOne,Tick,1636,1636,0,0,153400,153500,25334,-120534,-120534,OK
291.48725,TraderOne,Tick,1636,1646,-10,10,153900,153500,25180,-120380,-123380,OK
291.734421,TraderOne,Tick,1636,1646,-10,10,153900,153500,25180,-120380,-123380,OK
291.983023,TraderOne,Tick,1636,1646,-10,10,153900,153500,25180,-120380,-123380,OK
292.268016,TraderOne,Tick,1636,1646,-10,10,153900,153500,25180,-120380,-123380,OK
292.546568,TraderOne,Tick,1636,1656,-20,20,153900,153500,25026,-119226,-125226,OK
292.800567,TraderOne,Tick,1636,1666,-30,30,153900,153600,25334,-117534,-126534,OK
293.006758,TraderOne,Tick,1636,1676,-40,40,153900,153600,25642,-114842,-126842,OK
293.212604,TraderOne,Tick,1636,1676,-40,40,153900,153600,25642,-114842,-126842,OK
293.458241,TraderOne,Tick,1636,1676,-40,40,153900,153400,25642,-114842,-126842,OK
293.703808,TraderOne,Tick,1636,1676,-40,40,153900,153400,25642,-114842,-126842,OK
293.97127,TraderOne,Tick,1636,1686,-50,50,153900,153400,25950,-111150,-126150,OK
294.227873,TraderOne,Tick,1636,1686,-50,50,153900,153400,25950,-111150,-126150,OK
294.517666,TraderOne,Tick,1636,1686,-50,50,154000,153400,25950,-111150,-126150,OK
294.723627,TraderOne,Tick,1636,1686,-50,50,154000,153400,25950,-111150,-126150,OK
294.972384,TraderOne,Tick,1636,1686,-50,50,154000,153500,25950,-111150,-126150,OK
295.231108,TraderOne,Tick,1646,1686,-40,40,154000,153500,26258,-116458,-128458,OK
295.542543,TraderOne,Tick,1656,1686,-30,30,153800,153500,26104,-120304,-129304,OK
295.790352,TraderOne,Tick,1656,1686,-30,30,153800,153500,26104,-120304,-129304,OK
296.024832,TraderOne,Tick,1656,1686,-30,30,153800,153500,26104,-120304,-129304,OK
296.207955,TraderOne,Tick,1656,1686,-30,30,153800,153500,26104,-120304,-129304,OK
296.46565,TraderOne,Tick,1656,1686,-30,30,153800,153500,26104,-120304,-129304,OK
296.702336,TraderOne,Tick,1656,1696,-40,40,153800,153400,26412,-117612,-129612,OK
296.97546,TraderOne,Tick,1656,1696,-40,40,153800,153400,26412,-117612,-129612,OK
297.293609,TraderOne,Tick,1656,1696,-40,40,153800,153200,26412,-117612,-129612,OK
297.498093,TraderOne,Tick,1656,1706,-50,50,153700,153300,26719,-113919,-128919,OK
297.788588,TraderOne,Tick,1656,1706,-50,50,153700,153300,26719,-113919,-128919,OK
297.973986,TraderOne,Tick,1666,1706,-40,40,153800,153500,27027,-118227,-130227,OK
298.225914,TraderOne,Tick,1676,1706,-30,30,153100,153600,26873,-121073,-112073,OK
298.525458,TraderOne,Tick,1686,1706,-20,20,153100,153600,27179,-116379,-110379,OK
298.704982,TraderOne,Tick,1696,1706,-10,10,153100,153600,27485,-111685,-108685,OK
299.042409,TraderOne,Tick,1706,1706,0,0,153100,153500,27791,-107991,-107991,OK
299.252158,TraderOne,Tick,1706,1706,0,0,153100,153400,27791,-107991,-107991,OK
299.488838,TraderOne,Tick,1706,1706,0,0,153100,153400,27791,-107991,-107991,OK
299.769289,TraderOne,Tick,1706,1706,0,0,153100,153500,27791,-107991,-107991,OK
299.993997,TraderOne,Tick,1706,1706,0,0,153100,153700,27791,-107991,-107991,OK
300.260568,TraderOne,Tick,1706,1706,0,0,153100,153700,27791,-107991,-107991,OK
300.534836,TraderOne,Tick,1706,1706,0,0,153100,153600,27791,-107991,-107991,OK
300.706118,TraderOne,Tick,1706,1706,0,0,153100,153600,27791,-107991,-107991,OK
301.029326,TraderOne,Tick,1706,1706,0,0,153100,153600,27791,-107991,-107991,OK
301.301249,TraderOne,Tick,1706,1706,0,0,153100,153600,27791,-107991,-107991,OK
301.487092,TraderOne,Tick,1706,1706,0,0,153100,153600,27791,-107991,-107991,OK
301.752757,TraderOne,Tick,1706,1706,0,0,153100,153600,27791,-107991,-107991,OK
302.018819,TraderOne,Tick,1706,1706,0,0,153100,153600,27791,-107991,-107991,OK
302.25512,TraderOne,Tick,1706,1706,0,0,153100,153600,27791,-107991,-107991,OK
302.518424,TraderOne,Tick,1706,1706,0,0,153100,153600,27791,-107991,-107991,OK
302.722147,TraderOne,Tick,1716,1706,10,-10,153300,153600,27637,-107837,-110837,OK
302.966711,TraderOne,Tick,1716,1716,0,0,153700,153600,27944,-108144,-108144,OK
303.273046,TraderOne,Tick,1726,1726,0,0,153000,153300,28097,-109297,-109297,OK
303.545553,TraderOne,Tick,1726,1726,0,0,153000,153400,28097,-109297,-109297,OK
303.800372,TraderOne,Tick,1726,1726,0,0,153000,153400,28097,-109297,-109297,OK
304.049932,TraderOne,Tick,1726,1736,-10,0,154000,153200,27943,1425857,-109143,OK
304.202852,TraderOne,Tick,1726,1736,-10,10,154000,153200,27943,-106143,-109143,OK
304.507419,TraderOne,Tick,1726,1736,-10,10,154000,153100,27943,-106143,-109143,OK
304.710035,TraderOne,Tick,1726,1736,-10,10,154000,153100,27943,-106143,-109143,OK
305.047805,TraderOne,Tick,1736,1746,-10,10,152500,152900,27637,-104837,-101837,OK
305.206073,TraderOne,Tick,1736,1746,-10,10,152500,152900,27637,-104837,-101837,OK
305.456806,TraderOne,Tick,1736,1746,-10,10,152500,152900,27637,-104837,-101837,OK
305.794967,TraderOne,Tick,1736,1746,-10,10,152500,152800,27637,-104837,-101837,OK
305.96702,TraderOne,Tick,1736,1746,-10,10,152500,152800,27637,-104837,-101837,OK
306.280693,TraderOne,Tick,1736,1746,-10,10,152500,152800,27637,-104837,-101837,OK
306.497067,TraderOne,Tick,1746,1746,0,0,152500,152600,27484,-106684,-106684,OK
306.797742,TraderOne,Tick,1746,1746,0,0,152500,152600,27484,-106684,-106684,OK
306.994437,TraderOne,Tick,1746,1746,0,0,152500,152600,27484,-106684,-106684,OK
307.280451,TraderOne,Tick,1746,1746,0,0,152500,152900,27484,-106684,-106684,OK
307.477235,TraderOne,Tick,1746,1746,0,0,152500,152900,27484,-106684,-106684,OK
307.763672,TraderOne,Tick,1746,1746,0,0,152500,152900,27484,-106684,-106684,OK
308.004863,TraderOne,Tick,1746,1746,0,0,152500,152900,27484,-106684,-106684,OK
308.29622,TraderOne,Tick,1746,1746,0,0,152500,152900,27484,-106684,-106684,OK
308.490085,TraderOne,Tick,1746,1746,0,0,152500,152900,27484,-106684,-106684,OK
308.758685,TraderOne,Tick,1746,1746,0,0,152500,152900,27484,-106684,-106684,OK
308.990593,TraderOne,Tick,1746,1746,0,0,152500,152900,27484,-106684,-106684,OK
309.220905,TraderOne,Tick,1756,1746,10,-10,153200,152900,27331,-107531,-104531,OK
309.471393,TraderOne,Tick,1766,1756,10,-10,152600,153200,27025,-105225,-108225,OK
309.721196,TraderOne,Tick,1766,1756,10,-10,152600,153200,27025,-105225,-108225,OK
309.997509,TraderOne,Tick,1766,1756,10,-10,152600,153400,27025,-105225,-108225,OK
310.264739,TraderOne,Tick,1766,1763,3,-3,153400,154100,26918,-110018,-110918,OK
310.546014,TraderOne,Tick,1776,1763,13,-13,153800,154200,27226,-108326,-112226,OK
310.782007,TraderOne,Tick,1786,1763,23,-23,153800,154200,27534,-106634,-113534,OK
311.032125,TraderOne,Tick,1796,1773,23,-23,154100,154200,27688,-106788,-109088,OK
311.249839,TraderOne,Tick,1796,1773,23,-23,154100,154200,27688,-106788,-109088,OK
311.538324,TraderOne,Tick,1796,1783,13,-13,154100,154200,27534,-107634,-108934,OK
311.765728,TraderOne,Tick,1796,1783,13,-13,154100,154200,27534,-107634,-108934,OK
311.988783,TraderOne,Tick,1796,1783,13,-13,154100,154200,27534,-107634,-108934,OK
312.202552,TraderOne,Tick,1796,1783,13,-13,154100,154200,27534,-107634,-108934,OK
312.51833,TraderOne,Tick,1796,1783,13,-13,154100,154200,27534,-107634,-108934,OK
312.783301,TraderOne,Tick,1806,1783,23,-23,153600,154200,27842,-106942,-113842,OK
313.023293,TraderOne,Tick,1806,1783,23,-23,153600,154200,27842,-106942,-113842,OK
313.219526,TraderOne,Tick,1806,1783,23,-23,153600,154300,27842,-106942,-113842,OK
313.489743,TraderOne,Tick,1806,1793,13,-13,154300,154300,27688,-108788,-108788,OK
313.702205,TraderOne,Tick,1806,1793,13,-13,154300,154300,27688,-108788,-108788,OK
313.970302,TraderOne,Tick,1806,1793,13,-13,154300,154300,27688,-108788,-108788,OK
314.250435,TraderOne,Tick,1806,1793,13,-13,154300,154300,27688,-108788,-108788,OK
314.477231,TraderOne,Tick,1806,1793,13,-13,154300,154300,27688,-108788,-108788,OK
314.726461,TraderOne,Tick,1806,1803,3,-3,154500,154300,27534,-109634,-109034,OK
315.041766,TraderOne,Tick,1806,1803,3,-3,154500,154300,27534,-109634,-109034,OK
315.303725,TraderOne,Tick,1806,1803,3,-3,154500,154300,27534,-109634,-109034,OK
315.546907,TraderOne,Tick,1806,1803,3,-3,154500,154300,27534,-109634,-109034,OK
315.743921,TraderOne,Tick,1806,1803,3,-3,154500,154300,27534,-109634,-109034,OK
315.956549,TraderOne,Tick,1806,1803,3,-3,154500,154300,27534,-109634,-109034,OK
316.242217,TraderOne,Tick,1806,1803,3,-3,154500,154300,27534,-109634,-109034,OK
316.5148,TraderOne,Tick,1806,1803,3,-3,154500,154300,27534,-109634,-109034,OK
316.766789,TraderOne,Tick,1806,1803,3,-3,154500,154300,27534,-109634,-109034,OK
316.968143,TraderOne,Tick,1816,1803,13,-13,154200,154300,27380,-108480,-109780,OK
317.233312,TraderOne,Tick,1816,1813,3,-3,154300,154200,27689,-108789,-108489,OK
317.510562,TraderOne,Tick,1816,1823,-7,7,154500,154200,27998,-108098,-110198,OK
317.705234,TraderOne,Tick,1816,1833,-17,17,154300,154200,28307,-106407,-108107,OK
317.997267,TraderOne,Tick,1816,1843,-27,27,154300,154200,28616,-104716,-107416,OK
318.259696,TraderOne,Tick,1816,1843,-27,27,154300,154200,28616,-104716,-107416,OK
318.544888,TraderOne,Tick,1816,1853,-37,37,154400,153800,28925,-101025,-112125,OK
318.793345,TraderOne,Tick,1816,1863,-47,47,154300,153800,29234,-97334,-111434,OK
319.037568,TraderOne,Tick,1816,1863,-47,47,154300,153800,29234,-97334,-111434,OK
319.294651,TraderOne,Tick,1816,1863,-47,47,154300,153800,29234,-97334,-111434,OK
319.46461,TraderOne,Tick,1816,1863,-47,47,154300,153800,29234,-97334,-111434,OK
319.709284,TraderOne,Tick,1816,1864,-48,48,154300,153800,29265,-96965,-111365,OK
319.984122,TraderOne,Tick,1816,1873,-57,57,154400,153700,29126,-92326,-109426,OK
320.232915,TraderOne,Tick,1816,1873,-57,57,154400,153700,29126,-92326,-109426,OK
320.503521,TraderOne,Tick,1816,1873,-57,57,154400,153900,29126,-92326,-109426,OK
320.723039,TraderOne,Tick,1826,1873,-47,47,154400,153900,29435,-98635,-112735,OK
321.011348,TraderOne,Tick,1826,1873,-47,47,154400,153900,29435,-98635,-112735,OK
321.264267,TraderOne,Tick,1826,1876,-50,50,154400,153900,29389,-97089,-112089,OK
321.524212,TraderOne,Tick,1826,1876,-50,50,154400,153900,29389,-97089,-112089,OK
321.798719,TraderOne,Tick,1836,1876,-40,50,154300,153800,29235,-1639935,-113935,OK
321.968249,TraderOne,Tick,1836,1886,-50,50,154200,153800,29543,-100243,-115243,OK
322.236828,TraderOne,Tick,1836,1886,-50,50,154200,153800,29543,-100243,-115243,OK
322.474925,TraderOne,Tick,1836,1886,-50,50,154200,153800,29543,-100243,-115243,OK
322.767125,TraderOne,Tick,1836,1886,-50,50,154200,153800,29543,-100243,-115243,OK
323.049337,TraderOne,Tick,1836,1886,-50,50,154200,153800,29543,-100243,-115243,OK
323.230122,TraderOne,Tick,1836,1886,-50,50,154200,153800,29543,-100243,-115243,OK
323.541855,TraderOne,Tick,1836,1886,-50,50,154400,153800,29543,-100243,-115243,OK
323.774766,TraderOne,Tick,1836,1886,-50,50,154400,153800,29543,-100243,-115243,OK
323.984265,TraderOne,Tick,1836,1886,-50,50,154400,153800,29543,-100243,-115243,OK
324.224545,TraderOne,Tick,1836,1886,-50,50,154400,153800,29543,-100243,-115243,OK
324.534103,TraderOne,Tick,1846,1886,-40,40,153900,153800,29389,-105089,-109089,OK
324.801045,TraderOne,Tick,1846,1886,-40,40,153900,153800,29389,-105089,-109089,OK
325.000354,TraderOne,Tick,1846,1886,-40,40,153900,153800,29389,-105089,-109089,OK
325.239807,TraderOne,Tick,1846,1886,-40,40,153900,153600,29389,-105089,-117089,OK
325.529495,TraderOne,Tick,1846,1886,-40,40,153900,153600,29389,-105089,-117089,OK
325.78465,TraderOne,Tick,1846,1886,-40,40,153900,153600,29389,-105089,-117089,OK
325.983046,TraderOne,Tick,1856,1886,-30,30,153000,153600,29235,-108935,-99935,OK
326.266385,TraderOne,Tick,1856,1886,-30,30,153000,153600,29235,-108935,-99935,OK
326.451662,TraderOne,Tick,1856,1886,-30,30,153000,153500,29235,-108935,-99935,OK
326.763211,TraderOne,Tick,1856,1886,-30,30,153000,153500,29235,-108935,-99935,OK
326.975528,TraderOne,Tick,1856,1886,-30,30,153000,153400,29235,-108935,-99935,OK
327.26415,TraderOne,Tick,1856,1886,-30,30,153000,153400,29235,-108935,-99935,OK
327.509318,TraderOne,Tick,1856,1895,-39,39,153900,153400,29096,-105196,-116896,OK
327.717923,TraderOne,Tick,1856,1896,-40,40,154000,153400,29081,-104681,-116681,OK
328.027305,TraderOne,Tick,1866,1906,-40,40,152900,153400,28773,-104373,-92373,OK
328.275562,TraderOne,Tick,1866,1906,-40,40,152900,153400,28773,-104373,-92373,OK
328.487045,TraderOne,Tick,1866,1906,-40,40,152900,153400,28773,-104373,-92373,OK
328.74733,TraderOne,Tick,1866,1906,-40,40,152900,153400,28773,-104373,-92373,OK
328.998756,TraderOne,Tick,1866,1906,-40,40,152900,153400,28773,-104373,-92373,OK
329.261706,TraderOne,Tick,1866,1906,-40,40,152900,153400,28773,-104373,-92373,OK
329.4954,TraderOne,Tick,1866,1906,-40,40,152900,153400,28773,-104373,-92373,OK
329.774165,TraderOne,Tick,1866,1906,-40,40,152900,153400,28773,-104373,-92373,OK
330.047811,TraderOne,Tick,1866,1906,-40,40,152900,153400,28773,-104373,-92373,OK
330.306888,TraderOne,Tick,1866,1906,-40,40,152900,153500,28773,-104373,-92373,OK
330.537665,TraderOne,Tick,1866,1906,-40,40,154000,153500,28773,-104373,-116373,OK
330.706381,TraderOne,Tick,1866,1906,-40,40,154000,153500,28773,-104373,-116373,OK
330.962449,TraderOne,Tick,1866,1906,-40,40,154000,153500,28773,-104373,-116373,OK
331.209377,TraderOne,Tick,1866,1906,-40,40,154000,153400,28773,-104373,-116373,OK
331.533922,TraderOne,Tick,1876,1906,-30,30,152900,153400,28619,-107219,-98219,OK
331.794025,TraderOne,Tick,1876,1906,-30,30,152900,153400,28619,-107219,-98219,OK
332.049305,TraderOne,Tick,1876,1906,-30,30,152900,153400,28619,-107219,-98219,OK
332.285685,TraderOne,Tick,1876,1906,-30,30,152900,153400,28619,-107219,-98219,OK
332.489212,TraderOne,Tick,1876,1916,-40,40,154000,153400,28465,-104065,-116065,OK
332.716284,TraderOne,Tick,1876,1916,-40,40,154000,153400,28465,-104065,-116065,OK
333.011819,TraderOne,Tick,1876,1916,-40,40,154000,153400,28465,-104065,-116065,OK
333.209329,TraderOne,Tick,1876,1916,-40,40,154000,153400,28465,-104065,-116065,OK
333.493972,TraderOne,Tick,1876,1916,-40,40,154000,153400,28465,-104065,-116065,OK
333.712637,TraderOne,Tick,1876,1916,-40,40,154000,153400,28465,-104065,-116065,OK
333.957589,TraderOne,Tick,1876,1916,-40,40,154000,153300,28465,-104065,-116065,OK
334.219498,TraderOne,Tick,1876,1916,-40,40,154000,153200,28465,-104065,-116065,OK
334.531645,TraderOne,Tick,1876,1916,-40,40,154000,153200,28465,-104065,-116065,OK
334.711362,TraderOne,Tick,1876,1916,-40,40,154000,153200,28465,-104065,-116065,OK
335.045157,TraderOne,Tick,1876,1916,-40,40,154000,153200,28465,-104065,-116065,OK
335.259513,TraderOne,Tick,1876,1916,-40,40,154000,153200,28465,-104065,-116065,OK
335.48147,TraderOne,Tick,1876,1926,-50,50,154000,153200,28311,-99911,-114911,OK
335.719596,TraderOne,Tick,1886,1926,-40,40,152800,153200,28157,-104757,-92757,OK
336.00966,TraderOne,Tick,1886,1926,-40,40,152800,153200,28157,-104757,-92757,OK
336.227695,TraderOne,Tick,1886,1926,-40,40,152800,153200,28157,-104757,-92757,OK
336.547576,TraderOne,Tick,1886,1936,-50,50,153800,153300,28003,-100603,-115603,OK
336.710195,TraderOne,Tick,1886,1936,-50,50,153800,153300,28003,-100603,-115603,OK
337.05066,TraderOne,Tick,1886,1936,-50,50,153800,153300,28003,-100603,-115603,OK
337.290386,TraderOne,Tick,1886,1936,-50,50,153800,153300,28003,-100603,-115603,OK
337.551009,TraderOne,Tick,1886,1936,-50,50,153800,153300,28003,-100603,-115603,OK
337.757395,TraderOne,Tick,1886,1936,-50,50,153800,153300,28003,-100603,-115603,OK
337.965837,TraderOne,Tick,1886,1936,-50,50,153800,153300,28003,-100603,-115603,OK
338.23624,TraderOne,Tick,1886,1936,-50,50,153800,153300,28003,-100603,-115603,OK
338.460743,TraderOne,Tick,1886,1936,-50,50,153800,153300,28003,-100603,-115603,OK
338.706656,TraderOne,Tick,1886,1936,-50,50,153800,153300,28003,-100603,-115603,OK
338.965209,TraderOne,Tick,1886,1936,-50,50,153800,153300,28003,-100603,-115603,OK
339.274012,TraderOne,Tick,1886,1946,-60,60,154000,153300,27849,-95449,-113449,OK
339.473641,TraderOne,Tick,1906,1946,-40,40,154000,153500,28003,-102803,-114803,OK
339.789596,TraderOne,Tick,1906,1946,-40,40,154000,153500,28003,-102803,-114803,OK
339.970254,TraderOne,Tick,1906,1946,-40,40,154000,153500,28003,-102803,-114803,OK
340.246324,TraderOne,Tick,1906,1946,-40,40,154000,153500,28003,-102803,-114803,OK
340.495155,TraderOne,Tick,1906,1946,-40,40,154000,153500,28003,-102803,-114803,OK
340.760593,TraderOne,Tick,1906,1946,-40,40,154000,153300,28003,-102803,-114803,OK
340.953515,TraderOne,Tick,1906,1946,-40,40,154000,153300,28003,-102803,-114803,OK
341.294572,TraderOne,Tick,1906,1946,-40,40,154000,153300,28003,-102803,-114803,OK
341.466584,TraderOne,Tick,1906,1946,-40,40,154000,153300,28003,-102803,-114803,OK
341.770303,TraderOne,Tick,1906,1956,-50,50,154100,153300,27849,-98649,-113649,OK
342.046438,TraderOne,Tick,1906,1956,-50,50,154100,153300,27849,-98649,-113649,OK
342.201071,TraderOne,Tick,1906,1956,-50,50,154100,153300,27849,-98649,-113649,OK
342.511378,TraderOne,Tick,1916,1956,-40,40,154000,153300,27695,-104495,-116495,OK
342.768318,TraderOne,Tick,1916,1956,-40,40,154000,153300,27695,-104495,-116495,OK
342.988951,TraderOne,Tick,1916,1956,-40,40,154000,153300,27695,-104495,-116495,OK
343.217381,TraderOne,Tick,1916,1956,-40,40,154000,153300,27695,-104495,-116495,OK
343.552005,TraderOne,Tick,1916,1966,-50,50,153800,153300,28003,-99803,-114803,OK
343.798441,TraderOne,Tick,1916,1976,-60,60,153700,153300,28310,-94710,-112710,OK
344.006544,TraderOne,Tick,1926,1976,-50,50,152800,153300,28617,-101017,-86017,OK
344.219049,TraderOne,Tick,1926,1976,-50,50,152800,153000,28617,-101017,-91017,OK
344.4837,TraderOne,Tick,1926,1976,-50,50,152800,153000,28617,-101017,-91017,OK
344.742315,TraderOne,Tick,1936,1976,-40,40,152500,152900,28464,-105864,-93864,OK
345.000498,TraderOne,Tick,1936,1976,-40,40,152500,152900,28464,-105864,-93864,OK
345.200709,TraderOne,Tick,1936,1976,-40,40,152500,152900,28464,-105864,-93864,OK
345.534047,TraderOne,Tick,1936,1976,-40,40,152500,152900,28464,-105864,-93864,OK
345.757695,TraderOne,Tick,1936,1976,-40,40,152500,152700,28464,-105864,-97864,OK
345.971618,TraderOne,Tick,1936,1979,-43,43,153200,152700,28418,-104318,-117218,OK
346.294128,TraderOne,Tick,1936,1979,-43,43,153200,152700,28418,-104318,-117218,OK
346.53638,TraderOne,Tick,1936,1979,-43,43,153200,152600,28418,-104318,-117218,OK
346.728906,TraderOne,Tick,1946,1979,-33,33,153100,152800,28724,-108624,-118524,OK
346.966848,TraderOne,Tick,1946,1979,-33,33,153100,152700,28724,-108624,-118524,OK
347.262232,TraderOne,Tick,1946,1979,-33,33,153100,152700,28724,-108624,-118524,OK
347.50324,TraderOne,Tick,1946,1979,-33,33,153100,152700,28724,-108624,-118524,OK
347.720186,TraderOne,Tick,1956,1979,-23,23,152500,152700,28571,-112471,-107871,OK
347.992928,TraderOne,Tick,1966,1979,-13,13,152800,152700,28877,-114777,-116077,OK
348.211693,TraderOne,Tick,1976,1979,-3,3,152000,152700,29183,-117083,-116183,OK
348.494835,TraderOne,Tick,1986,1979,7,-7,152700,152700,29030,-117930,-117930,OK
348.702986,TraderOne,Tick,1986,1979,7,-7,152700,152600,29030,-117930,-117230,OK
349.039521,TraderOne,Tick,1986,1979,7,-7,152700,152600,29030,-117930,-117230,OK
349.284677,TraderOne,Tick,1986,1979,7,-7,152700,152600,29030,-117930,-117230,OK
349.513533,TraderOne,Tick,1986,1979,7,-7,152700,152600,29030,-117930,-117230,OK
349.802513,TraderOne,Tick,1986,1979,7,-7,152700,152600,29030,-117930,-117230,OK
350.011978,TraderOne,Tick,1986,1979,7,-7,152700,152600,29030,-117930,-117230,OK
350.280277,TraderOne,Tick,1986,1979,7,-7,152700,152600,29030,-117930,-117230,OK
350.507388,TraderOne,Tick,1986,1979,7,-7,152700,152600,29030,-117930,-117230,OK
350.701143,TraderOne,Tick,1986,1979,7,-7,152700,152600,29030,-117930,-117230,OK
350.992278,TraderOne,Tick,1986,1979,7,-7,152700,152600,29030,-117930,-117230,OK
351.211502,TraderOne,Tick,1986,1979,7,-7,152700,152600,29030,-117930,-117230,OK
351.545408,TraderOne,Tick,1986,1979,7,-7,152700,152500,29030,-117930,-116530,OK
351.718227,TraderOne,Tick,1986,1989,-3,3,152700,152500,28877,-116777,-117377,OK
352.040904,TraderOne,Tick,1986,1999,-13,13,152700,152300,29182,-115082,-118982,OK
352.22475,TraderOne,Tick,1986,2009,-23,23,152700,152300,29487,-112387,-119287,OK
352.47501,TraderOne,Tick,1986,2009,-23,23,152700,152300,29487,-112387,-119287,OK
352.759298,TraderOne,Tick,1986,2009,-23,23,152700,152300,29487,-112387,-119287,OK
353.01091,TraderOne,Tick,1986,2019,-33,33,152700,152300,29792,-108692,-118592,OK
353.276281,TraderOne,Tick,1986,2029,-43,43,152700,152300,30097,-104997,-117897,OK
353.498831,TraderOne,Tick,1986,2034,-48,48,152700,152100,30250,-102650,-117050,OK
353.753178,TraderOne,Tick,1986,2034,-48,48,152700,152100,30250,-102650,-117050,OK
353.969703,TraderOne,Tick,1986,2034,-48,48,152700,152100,30250,-102650,-117050,OK
354.225316,TraderOne,Tick,1986,2034,-48,48,152700,152100,30250,-102650,-117050,OK
354.481683,TraderOne,Tick,1986,2034,-48,48,152700,152100,30250,-102650,-117050,OK
354.726567,TraderOne,Tick,1986,2034,-48,48,152700,152100,30250,-102650,-117050,OK
355.008698,TraderOne,Tick,1996,2034,-38,38,152800,152100,30556,-106956,-118356,OK
355.292973,TraderOne,Tick,1996,2034,-38,38,152800,152100,30556,-106956,-118356,OK
355.55805,TraderOne,Tick,1996,2034,-38,38,153000,152500,30556,-106956,-118356,OK
355.729019,TraderOne,Tick,1996,2034,-38,38,153000,152500,30556,-106956,-118356,OK
356.035586,TraderOne,Tick,1996,2034,-38,38,153000,152500,30556,-106956,-118356,OK
356.235753,TraderOne,Tick,1996,2034,-38,38,153000,152500,30556,-106956,-118356,OK
356.519167,TraderOne,Tick,1996,2034,-38,38,153000,152400,30556,-106956,-118356,OK
356.752963,TraderOne,Tick,1996,2034,-38,38,153000,152400,30556,-106956,-118356,OK
357.026663,TraderOne,Tick,1996,2034,-38,38,153000,152400,30556,-106956,-118356,OK
357.218764,TraderOne,Tick,1996,2034,-38,38,153000,152400,30556,-106956,-118356,OK
357.497967,TraderOne,Tick,1996,2044,-48,48,153000,152400,30403,-103803,-118203,OK
357.739639,TraderOne,Tick,1996,2044,-48,48,153000,152400,30403,-103803,-118203,OK
357.9856,TraderOne,Tick,1996,2044,-48,48,153000,152400,30403,-103803,-118203,OK
358.269307,TraderOne,Tick,2006,2044,-38,38,152800,152400,30250,-108650,-120050,OK
358.495457,TraderOne,Tick,2016,2044,-28,28,152600,152100,30555,-112955,-121355,OK
358.774665,TraderOne,Tick,2016,2054,-38,38,152800,152100,30403,-108803,-120203,OK
358.995472,TraderOne,Tick,2016,2054,-38,38,152800,152100,30403,-108803,-120203,OK
359.280787,TraderOne,Tick,2016,2054,-38,38,152800,152100,30403,-108803,-120203,OK
359.485068,TraderOne,Tick,2016,2054,-38,38,152800,152100,30403,-108803,-120203,OK
359.814286,TraderOne,Tick,2016,2054,-38,38,152800,151400,30403,-108803,-120203,OK
360.006598,TraderOne,Tick,2016,2064,-48,48,152100,151400,30708,-102108,-116508,OK
360.251994,TraderOne,Tick,2026,2064,-38,38,152000,151400,31012,-107412,-118812,OK
360.47605,TraderOne,Tick,2026,2064,-38,38,152000,151800,31012,-107412,-115012,OK
360.763185,TraderOne,Tick,2026,2074,-48,48,152400,152000,30860,-103260,-117660,OK
361.000735,TraderOne,Tick,2026,2074,-48,48,152400,152300,30860,-103260,-108060,OK
361.222828,TraderOne,Tick,2026,2074,-48,48,152400,152300,30860,-103260,-108060,OK
361.476138,TraderOne,Tick,2026,2074,-48,48,152400,152300,30860,-103260,-108060,OK
361.772095,TraderOne,Tick,2026,2074,-48,48,152400,152300,30860,-103260,-108060,OK
361.962846,TraderOne,Tick,2026,2074,-48,48,152400,152300,30860,-103260,-108060,OK
362.293656,TraderOne,Tick,2036,2083,-47,47,151900,152300,30571,-102471,-88371,OK
362.464677,TraderOne,Tick,2036,2084,-48,48,152500,152300,30556,-101956,-111556,OK
362.781706,TraderOne,Tick,2036,2084,-48,48,152500,152100,30556,-101956,-116356,OK
363.032225,TraderOne,Tick,2046,2084,-38,38,152500,152100,30404,-108804,-120204,OK
363.30123,TraderOne,Tick,2046,2084,-38,38,152500,152100,30404,-108804,-120204,OK
363.454495,TraderOne,Tick,2046,2084,-38,38,152500,152100,30404,-108804,-120204,OK
363.77904,TraderOne,Tick,2046,2084,-38,38,152500,152100,30404,-108804,-120204,OK
363.994189,TraderOne,Tick,2046,2084,-38,38,152500,152100,30404,-108804,-120204,OK
364.226615,TraderOne,Tick,2046,2094,-48,48,152200,152100,30252,-104652,-109452,OK
364.496135,TraderOne,Tick,2046,2094,-48,48,152200,152100,30252,-104652,-109452,OK
364.801516,TraderOne,Tick,2056,2094,-38,38,151900,152100,30100,-110500,-102900,OK
364.978637,TraderOne,Tick,2056,2094,-38,38,151800,152100,30100,-110500,-99100,OK
365.297079,TraderOne,Tick,2056,2094,-38,38,151800,152100,30100,-110500,-99100,OK
365.472657,TraderOne,Tick,2056,2094,-38,38,151800,152100,30100,-110500,-99100,OK
365.738174,TraderOne,Tick,2056,2104,-48,48,152200,152100,29948,-106348,-111148,OK
365.995335,TraderOne,Tick,2056,2104,-48,48,152200,152100,29948,-106348,-111148,OK
366.213484,TraderOne,Tick,2056,2104,-48,48,151800,152100,29948,-106348,-91948,OK
366.537189,TraderOne,Tick,2056,2114,-58,58,152000,151500,29796,-102196,-119596,OK
366.709418,TraderOne,Tick,2056,2114,-58,58,152000,151500,29796,-102196,-119596,OK
367.040113,TraderOne,Tick,2056,2114,-58,58,152000,151500,29796,-102196,-119596,OK
367.217652,TraderOne,Tick,2076,2114,-38,38,152100,151500,29947,-108847,-120247,OK
367.51588,TraderOne,Tick,2076,2114,-38,38,152100,151600,29947,-108847,-120247,OK
367.707893,TraderOne,Tick,2076,2114,-38,38,152100,151800,29947,-108847,-120247,OK
367.969417,TraderOne,Tick,2076,2114,-38,38,152100,151800,29947,-108847,-120247,OK
368.262413,TraderOne,Tick,2076,2114,-38,38,152100,151800,29947,-108847,-120247,OK
368.523163,TraderOne,Tick,2076,2124,-48,48,152100,151800,29795,-104695,-119095,OK
368.720128,TraderOne,Tick,2076,2124,-48,48,152100,151800,29795,-104695,-119095,OK
369.018065,TraderOne,Tick,2076,2124,-48,48,152100,151700,29795,-104695,-119095,OK
369.281726,TraderOne,Tick,2076,2124,-48,48,152100,151700,29795,-104695,-119095,OK
369.501927,TraderOne,Tick,2076,2124,-48,48,152100,151700,29795,-104695,-119095,OK
369.882259,TraderOne,Tick,2076,2124,-48,48,152100,152000,29795,-104695,-109495,OK
369.999082,TraderOne,Tick,2086,2124,-38,38,152400,152000,30100,-109000,-120400,OK
370.243224,TraderOne,Tick,2096,2124,-28,28,152400,152000,30405,-113305,-121705,OK
370.490777,TraderOne,Tick,2096,2124,-28,28,152400,152000,30405,-113305,-121705,OK
370.798196,TraderOne,Tick,2096,2124,-28,28,152400,152000,30405,-113305,-121705,OK
371.051163,TraderOne,Tick,2106,2124,-18,18,152400,152000,30710,-116610,-122010,OK
371.210108,TraderOne,Tick,2106,2124,-18,18,152400,152000,30710,-116610,-122010,OK
371.474059,TraderOne,Tick,2106,2124,-18,18,152400,152000,30710,-116610,-122010,OK
371.780487,TraderOne,Tick,2106,2124,-18,18,152400,152000,30710,-116610,-122010,OK
372.017217,TraderOne,Tick,2116,2124,-8,8,152100,152000,30558,-117458,-118258,OK
372.22918,TraderOne,Tick,2126,2124,2,-2,151900,152000,30862,-115762,-115962,OK
372.465573,TraderOne,Tick,2136,2124,12,-12,151900,152000,31166,-115066,-116266,OK
372.722238,TraderOne,Tick,2146,2124,22,-22,151900,152000,31470,-114370,-116570,OK
373.035648,TraderOne,Tick,2146,2124,22,-22,151900,152000,31470,-114370,-116570,OK
373.229595,TraderOne,Tick,2146,2124,22,-22,151900,152000,31470,-114370,-116570,OK
373.538569,TraderOne,Tick,2146,2134,12,-12,151900,152000,31318,-116218,-117418,OK
373.770273,TraderOne,Tick,2146,2134,12,-12,151900,152000,31318,-116218,-117418,OK
373.979901,TraderOne,Tick,2146,2134,12,-12,151900,152000,31318,-116218,-117418,OK
374.231641,TraderOne,Tick,2146,2134,12,-12,151900,152000,31318,-116218,-117418,OK
374.452837,TraderOne,Tick,2148,2134,14,-14,151900,152000,31379,-115879,-117279,OK
374.736315,TraderOne,Tick,2148,2134,14,-14,151900,152000,31379,-115879,-117279,OK
375.00697,TraderOne,Tick,2148,2134,14,-14,151900,152000,31379,-115879,-117279,OK
375.274852,TraderOne,Tick,2148,2144,4,-4,152400,152000,31227,-116727,-115527,OK
375.485549,TraderOne,Tick,2148,2144,4,-4,152400,152000,31227,-116727,-115527,OK
375.75818,TraderOne,Tick,2148,2144,4,-4,152400,152000,31227,-116727,-115527,OK
376.028583,TraderOne,Tick,2148,2144,4,-4,152400,152000,31227,-116727,-115527,OK
376.28602,TraderOne,Tick,2148,2144,4,-4,152400,152000,31227,-116727,-115527,OK
376.482877,TraderOne,Tick,2148,2144,4,-4,152400,152000,31227,-116727,-115527,OK
376.746365,TraderOne,Tick,2148,2144,4,-4,152400,152000,31227,-116727,-115527,OK
377.049737,TraderOne,Tick,2158,2144,14,-14,151900,152000,31075,-117575,-118975,OK
377.316201,TraderOne,Tick,2158,2144,14,-14,151900,152300,31075,-117575,-121775,OK
377.487603,TraderOne,Tick,2158,2144,14,-14,151900,152300,31075,-117575,-121775,OK
377.77439,TraderOne,Tick,2158,2144,14,-14,151900,152300,31075,-117575,-121775,OK
377.973217,TraderOne,Tick,2158,2144,14,-14,151900,152300,31075,-117575,-121775,OK
378.299382,TraderOne,Tick,2158,2154,4,-4,152800,152300,30923,-118423,-117223,OK
378.532362,TraderOne,Tick,2168,2154,14,-14,151800,152300,30771,-118271,-122471,OK
378.702645,TraderOne,Tick,2168,2164,4,-4,152200,152300,30619,-119119,-119519,OK
379.046831,TraderOne,Tick,2178,2174,4,-4,151800,152300,30772,-115272,-116472,OK
379.261601,TraderOne,Tick,2178,2174,4,-4,151800,152300,30772,-115272,-116472,OK
379.507708,TraderOne,Tick,2178,2174,4,-4,151800,152300,30772,-115272,-116472,OK
379.782848,TraderOne,Tick,2178,2174,4,-4,151800,152300,30772,-115272,-116472,OK
380.037355,TraderOne,Tick,2186,2174,12,-12,152200,152300,30650,-115950,-117150,OK
380.203633,TraderOne,Tick,2186,2174,12,-12,152200,152300,30650,-115950,-117150,OK
380.502279,TraderOne,Tick,2186,2174,12,-12,152200,152300,30650,-115950,-117150,OK
380.791872,TraderOne,Tick,2196,2174,22,-22,151800,152300,30498,-114798,-121398,OK
380.955972,TraderOne,Tick,2196,2174,22,-22,151800,152300,30498,-114798,-121398,OK
381.210034,TraderOne,Tick,2196,2174,22,-22,151800,152300,30498,-114798,-121398,OK
381.497315,TraderOne,Tick,2196,2174,22,-22,151800,152300,30498,-114798,-121398,OK
381.702353,TraderOne,Tick,2196,2184,12,-12,152900,152300,30346,-116646,-113046,OK
382.025878,TraderOne,Tick,2203,2184,19,-19,152300,152500,30239,-115839,-119639,OK
382.299837,TraderOne,Tick,2203,2184,19,-19,152300,152500,30239,-115839,-119639,OK
382.510915,TraderOne,Tick,2203,2184,19,-19,152300,152500,30239,-115839,-119639,OK
382.715597,TraderOne,Tick,2203,2184,19,-19,152300,152500,30239,-115839,-119639,OK
382.996427,TraderOne,Tick,2203,2184,19,-19,152300,152500,30239,-115839,-119639,OK
383.28647,TraderOne,Tick,2203,2184,19,-19,152300,152500,30239,-115839,-119639,OK
383.53927,TraderOne,Tick,2203,2194,9,-9,152900,152500,30087,-117687,-114987,OK
383.716138,TraderOne,Tick,2203,2204,-1,1,152900,152500,30393,-115993,-116293,OK
384.047224,TraderOne,Tick,2203,2211,-8,8,152900,152500,30607,-114107,-116507,OK
384.22066,TraderOne,Tick,2203,2211,-8,8,152900,152500,30607,-114107,-116507,OK
384.496637,TraderOne,Tick,2203,2211,-8,8,152900,152500,30607,-114107,-116507,OK
384.707275,TraderOne,Tick,2203,2211,-8,8,152900,152500,30607,-114107,-116507,OK
384.981026,TraderOne,Tick,2203,2211,-8,8,152900,152500,30607,-114107,-116507,OK
385.210898,TraderOne,Tick,2203,2211,-8,8,152900,152500,30607,-114107,-116507,OK
385.546124,TraderOne,Tick,2213,2211,2,-2,152200,152500,30454,-115954,-116554,OK
385.79569,TraderOne,Tick,2213,2211,2,-2,152200,152500,30454,-115954,-116554,OK
386.034272,TraderOne,Tick,2213,2211,2,-2,152200,152500,30454,-115954,-116554,OK
386.266243,TraderOne,Tick,2213,2211,2,-2,152200,152500,30454,-115954,-116554,OK
386.550977,TraderOne,Tick,2213,2211,2,-2,151800,152500,30454,-115954,-116554,OK
386.72384,TraderOne,Tick,2213,2211,2,-2,151800,152500,30454,-115954,-116554,OK
386.96037,TraderOne,Tick,2213,2211,2,-2,151800,152500,30454,-115954,-116554,OK
387.236234,TraderOne,Tick,2213,2211,2,-2,151800,152300,30454,-115954,-116554,OK
387.457035,TraderOne,Tick,2213,2221,-8,8,152900,152300,30302,-115802,-118202,OK
387.768242,TraderOne,Tick,2213,2221,-8,8,152900,152300,30302,-115802,-118202,OK
387.976709,TraderOne,Tick,2213,2221,-8,8,152900,152300,30302,-115802,-118202,OK
388.273555,TraderOne,Tick,2213,2221,-8,8,152900,152300,30302,-115802,-118202,OK
388.522208,TraderOne,Tick,2223,2221,2,-2,151700,152200,30150,-115650,-116250,OK
388.759674,TraderOne,Tick,2223,2221,2,-2,151700,152200,30150,-115650,-116250,OK
388.976987,TraderOne,Tick,2223,2221,2,-2,151700,152200,30150,-115650,-116250,OK
389.281305,TraderOne,Tick,2223,2231,-8,8,152900,152400,29998,-116498,-118898,OK
389.537495,TraderOne,Tick,2223,2231,-8,8,152900,152400,29998,-116498,-118898,OK
389.79593,TraderOne,Tick,2223,2231,-8,8,152900,152400,29998,-116498,-118898,OK
390.027066,TraderOne,Tick,2223,2231,-8,8,152900,152200,29998,-116498,-118898,OK
390.210123,TraderOne,Tick,2223,2231,-8,8,152900,152200,29998,-116498,-118898,OK
390.486457,TraderOne,Tick,2223,2231,-8,8,152900,152200,29998,-116498,-118898,OK
390.743629,TraderOne,Tick,2223,2231,-8,8,152900,152100,29998,-116498,-118898,OK
391.024843,TraderOne,Tick,2223,2231,-8,8,152900,152100,29998,-116498,-118898,OK
391.237356,TraderOne,Tick,2223,2231,-8,8,152900,152100,29998,-116498,-118898,OK
391.488648,TraderOne,Tick,2223,2231,-8,8,152900,152100,29998,-116498,-118898,OK
391.743793,TraderOne,Tick,2223,2231,-8,8,152900,152100,29998,-116498,-118898,OK
392.051522,TraderOne,Tick,2223,2231,-8,8,152900,152100,29998,-116498,-118898,OK
392.226076,TraderOne,Tick,2223,2231,-8,8,152900,152100,29998,-116498,-118898,OK
392.450655,TraderOne,Tick,2223,2231,-8,8,152900,152100,29998,-116498,-118898,OK
392.78134,TraderOne,Tick,2223,2231,-8,8,152900,152100,29998,-116498,-118898,OK
393.040053,TraderOne,Tick,2223,2251,-28,28,152700,152200,30151,-112651,-121051,OK
393.257677,TraderOne,Tick,2223,2261,-38,38,152700,152200,30456,-109956,-121356,OK
393.504473,TraderOne,Tick,2223,2261,-38,38,152700,152200,30456,-109956,-121356,OK
393.709859,TraderOne,Tick,2223,2261,-38,38,152700,152500,30456,-109956,-117556,OK
394.041696,TraderOne,Tick,2223,2261,-38,38,152700,152500,30456,-109956,-117556,OK
394.267637,TraderOne,Tick,2223,2261,-38,38,152700,152400,30456,-109956,-121356,OK
394.498989,TraderOne,Tick,2223,2261,-38,38,152700,152400,30456,-109956,-121356,OK
394.733126,TraderOne,Tick,2223,2261,-38,38,152700,152400,30456,-109956,-121356,OK
395.030389,TraderOne,Tick,2229,2271,-42,42,152900,152400,30211,-108111,-120711,OK
395.257701,TraderOne,Tick,2229,2271,-42,42,152900,152400,30211,-108111,-120711,OK
395.503492,TraderOne,Tick,2229,2271,-42,42,152900,152400,30211,-108111,-120711,OK
395.79944,TraderOne,Tick,2239,2271,-32,32,152300,152300,30058,-112958,-112958,OK
396.002555,TraderOne,Tick,2249,2271,-22,22,151900,152300,30362,-110262,-103662,OK
396.275647,TraderOne,Tick,2249,2271,-22,22,151900,152300,30362,-110262,-103662,OK
396.527508,TraderOne,Tick,2249,2271,-22,22,151900,152300,30362,-110262,-103662,OK
396.773665,TraderOne,Tick,2249,2271,-22,22,151900,152300,30362,-110262,-103662,OK
396.965262,TraderOne,Tick,2249,2271,-22,22,151900,151700,30362,-110262,-114662,OK
397.211604,TraderOne,Tick,2249,2271,-22,22,151900,151400,30362,-110262,-116862,OK
397.488472,TraderOne,Tick,2249,2281,-32,32,151900,151400,30666,-105566,-115166,OK
397.725027,TraderOne,Tick,2249,2291,-42,42,151800,151400,30970,-100870,-113470,OK
397.953901,TraderOne,Tick,2249,2291,-42,42,151800,151400,30970,-100870,-113470,OK
398.235415,TraderOne,Tick,2249,2291,-42,42,151800,151400,30970,-100870,-113470,OK
398.464645,TraderOne,Tick,2259,2291,-32,32,151600,151100,30818,-106718,-116318,OK
398.782629,TraderOne,Tick,2259,2291,-32,32,151600,151100,30818,-106718,-116318,OK
398.976357,TraderOne,Tick,2259,2291,-32,32,151600,151100,30818,-106718,-116318,OK
399.282334,TraderOne,Tick,2259,2291,-32,32,151600,151200,30818,-106718,-116318,OK
399.548898,TraderOne,Tick,2259,2291,-32,32,151400,151200,30818,-106718,-113118,OK
399.705368,TraderOne,Tick,2259,2291,-32,32,151400,151200,30818,-106718,-113118,OK
400.030287,TraderOne,Tick,2259,2291,-32,32,151400,151200,30818,-106718,-113118,OK
400.247869,TraderOne,Tick,2259,2291,-32,32,151400,151200,30818,-106718,-113118,OK
400.498117,TraderOne,Tick,2259,2291,-32,32,151400,151200,30818,-106718,-113118,OK
400.751778,TraderOne,Tick,2259,2291,-32,32,151400,151000,30818,-106718,-116318,OK
401.015616,TraderOne,Tick,2259,2291,-32,32,151400,151000,30818,-106718,-116318,OK
401.295785,TraderOne,Tick,2259,2291,-32,32,151300,151000,30818,-106718,-116318,OK
401.504661,TraderOne,Tick,2259,2291,-32,32,151300,151000,30818,-106718,-116318,OK
401.79073,TraderOne,Tick,2269,2291,-22,22,151300,151000,30667,-110567,-117167,OK
402.040152,TraderOne,Tick,2269,2291,-22,22,151300,151000,30667,-110567,-117167,OK
402.225774,TraderOne,Tick,2269,2301,-32,32,151300,150900,30970,-107870,-117470,OK
402.502402,TraderOne,Tick,2269,2311,-42,42,151400,150900,31273,-104173,-116773,OK
402.726837,TraderOne,Tick,2269,2321,-52,52,151300,150900,31576,-99476,-115076,OK
402.978686,TraderOne,Tick,2269,2321,-52,52,151300,150900,31576,-99476,-115076,OK
403.282276,TraderOne,Tick,2269,2321,-52,52,151400,150900,31576,-99476,-115076,OK
403.495153,TraderOne,Tick,2269,2321,-52,52,151400,150900,31576,-99476,-115076,OK
403.783755,TraderOne,Tick,2269,2321,-52,52,151400,150900,31576,-99476,-115076,OK
403.969852,TraderOne,Tick,2269,2321,-52,52,151400,150900,31576,-99476,-115076,OK
404.298361,TraderOne,Tick,2269,2321,-52,52,151400,150900,31576,-99476,-115076,OK
404.527128,TraderOne,Tick,2269,2321,-52,52,151400,150900,31576,-99476,-115076,OK
404.704324,TraderOne,Tick,2269,2321,-52,52,151400,150900,31576,-99476,-115076,OK
405.033977,TraderOne,Tick,2269,2321,-52,52,151400,150900,31576,-99476,-115076,OK
405.284847,TraderOne,Tick,2269,2321,-52,52,151400,150900,31576,-99476,-115076,OK
405.542242,TraderOne,Tick,2279,2321,-42,42,151300,151000,31425,-105325,-117925,OK
405.796045,TraderOne,Tick,2279,2321,-42,42,151300,151000,31425,-105325,-117925,OK
406.0236,TraderOne,Tick,2279,2321,-42,42,151300,151000,31425,-105325,-117925,OK
406.212344,TraderOne,Tick,2279,2321,-42,42,151300,151000,31425,-105325,-117925,OK
406.505181,TraderOne,Tick,2279,2321,-42,42,151300,151000,31425,-105325,-117925,OK
406.787433,TraderOne,Tick,2279,2331,-52,52,151400,151000,31728,-101628,-117228,OK
406.992679,TraderOne,Tick,2279,2331,-52,52,151400,151000,31728,-101628,-117228,OK
407.213642,TraderOne,Tick,2279,2331,-52,52,151400,151000,31728,-101628,-117228,OK
407.476218,TraderOne,Tick,2289,2331,-42,42,151200,151000,31577,-109477,-117877,OK
407.736503,TraderOne,Tick,2289,2341,-52,52,151200,150500,31879,-104779,-120379,OK
408.027463,TraderOne,Tick,2289,2341,-52,52,151100,150500,31879,-104779,-120379,OK
408.215368,TraderOne,Tick,2289,2351,-62,62,151000,150500,32181,-99081,-117681,OK
408.544239,TraderOne,Tick,2299,2351,-52,52,150900,150500,32030,-105930,-121530,OK
408.788774,TraderOne,Tick,2299,2351,-52,52,150900,150500,32030,-105930,-121530,OK
408.992435,TraderOne,Tick,2299,2351,-52,52,150700,150500,32030,-105930,-116330,OK
409.285329,TraderOne,Tick,2309,2351,-42,42,150700,150500,32331,-112231,-120631,OK
409.55188,TraderOne,Tick,2309,2351,-42,42,150700,150000,32331,-112231,-124831,OK
409.784555,TraderOne,Tick,2309,2361,-52,52,150600,150000,32632,-107532,-123132,OK
410.024667,TraderOne,Tick,2309,2361,-52,52,150600,150000,32632,-107532,-123132,OK
410.200655,TraderOne,Tick,2309,2361,-52,52,150600,150000,32632,-107532,-123132,OK
410.497082,TraderOne,Tick,2309,2361,-52,52,150600,150000,32632,-107532,-123132,OK
410.758826,TraderOne,Tick,2309,2361,-52,52,150600,150000,32632,-107532,-123132,OK
411.024559,TraderOne,Tick,2309,2361,-52,52,150600,149900,32632,-107532,-123132,OK
411.269132,TraderOne,Tick,2309,2361,-52,52,150600,149900,32632,-107532,-123132,OK
411.525179,TraderOne,Tick,2309,2361,-52,52,150600,150000,32632,-107532,-123132,OK
411.727265,TraderOne,Tick,2319,2361,-42,42,150200,150100,32482,-113382,-117582,OK
412.024132,TraderOne,Tick,2319,2361,-42,42,150200,150100,32482,-113382,-117582,OK
412.244566,TraderOne,Tick,2329,2361,-32,32,150200,150100,32332,-118232,-121432,OK
412.508814,TraderOne,Tick,2339,2371,-32,32,150500,150100,32032,-117932,-127532,OK
412.775783,TraderOne,Tick,2339,2371,-32,32,150500,150000,32032,-117932,-127532,OK
413.040683,TraderOne,Tick,2339,2371,-32,32,150500,150000,32032,-117932,-127532,OK
413.235369,TraderOne,Tick,2339,2371,-32,32,150500,150000,32032,-117932,-127532,OK
413.523728,TraderOne,Tick,2339,2381,-42,42,150500,150000,31882,-113782,-126382,OK
413.741461,TraderOne,Tick,2339,2381,-42,42,150500,150000,31882,-113782,-126382,OK
414.003977,TraderOne,Tick,2339,2381,-42,42,150500,150000,31882,-113782,-126382,OK
414.223983,TraderOne,Tick,2349,2381,-32,32,150400,150000,31732,-119632,-129232,OK
414.501989,TraderOne,Tick,2349,2381,-32,32,150400,150000,31732,-119632,-129232,OK
414.73806,TraderOne,Tick,2349,2381,-32,32,150400,150000,31732,-119632,-129232,OK
415.019881,TraderOne,Tick,2359,2381,-22,22,150000,150000,31582,-123482,-123482,OK
415.278439,TraderOne,Tick,2369,2381,-12,12,150200,150000,31882,-126782,-129182,OK
415.4918,TraderOne,Tick,2369,2381,-12,12,150200,150000,31882,-126782,-129182,OK
415.778669,TraderOne,Tick,2369,2381,-12,12,150200,150000,31882,-126782,-129182,OK
416.008355,TraderOne,Tick,2369,2381,-12,12,150200,150000,31882,-126782,-129182,OK
416.270631,TraderOne,Tick,2369,2381,-12,12,150200,150000,31882,-126782,-129182,OK
416.529181,TraderOne,Tick,2369,2381,-12,12,150200,150000,31882,-126782,-129182,OK
416.784676,TraderOne,Tick,2369,2381,-12,12,150200,150000,31882,-126782,-129182,OK
417.004124,TraderOne,Tick,2369,2391,-22,22,150700,150000,31732,-124632,-131232,OK
417.262891,TraderOne,Tick,2369,2391,-22,22,150700,150000,31732,-124632,-131232,OK
417.517898,TraderOne,Tick,2369,2391,-22,22,150700,150000,31732,-124632,-131232,OK
417.725961,TraderOne,Tick,2369,2391,-22,22,150700,150000,31732,-124632,-131232,OK
418.021095,TraderOne,Tick,2369,2391,-22,22,150700,150000,31732,-124632,-131232,OK
418.221104,TraderOne,Tick,2369,2391,-22,22,150700,150000,31732,-124632,-131232,OK
418.491113,TraderOne,Tick,2369,2391,-22,22,150700,150200,31732,-124632,-131232,OK
418.750169,TraderOne,Tick,2369,2391,-22,22,150700,150300,31732,-124632,-131232,OK
418.958871,TraderOne,Tick,2369,2391,-22,22,150700,150300,31732,-124632,-131232,OK
419.223394,TraderOne,Tick,2369,2391,-22,22,150700,150300,31732,-124632,-131232,OK
419.490916,TraderOne,Tick,2369,2391,-22,22,150700,150300,31732,-124632,-131232,OK
419.776632,TraderOne,Tick,2369,2391,-22,22,150700,150300,31732,-124632,-131232,OK
420.016077,TraderOne,Tick,2369,2391,-22,22,150700,150300,31732,-124632,-131232,OK
420.294739,TraderOne,Tick,2369,2391,-22,22,150700,150300,31732,-124632,-131232,OK
420.483457,TraderOne,Tick,2369,2391,-22,22,150700,150300,31732,-124632,-131232,OK
420.721662,TraderOne,Tick,2369,2391,-22,22,150700,150300,31732,-124632,-131232,OK
420.991793,TraderOne,Tick,2369,2391,-22,22,150700,150300,31732,-124632,-131232,OK
421.281371,TraderOne,Tick,2369,2391,-22,22,150700,150300,31732,-124632,-131232,OK
421.536892,TraderOne,Tick,2369,2391,-22,22,150700,149900,31732,-124632,-131232,OK
421.748768,TraderOne,Tick,2369,2391,-22,22,150700,149900,31732,-124632,-131232,OK
422.012524,TraderOne,Tick,2379,2391,-12,12,150000,149900,31582,-126482,-127682,OK
422.260522,TraderOne,Tick,2379,2391,-12,12,150000,149900,31582,-126482,-127682,OK
422.528362,TraderOne,Tick,2389,2391,-2,2,150000,149900,31432,-130332,-130532,OK
422.753162,TraderOne,Tick,2389,2401,-12,12,150000,149900,31732,-129632,-130832,OK
423.003301,TraderOne,Tick,2389,2401,-12,12,150000,149900,31732,-129632,-130832,OK
423.267035,TraderOne,Tick,2389,2401,-12,12,150000,149900,31732,-129632,-130832,OK
423.456855,TraderOne,Tick,2389,2401,-12,12,150000,149900,31732,-129632,-130832,OK
423.783268,TraderOne,Tick,2389,2411,-22,22,150500,149900,31582,-127482,-134082,OK
424.047539,TraderOne,Tick,2389,2411,-22,22,150500,149900,31582,-127482,-134082,OK
424.205172,TraderOne,Tick,2389,2411,-22,22,150500,149900,31582,-127482,-134082,OK
424.496981,TraderOne,Tick,2389,2411,-22,22,150000,149900,31582,-127482,-129682,OK
424.783233,TraderOne,Tick,2389,2411,-22,22,150000,149900,31582,-127482,-129682,OK
425.049083,TraderOne,Tick,2389,2421,-32,32,150000,149500,31882,-124782,-131182,OK
425.2775,TraderOne,Tick,2389,2431,-42,42,150000,149500,32092,-121992,-130392,OK
425.53404,TraderOne,Tick,2389,2431,-42,42,149900,149500,32092,-121992,-130392,OK
425.793191,TraderOne,Tick,2399,2431,-32,32,150100,149700,32392,-127292,-133692,OK
426.009431,TraderOne,Tick,2399,2431,-32,32,150100,149700,32392,-127292,-133692,OK
426.214778,TraderOne,Tick,2399,2431,-32,32,150100,149800,32392,-127292,-136892,OK
426.488882,TraderOne,Tick,2399,2431,-32,32,150100,149800,32392,-127292,-136892,OK
426.70433,TraderOne,Tick,2405,2431,-26,26,150000,149800,32302,-128402,-133602,OK
427.026021,TraderOne,Tick,2409,2433,-24,24,150300,149800,32392,-129292,-136492,OK
427.22383,TraderOne,Tick,2409,2433,-24,24,150300,149800,32392,-129292,-136492,OK
427.503618,TraderOne,Tick,2409,2433,-24,24,150300,149800,32392,-129292,-136492,OK
427.72594,TraderOne,Tick,2409,2433,-24,24,150300,149800,32392,-129292,-136492,OK
428.009526,TraderOne,Tick,2409,2433,-24,24,150300,149800,32392,-129292,-136492,OK
428.243581,TraderOne,Tick,2409,2443,-34,34,150400,149800,32242,-126142,-136342,OK
428.532624,TraderOne,Tick,2419,2443,-24,24,149900,149800,32092,-131992,-134392,OK
428.770217,TraderOne,Tick,2419,2443,-24,24,149900,149800,32092,-131992,-134392,OK
429.012528,TraderOne,Tick,2419,2443,-24,24,149900,149800,32092,-131992,-134392,OK
429.210276,TraderOne,Tick,2419,2443,-24,24,149900,149800,32092,-131992,-134392,OK
429.470796,TraderOne,Tick,2419,2443,-24,24,149900,149800,32092,-131992,-134392,OK
429.799759,TraderOne,Tick,2419,2443,-24,24,149900,149800,32092,-131992,-134392,OK
430.050612,TraderOne,Tick,2419,2443,-24,24,149900,149600,32092,-131992,-136792,OK
430.209546,TraderOne,Tick,2419,2453,-34,34,150200,149600,31942,-126842,-133642,OK
430.456179,TraderOne,Tick,2419,2453,-34,34,150200,149600,31942,-126842,-133642,OK
430.753739,TraderOne,Tick,2419,2453,-34,34,149800,149600,31942,-126842,-133642,OK
430.98088,TraderOne,Tick,2419,2453,-34,34,149800,149600,31942,-126842,-133642,OK
431.212383,TraderOne,Tick,2419,2453,-34,34,149800,149600,31942,-126842,-133642,OK
431.473903,TraderOne,Tick,2419,2453,-34,34,149800,149600,31942,-126842,-133642,OK
431.75934,TraderOne,Tick,2419,2453,-34,34,149800,149700,31942,-126842,-130242,OK
431.953162,TraderOne,Tick,2419,2453,-34,34,149800,149700,31942,-126842,-130242,OK
432.204829,TraderOne,Tick,2419,2453,-34,34,149800,149700,31942,-126842,-130242,OK
432.509862,TraderOne,Tick,2429,2453,-24,24,149900,149700,31792,-130692,-135492,OK
432.752144,TraderOne,Tick,2429,2463,-34,34,149800,149700,32092,-126292,-129692,OK
433.048366,TraderOne,Tick,2429,2473,-44,44,149800,149500,32392,-124592,-133392,OK
433.287756,TraderOne,Tick,2429,2473,-44,44,149800,149500,32392,-124592,-133392,OK
433.484573,TraderOne,Tick,2429,2473,-44,44,149800,149500,32392,-124592,-133392,OK
433.774727,TraderOne,Tick,2429,2473,-44,44,149800,149500,32392,-124592,-133392,OK
433.959708,TraderOne,Tick,2429,2473,-44,44,150000,149300,32392,-124592,-133392,OK
434.295832,TraderOne,Tick,2429,2473,-44,44,149600,149300,32392,-124592,-133392,OK
434.462907,TraderOne,Tick,2439,2473,-34,34,149600,149000,32242,-130442,-137242,OK
434.751644,TraderOne,Tick,2439,2473,-34,34,149600,149000,32242,-130442,-137242,OK
435.011597,TraderOne,Tick,2439,2473,-34,34,149600,149000,32242,-130442,-137242,OK
435.275659,TraderOne,Tick,2439,2473,-34,34,149600,149300,32242,-130442,-137242,OK
435.49783,TraderOne,Tick,2439,2473,-34,34,149600,149300,32242,-130442,-137242,OK
435.734639,TraderOne,Tick,2439,2473,-34,34,149600,149300,32242,-130442,-137242,OK
436.0434,TraderOne,Tick,2439,2473,-34,34,149600,149300,32242,-130442,-137242,OK
436.209579,TraderOne,Tick,2439,2473,-34,34,149600,149300,32242,-130442,-137242,OK
436.456282,TraderOne,Tick,2439,2473,-34,34,149600,149300,32242,-130442,-137242,OK
436.787712,TraderOne,Tick,2439,2473,-34,34,149600,149300,32242,-130442,-137242,OK
437.009981,TraderOne,Tick,2439,2473,-34,34,149600,149300,32242,-130442,-137242,OK
437.20753,TraderOne,Tick,2439,2473,-34,34,149600,149300,32242,-130442,-137242,OK
437.4559,TraderOne,Tick,2439,2473,-34,34,149600,149300,32242,-130442,-137242,OK
437.798177,TraderOne,Tick,2439,2473,-34,34,149600,149300,32242,-130442,-137242,OK
437.957662,TraderOne,Tick,2439,2473,-34,34,149600,149300,32242,-130442,-137242,OK
438.240978,TraderOne,Tick,2439,2473,-34,34,149600,149300,32242,-130442,-137242,OK
438.52591,TraderOne,Tick,2449,2473,-24,24,149400,149300,32092,-133292,-135692,OK
438.716424,TraderOne,Tick,2449,2473,-24,24,149400,149300,32092,-133292,-135692,OK
438.9729,TraderOne,Tick,2449,2473,-24,24,149400,149300,32092,-133292,-135692,OK
439.241846,TraderOne,Tick,2449,2473,-24,24,149400,149500,32092,-133292,-130892,OK
439.527757,TraderOne,Tick,2459,2473,-14,14,149700,149500,32391,-136591,-139391,OK
439.76197,TraderOne,Tick,2459,2473,-14,14,149700,149500,32391,-136591,-139391,OK
440.03176,TraderOne,Tick,2459,2473,-14,14,149700,149300,32391,-136591,-139391,OK
440.297233,TraderOne,Tick,2459,2473,-14,14,149700,149300,32391,-136591,-139391,OK
440.491986,TraderOne,Tick,2459,2473,-14,14,149700,149300,32391,-136591,-139391,OK
440.810248,TraderOne,Tick,2459,2473,-14,14,149700,149700,32391,-136591,-136591,OK
440.963224,TraderOne,Tick,2469,2473,-4,4,149700,149700,32690,-138890,-138890,OK
441.281181,TraderOne,Tick,2469,2473,-4,4,149700,149700,32690,-138890,-138890,OK
441.52684,TraderOne,Tick,2469,2473,-4,4,149700,149700,32690,-138890,-138890,OK
441.728253,TraderOne,Tick,2469,2473,-4,4,149700,149700,32690,-138890,-138890,OK
442.023252,TraderOne,Tick,2469,2473,-4,4,149700,149700,32690,-138890,-138890,OK
442.291541,TraderOne,Tick,2469,2473,-4,4,149700,149700,32690,-138890,-138890,OK
442.517223,TraderOne,Tick,2469,2483,-14,14,149400,149700,32989,-138189,-135389,OK
442.749027,TraderOne,Tick,2479,2483,-4,4,149700,149700,33288,-140488,-140488,OK
442.996695,TraderOne,Tick,2479,2483,-4,4,149700,149700,33288,-140488,-140488,OK
443.206785,TraderOne,Tick,2479,2483,-4,4,149700,149700,33288,-140488,-140488,OK
443.473767,TraderOne,Tick,2479,2483,-4,4,149700,149700,33288,-140488,-140488,OK
443.787178,TraderOne,Tick,2479,2493,-14,14,149300,149700,33587,-139787,-136987,OK
443.996969,TraderOne,Tick,2479,2493,-14,14,149300,149700,33587,-139787,-136987,OK
444.233818,TraderOne,Tick,2479,2493,-14,14,149300,149700,33587,-139787,-136987,OK
444.50124,TraderOne,Tick,2479,2493,-14,14,149300,149200,33587,-139787,-141187,OK
444.727258,TraderOne,Tick,2479,2493,-14,14,149300,149200,33587,-139787,-141187,OK
444.983609,TraderOne,Tick,2479,2493,-14,14,149300,149200,33587,-139787,-141187,OK
445.241828,TraderOne,Tick,2479,2493,-14,14,149300,149300,33587,-139787,-139787,OK
445.513474,TraderOne,Tick,2479,2493,-14,14,149300,149300,33587,-139787,-139787,OK
445.748639,TraderOne,Tick,2479,2493,-14,14,149300,149300,33587,-139787,-139787,OK
445.990197,TraderOne,Tick,2479,2493,-14,14,149300,149300,33587,-139787,-139787,OK
446.297332,TraderOne,Tick,2479,2493,-14,14,149300,149300,33587,-139787,-139787,OK
446.502001,TraderOne,Tick,2479,2503,-24,24,149300,148800,33886,-138086,-142886,OK
446.800669,TraderOne,Tick,2479,2513,-34,34,149300,148900,34185,-134385,-141185,OK
447.050426,TraderOne,Tick,2479,2513,-34,34,149300,148900,34185,-134385,-141185,OK
447.237705,TraderOne,Tick,2479,2513,-34,34,149300,148900,34185,-134385,-141185,OK
447.497708,TraderOne,Tick,2479,2513,-34,34,149300,148900,34185,-134385,-141185,OK
447.719751,TraderOne,Tick,2479,2513,-34,34,149300,148900,34185,-134385,-141185,OK
447.960329,TraderOne,Tick,2479,2513,-34,34,149300,148900,34185,-134385,-141185,OK
448.292891,TraderOne,Tick,2479,2513,-34,34,149300,148900,34185,-134385,-141185,OK
448.467537,TraderOne,Tick,2479,2523,-44,44,149300,148900,34484,-130684,-139484,OK
448.771689,TraderOne,Tick,2479,2523,-44,44,149300,148900,34484,-130684,-139484,OK
449.025287,TraderOne,Tick,2479,2523,-44,44,149300,149000,34484,-130684,-139484,OK
449.235573,TraderOne,Tick,2479,2523,-44,44,149300,149000,34484,-130684,-139484,OK
449.535211,TraderOne,Tick,2479,2523,-44,44,149300,149000,34484,-130684,-139484,OK
449.796445,TraderOne,Tick,2479,2523,-44,44,149300,149000,34484,-130684,-139484,OK
450.010771,TraderOne,Tick,2479,2523,-44,44,149300,149000,34484,-130684,-139484,OK
450.259126,TraderOne,Tick,2479,2523,-44,44,149300,149000,34484,-130684,-139484,OK
450.523396,TraderOne,Tick,2483,2523,-40,40,149600,149000,34424,-132624,-140624,OK
450.731053,TraderOne,Tick,2483,2523,-40,40,149600,149000,34424,-132624,-140624,OK
451.03122,TraderOne,Tick,2483,2533,-50,50,149600,149000,34723,-128923,-138923,OK
451.291032,TraderOne,Tick,2483,2533,-50,50,149600,149000,34723,-128923,-138923,OK
451.541393,TraderOne,Tick,2483,2533,-50,50,149600,149000,34723,-128923,-138923,OK
451.733347,TraderOne,Tick,2493,2533,-40,40,149100,149200,34573,-133773,-129773,OK
452.033715,TraderOne,Tick,2503,2533,-30,30,149700,149200,34872,-137072,-143072,OK
452.229887,TraderOne,Tick,2503,2533,-30,30,149700,149200,34872,-137072,-143072,OK
452.519028,TraderOne,Tick,2503,2533,-30,30,149700,149300,34872,-137072,-143072,OK
452.740652,TraderOne,Tick,2503,2533,-30,30,149700,149300,34872,-137072,-143072,OK
452.996225,TraderOne,Tick,2503,2543,-40,40,149800,149300,34722,-133922,-141922,OK
453.259898,TraderOne,Tick,2503,2543,-40,40,149800,149300,34722,-133922,-141922,OK
453.525853,TraderOne,Tick,2503,2543,-40,40,149800,149300,34722,-133922,-141922,OK
453.775047,TraderOne,Tick,2503,2543,-40,40,149800,149300,34722,-133922,-141922,OK
454.013007,TraderOne,Tick,2503,2543,-40,40,149800,149300,34722,-133922,-141922,OK
454.251884,TraderOne,Tick,2503,2543,-40,40,149800,149300,34722,-133922,-141922,OK
454.48541,TraderOne,Tick,2513,2543,-30,30,149100,149000,34572,-137772,-140772,OK
454.784974,TraderOne,Tick,2513,2543,-30,30,149100,149000,34572,-137772,-140772,OK
454.969703,TraderOne,Tick,2513,2543,-30,30,149100,149000,34572,-137772,-140772,OK
455.30125,TraderOne,Tick,2513,2543,-30,30,149100,149000,34572,-137772,-140772,OK
455.457366,TraderOne,Tick,2513,2543,-30,30,149100,149000,34572,-137772,-140772,OK
455.731615,TraderOne,Tick,2513,2543,-30,30,149100,149100,34572,-137772,-137772,OK
456.004625,TraderOne,Tick,2513,2543,-30,30,149100,149100,34572,-137772,-137772,OK
456.205585,TraderOne,Tick,2513,2543,-30,30,149100,149100,34572,-137772,-137772,OK
456.48843,TraderOne,Tick,2513,2543,-30,30,149100,149100,34572,-137772,-137772,OK
456.761719,TraderOne,Tick,2513,2543,-30,30,149100,149200,34572,-137772,-134772,OK
457.01129,TraderOne,Tick,2513,2543,-30,30,149100,149200,34572,-137772,-134772,OK
457.203768,TraderOne,Tick,2513,2543,-30,30,149100,149300,34572,-137772,-131772,OK
457.506763,TraderOne,Tick,2513,2543,-30,30,149100,149300,34572,-137772,-131772,OK
457.785552,TraderOne,Tick,2513,2543,-30,30,149100,149300,34572,-137772,-131772,OK
457.991841,TraderOne,Tick,2513,2543,-30,30,149100,149300,34572,-137772,-131772,OK
458.274464,TraderOne,Tick,2513,2543,-30,30,149100,149300,34572,-137772,-131772,OK
458.46677,TraderOne,Tick,2513,2543,-30,30,149100,149300,34572,-137772,-131772,OK
458.75215,TraderOne,Tick,2513,2543,-30,30,149100,149500,34572,-137772,-131772,OK
458.993445,TraderOne,Tick,2513,2543,-30,30,149100,149500,34572,-137772,-131772,OK
459.279607,TraderOne,Tick,2513,2543,-30,30,149100,149500,34572,-137772,-131772,OK
459.549755,TraderOne,Tick,2513,2543,-30,30,149100,149500,34572,-137772,-131772,OK
459.774979,TraderOne,Tick,2513,2543,-30,30,149100,149500,34572,-137772,-131772,OK
460.015805,TraderOne,Tick,2513,2543,-30,30,149100,149500,34572,-137772,-131772,OK
460.220178,TraderOne,Tick,2513,2543,-30,30,149100,149500,34572,-137772,-131772,OK
460.519532,TraderOne,Tick,2513,2543,-30,30,149100,149500,34572,-137772,-131772,OK
460.75562,TraderOne,Tick,2513,2543,-30,30,149100,149500,34572,-137772,-131772,OK
460.989094,TraderOne,Tick,2513,2543,-30,30,149100,149500,34572,-137772,-131772,OK
461.22553,TraderOne,Tick,2513,2543,-30,30,149100,149500,34572,-137772,-131772,OK
461.518329,TraderOne,Tick,2513,2543,-30,30,149100,149500,34572,-137772,-131772,OK
461.785192,TraderOne,Tick,2513,2543,-30,30,149100,149500,34572,-137772,-131772,OK
462.039234,TraderOne,Tick,2513,2543,-30,30,149100,149500,34572,-137772,-131772,OK
462.294532,TraderOne,Tick,2523,2543,-20,20,149100,149500,34422,-142622,-138622,OK
462.515288,TraderOne,Tick,2523,2543,-20,20,149100,149500,34422,-142622,-138622,OK
462.712127,TraderOne,Tick,2523,2543,-20,20,149100,149500,34422,-142622,-138622,OK
462.988269,TraderOne,Tick,2523,2543,-20,20,149100,149500,34422,-142622,-138622,OK
463.233131,TraderOne,Tick,2533,2543,-10,10,149100,149200,34272,-146472,-145472,OK
463.483466,TraderOne,Tick,2533,2543,-10,10,149100,148900,34272,-146472,-148472,OK
463.733264,TraderOne,Tick,2533,2553,-20,20,149100,149000,34570,-145770,-147770,OK
464.045869,TraderOne,Tick,2543,2553,-10,10,149100,149000,34421,-148621,-149621,OK
464.24076,TraderOne,Tick,2543,2553,-10,10,149100,149000,34421,-148621,-149621,OK
464.469826,TraderOne,Tick,2543,2553,-10,10,149100,149000,34421,-148621,-149621,OK
464.793215,TraderOne,Tick,2543,2553,-10,10,149100,149000,34421,-148621,-149621,OK
464.973042,TraderOne,Tick,2543,2553,-10,10,149100,149000,34421,-148621,-149621,OK
465.236353,TraderOne,Tick,2543,2553,-10,10,149100,149000,34421,-148621,-149621,OK
465.543198,TraderOne,Tick,2543,2553,-10,10,149100,149100,34421,-148621,-148621,OK
465.763769,TraderOne,Tick,2553,2553,0,0,149000,149100,34272,-146472,-146472,OK
465.991023,TraderOne,Tick,2563,2553,10,-10,149300,149100,34571,-146771,-144771,OK
466.244263,TraderOne,Tick,2563,2553,10,-10,149300,149100,34571,-146771,-144771,OK
466.459689,TraderOne,Tick,2563,2553,10,-10,149300,149100,34571,-146771,-144771,OK
466.780142,TraderOne,Tick,2573,2553,20,-20,149000,149100,34422,-145622,-147622,OK
467.03541,TraderOne,Tick,2573,2553,20,-20,149000,149100,34422,-145622,-147622,OK
467.216266,TraderOne,Tick,2573,2553,20,-20,149000,149100,34422,-145622,-147622,OK
467.511115,TraderOne,Tick,2573,2553,20,-20,149000,149100,34422,-145622,-147622,OK
467.759572,TraderOne,Tick,2573,2563,10,-10,149100,149100,34720,-147920,-147920,OK
468.03259,TraderOne,Tick,2573,2563,10,-10,149000,149100,34720,-147920,-148920,OK
468.285271,TraderOne,Tick,2573,2573,0,0,149000,149100,35018,-149218,-149218,OK
468.53777,TraderOne,Tick,2573,2573,0,0,149000,149100,35018,-149218,-149218,OK
468.747516,TraderOne,Tick,2573,2573,0,0,149000,149100,35018,-149218,-149218,OK
469.013088,TraderOne,Tick,2573,2573,0,0,149300,149100,35018,-149218,-149218,OK
469.229599,TraderOne,Tick,2573,2573,0,0,149300,149100,35018,-149218,-149218,OK
469.530413,TraderOne,Tick,2573,2573,0,0,149300,149100,35018,-149218,-149218,OK
469.781144,TraderOne,Tick,2583,2573,10,-10,148900,149100,34869,-149069,-151069,OK
469.965337,TraderOne,Tick,2583,2573,10,-10,148900,149100,34869,-149069,-151069,OK
470.232574,TraderOne,Tick,2583,2583,0,-10,149300,149100,34720,1342080,-148920,OK
470.489547,TraderOne,Tick,2593,2583,10,-10,148900,149100,34571,-148771,-150771,OK
470.767963,TraderOne,Tick,2593,2583,10,-10,148900,149000,34571,-148771,-149771,OK
471.004034,TraderOne,Tick,2593,2583,10,-10,148900,149000,34571,-148771,-149771,OK
471.243575,TraderOne,Tick,2593,2583,10,-10,148900,149400,34571,-148771,-150771,OK
471.52284,TraderOne,Tick,2593,2583,10,-10,148900,149400,34571,-148771,-150771,OK
471.753556,TraderOne,Tick,2603,2583,20,-20,148900,149400,34422,-147622,-151622,OK
472.04569,TraderOne,Tick,2603,2593,10,-10,149900,149400,34273,-149473,-147473,OK
472.291388,TraderOne,Tick,2603,2593,10,-10,149900,149400,34273,-149473,-147473,OK
472.536782,TraderOne,Tick,2603,2603,0,0,149300,149400,34124,-151324,-151324,OK
472.71781,TraderOne,Tick,2603,2603,0,0,149300,149400,34124,-151324,-151324,OK
473.041684,TraderOne,Tick,2603,2603,0,0,149300,149400,34124,-151324,-151324,OK
473.298995,TraderOne,Tick,2603,2603,0,0,149300,149400,34124,-151324,-151324,OK
473.517737,TraderOne,Tick,2603,2603,0,0,149300,149400,34124,-151324,-151324,OK
473.706928,TraderOne,Tick,2603,2613,-10,10,149900,149400,33974,-152174,-154174,OK
473.981873,TraderOne,Tick,2603,2613,-10,10,149900,149400,33974,-152174,-154174,OK
474.236125,TraderOne,Tick,2603,2613,-10,10,149900,149400,33974,-152174,-154174,OK
474.466868,TraderOne,Tick,2603,2613,-10,10,149900,149400,33974,-152174,-154174,OK
474.727621,TraderOne,Tick,2613,2613,0,0,148900,149400,33824,-153024,-153024,OK
475.038362,TraderOne,Tick,2613,2613,0,0,148900,149400,33824,-153024,-153024,OK
475.245812,TraderOne,Tick,2613,2613,0,0,148900,149400,33824,-153024,-153024,OK
475.525682,TraderOne,Tick,2623,2613,10,-10,149400,149400,33675,-154875,-154875,OK
475.73623,TraderOne,Tick,2623,2613,10,-10,149400,149400,33675,-154875,-154875,OK
476.039694,TraderOne,Tick,2623,2613,10,-10,149400,149400,33675,-154875,-154875,OK
476.2257,TraderOne,Tick,2633,2613,20,-20,149300,149400,33974,-154174,-156174,OK
476.527712,TraderOne,Tick,2633,2613,20,-20,149300,149400,33974,-154174,-156174,OK
476.817442,TraderOne,Tick,2633,2613,20,-20,149300,149600,33974,-154174,-158174,OK
477.02236,TraderOne,Tick,2638,2613,25,-25,149300,149600,34123,-152823,-157823,OK
477.20906,TraderOne,Tick,2638,2613,25,-25,149300,149600,34123,-152823,-157823,OK
477.473381,TraderOne,Tick,2638,2613,25,-25,149300,149700,34123,-152823,-157823,OK
477.76071,TraderOne,Tick,2643,2613,30,-30,149000,149700,34048,-151748,-157748,OK
478.030864,TraderOne,Tick,2643,2613,30,-30,149000,149700,34048,-151748,-157748,OK
478.302029,TraderOne,Tick,2643,2613,30,-30,149000,149700,34048,-151748,-157748,OK
478.473827,TraderOne,Tick,2643,2613,30,-30,149000,149600,34048,-151748,-157748,OK
478.75635,TraderOne,Tick,2643,2613,30,-30,149000,149600,34048,-151748,-157748,OK
478.98237,TraderOne,Tick,2643,2613,30,-30,149000,149600,34048,-151748,-157748,OK
479.232852,TraderOne,Tick,2643,2613,30,-30,149000,149600,34048,-151748,-157748,OK
479.549588,TraderOne,Tick,2643,2613,30,-30,149000,149500,34048,-151748,-157748,OK
479.72634,TraderOne,Tick,2643,2613,30,-30,149000,149500,34048,-151748,-157748,OK
480.088883,TraderOne,Tick,2643,2613,30,-30,149000,149400,34048,-151748,-157748,OK
480.300444,TraderOne,Tick,2643,2613,30,-30,149000,149400,34048,-151748,-157748,OK
480.531145,TraderOne,Tick,2643,2613,30,-30,149000,149400,34048,-151748,-157748,OK
480.732854,TraderOne,Tick,2643,2613,30,-30,149000,149400,34048,-151748,-157748,OK
481.037213,TraderOne,Tick,2643,2613,30,-30,149000,149800,34048,-151748,-160748,OK
481.274433,TraderOne,Tick,2643,2613,30,-30,149000,149800,34048,-151748,-160748,OK
481.530154,TraderOne,Tick,2643,2613,30,-30,149000,150000,34048,-151748,-160748,OK
481.778443,TraderOne,Tick,2643,2623,20,-20,149900,150000,33898,-153598,-155598,OK
481.990224,TraderOne,Tick,2643,2623,20,-20,149900,150000,33898,-153598,-155598,OK
482.260591,TraderOne,Tick,2643,2623,20,-20,149900,150000,33898,-153598,-155598,OK
482.527765,TraderOne,Tick,2643,2623,20,-20,149900,150000,33898,-153598,-155598,OK
482.746421,TraderOne,Tick,2643,2623,20,-20,149900,150000,33898,-153598,-155598,OK
482.962694,TraderOne,Tick,2643,2623,20,-20,149900,150000,33898,-153598,-155598,OK
483.24625,TraderOne,Tick,2643,2623,20,-20,149900,150000,33898,-153598,-155598,OK
483.462431,TraderOne,Tick,2643,2623,20,-20,149900,150000,33898,-153598,-155598,OK
483.707538,TraderOne,Tick,2643,2623,20,-20,149900,150000,33898,-153598,-155598,OK
484.022165,TraderOne,Tick,2643,2623,20,-20,149900,150000,33898,-153598,-155598,OK
484.263292,TraderOne,Tick,2643,2623,20,-20,149900,150000,33898,-153598,-155598,OK
484.514215,TraderOne,Tick,2653,2623,30,-30,149900,150000,34198,-151898,-154898,OK
484.79665,TraderOne,Tick,2653,2623,30,-30,149900,150000,34198,-151898,-154898,OK
485.024819,TraderOne,Tick,2653,2623,30,-30,149900,150000,34198,-151898,-154898,OK
485.245892,TraderOne,Tick,2663,2623,40,-40,149500,150000,34048,-148748,-160748,OK
485.492959,TraderOne,Tick,2663,2623,40,-40,149500,150000,34048,-148748,-160748,OK
485.715425,TraderOne,Tick,2663,2633,30,-30,150000,150500,33898,-153598,-162598,OK
486.048599,TraderOne,Tick,2663,2633,30,-30,150000,150700,33898,-153598,-162598,OK
486.208283,TraderOne,Tick,2673,2633,40,-40,150300,150700,34198,-146898,-158898,OK
486.516325,TraderOne,Tick,2683,2633,50,-50,150400,151000,34499,-142199,-157199,OK
486.763391,TraderOne,Tick,2683,2633,50,-50,150500,150900,34499,-142199,-157199,OK
486.973271,TraderOne,Tick,2683,2633,50,-50,150500,150800,34499,-142199,-157199,OK
487.230215,TraderOne,Tick,2683,2643,40,-40,150400,151000,34800,-149500,-161500,OK
487.494878,TraderOne,Tick,2693,2643,50,-50,150500,150900,35101,-146801,-161801,OK
487.754099,TraderOne,Tick,2693,2643,50,-50,150500,150800,35101,-146801,-161801,OK
488.037697,TraderOne,Tick,2693,2643,50,-50,150500,150800,35101,-146801,-161801,OK
488.221715,TraderOne,Tick,2693,2643,50,-50,150500,150800,35101,-146801,-161801,OK
488.533104,TraderOne,Tick,2693,2643,50,-50,150500,150800,35101,-146801,-161801,OK
488.751227,TraderOne,Tick,2693,2653,40,-40,150500,150800,34951,-153651,-165651,OK
489.04688,TraderOne,Tick,2693,2653,40,-40,150500,150800,34951,-153651,-165651,OK
489.274134,TraderOne,Tick,2700,2653,47,-47,150500,150800,35162,-151062,-165162,OK
489.52391,TraderOne,Tick,2703,2653,50,-50,150400,151000,35117,-149217,-164217,OK
489.761733,TraderOne,Tick,2703,2653,50,-50,150600,151000,35117,-149217,-164217,OK
489.973472,TraderOne,Tick,2703,2663,40,-40,150800,151000,34966,-155066,-163066,OK
490.248443,TraderOne,Tick,2703,2663,40,-40,150800,151000,34966,-155066,-163066,OK
490.496925,TraderOne,Tick,2703,2663,40,-40,150800,151000,34966,-155066,-163066,OK
490.702959,TraderOne,Tick,2703,2663,40,-40,150800,151000,34966,-155066,-163066,OK
491.010298,TraderOne,Tick,2703,2663,40,-40,150800,151000,34966,-155066,-163066,OK
491.231912,TraderOne,Tick,2703,2663,40,-40,150800,150800,34966,-155066,-155066,OK
491.524997,TraderOne,Tick,2703,2663,40,-40,150800,150800,34966,-155066,-155066,OK
491.703687,TraderOne,Tick,2703,2663,40,-40,150800,150800,34966,-155066,-155066,OK
491.998989,TraderOne,Tick,2703,2663,40,-40,150800,150800,34966,-155066,-155066,OK
492.264052,TraderOne,Tick,2703,2663,40,-40,150800,150500,34966,-155066,-143066,OK
492.51879,TraderOne,Tick,2703,2670,33,-33,150300,150500,35176,-158076,-164676,OK
492.773332,TraderOne,Tick,2703,2680,23,-23,150800,150500,35026,-159926,-153026,OK
493.019168,TraderOne,Tick,2703,2680,23,-23,150800,150500,35026,-159926,-153026,OK
493.262155,TraderOne,Tick,2703,2680,23,-23,150800,150500,35026,-159926,-153026,OK
493.49048,TraderOne,Tick,2703,2680,23,-23,150800,150500,35026,-159926,-153026,OK
493.762897,TraderOne,Tick,2703,2680,23,-23,150800,150200,35026,-159926,-153026,OK
493.998254,TraderOne,Tick,2703,2680,23,-23,150800,150200,35026,-159926,-153026,OK
494.233559,TraderOne,Tick,2704,2680,24,-24,149900,150200,35011,-159711,-166911,OK
494.482277,TraderOne,Tick,2704,2680,24,-24,149900,150200,35011,-159711,-166911,OK
494.735581,TraderOne,Tick,2704,2680,24,-24,149900,150200,35011,-159711,-166911,OK
494.969299,TraderOne,Tick,2704,2680,24,-24,149900,150200,35011,-159711,-166911,OK
495.243473,TraderOne,Tick,2704,2680,24,-24,149900,150000,35011,-159711,-162111,OK
495.462333,TraderOne,Tick,2704,2680,24,-24,149900,150000,35011,-159711,-162111,OK
495.737181,TraderOne,Tick,2704,2690,14,-14,149600,149800,35310,-162010,-164810,OK
496.028353,TraderOne,Tick,2704,2690,14,-14,149600,149800,35310,-162010,-164810,OK
496.271466,TraderOne,Tick,2704,2690,14,-14,149600,149800,35310,-162010,-164810,OK
496.470037,TraderOne,Tick,2704,2690,14,-14,149600,149800,35310,-162010,-164810,OK
496.748602,TraderOne,Tick,2704,2690,14,-14,149600,149900,35310,-162010,-166210,OK
496.958028,TraderOne,Tick,2714,2690,24,-24,149500,149900,35160,-161860,-169060,OK
497.276236,TraderOne,Tick,2714,2690,24,-24,149500,149900,35160,-161860,-169060,OK
497.461108,TraderOne,Tick,2714,2690,24,-24,149500,149900,35160,-161860,-169060,OK
497.805163,TraderOne,Tick,2714,2690,24,-24,149500,149900,35160,-161860,-169060,OK
498.048217,TraderOne,Tick,2714,2690,24,-24,149500,149900,35160,-161860,-169060,OK
498.293574,TraderOne,Tick,2714,2690,24,-24,149500,149900,35160,-161860,-169060,OK
498.492813,TraderOne,Tick,2714,2690,24,-24,149500,149900,35160,-161860,-169060,OK
498.79149,TraderOne,Tick,2714,2690,24,-24,149500,149900,35160,-161860,-169060,OK
498.995088,TraderOne,Tick,2714,2690,24,-24,149500,149900,35160,-161860,-169060,OK
499.255721,TraderOne,Tick,2714,2690,24,-24,149500,149900,35160,-161860,-169060,OK
499.548882,TraderOne,Tick,2724,2690,34,-34,149400,149900,35010,-159710,-169910,OK
499.78019,TraderOne,Tick,2724,2690,34,-34,149400,149900,35010,-159710,-169910,OK
499.952052,TraderOne,Tick,2724,2690,34,-34,149400,149900,35010,-159710,-169910,OK
500.232536,TraderOne,Tick,2724,2690,34,-34,149400,149900,35010,-159710,-169910,OK
500.489661,TraderOne,Tick,2724,2690,34,-34,149400,149900,35010,-159710,-169910,OK
500.710088,TraderOne,Tick,2724,2690,34,-34,149400,149900,35010,-159710,-169910,OK
501.036498,TraderOne,Tick,2724,2700,24,-24,150400,149900,34860,-162560,-155360,OK
501.268757,TraderOne,Tick,2724,2700,24,-24,150400,149900,34860,-162560,-155360,OK
501.490264,TraderOne,Tick,2724,2700,24,-24,150400,149900,34860,-162560,-155360,OK
501.784376,TraderOne,Tick,2724,2700,24,-24,150400,149900,34860,-162560,-155360,OK
502.028996,TraderOne,Tick,2724,2700,24,-24,150400,149900,34860,-162560,-155360,OK
502.273743,TraderOne,Tick,2724,2700,24,-24,150400,149900,34860,-162560,-155360,OK
502.457912,TraderOne,Tick,2724,2705,19,-19,149700,149900,34785,-164485,-168285,OK
502.760201,TraderOne,Tick,2734,2705,29,-29,149600,150200,35085,-162785,-171485,OK
502.981052,TraderOne,Tick,2744,2705,39,-39,149600,150200,35385,-161085,-172785,OK
503.299728,TraderOne,Tick,2744,2715,29,-29,150600,150200,35235,-163935,-155235,OK
503.53396,TraderOne,Tick,2744,2715,29,-29,150600,150200,35235,-163935,-155235,OK
503.747845,TraderOne,Tick,2752,2715,37,-37,150000,150200,35115,-162215,-169615,OK
504.013642,TraderOne,Tick,2752,2715,37,-37,150000,150200,35115,-162215,-169615,OK
504.213206,TraderOne,Tick,2752,2715,37,-37,150000,150200,35115,-162215,-169615,OK
504.463709,TraderOne,Tick,2752,2715,37,-37,150000,150200,35115,-162215,-169615,OK
504.70992,TraderOne,Tick,2752,2715,37,-37,150000,150200,35115,-162215,-169615,OK
505.014612,TraderOne,Tick,2762,2725,37,-37,149400,150200,34815,-161915,-173015,OK
505.247927,TraderOne,Tick,2762,2725,37,-37,149400,150200,34815,-161915,-173015,OK
505.505121,TraderOne,Tick,2762,2725,37,-37,149400,150200,34815,-161915,-173015,OK
505.705613,TraderOne,Tick,2762,2725,37,-37,149400,150200,34815,-161915,-173015,OK
506.028627,TraderOne,Tick,2762,2735,27,-27,150100,150200,34665,-172765,-175465,OK
506.244886,TraderOne,Tick,2772,2735,37,-37,150600,150200,34966,-169066,-157966,OK
506.470338,TraderOne,Tick,2782,2735,47,-47,150600,150200,35267,-165367,-151267,OK
506.707028,TraderOne,Tick,2782,2735,47,-47,150600,150200,35267,-165367,-151267,OK
507.042863,TraderOne,Tick,2782,2735,47,-47,150600,150200,35267,-165367,-151267,OK
507.233996,TraderOne,Tick,2782,2745,37,-37,150400,150200,35116,-168216,-160816,OK
507.525552,TraderOne,Tick,2792,2745,47,-47,150400,150200,34966,-165066,-155666,OK
507.743303,TraderOne,Tick,2792,2745,47,-47,150400,150200,34966,-165066,-155666,OK
507.978545,TraderOne,Tick,2792,2745,47,-47,150400,151000,34966,-165066,-179166,OK
508.291945,TraderOne,Tick,2802,2745,57,-57,150400,151000,35267,-160367,-177467,OK
508.533595,TraderOne,Tick,2802,2745,57,-57,150400,151000,35267,-160367,-177467,OK
508.733115,TraderOne,Tick,2802,2745,57,-57,150400,151000,35267,-160367,-177467,OK
509.026168,TraderOne,Tick,2802,2745,57,-57,150400,151000,35267,-160367,-177467,OK
509.242405,TraderOne,Tick,2802,2745,57,-57,150400,151000,35267,-160367,-177467,OK
509.455442,TraderOne,Tick,2802,2745,57,-57,150400,151000,35267,-160367,-177467,OK
509.742079,TraderOne,Tick,2802,2745,57,-57,150400,151000,35267,-160367,-177467,OK
510.015432,TraderOne,Tick,2802,2745,57,-57,150400,151000,35267,-160367,-177467,OK
510.241295,TraderOne,Tick,2802,2745,57,-57,150400,151000,35267,-160367,-177467,OK
510.50213,TraderOne,Tick,2802,2745,57,-57,150400,151000,35267,-160367,-177467,OK
510.71865,TraderOne,Tick,2802,2755,47,-47,150200,151000,35117,-165217,-179317,OK
511.044325,TraderOne,Tick,2802,2765,37,-37,150600,151000,35418,-167518,-178618,OK
511.279495,TraderOne,Tick,2802,2765,37,-37,150600,151000,35418,-167518,-178618,OK
511.539762,TraderOne,Tick,2802,2765,37,-37,150600,151000,35418,-167518,-178618,OK
511.735372,TraderOne,Tick,2802,2785,17,-17,150600,151000,35568,-172668,-177768,OK
511.959447,TraderOne,Tick,2812,2785,27,-27,150600,151000,35417,-171517,-179617,OK
512.292752,TraderOne,Tick,2812,2785,27,-27,150600,151000,35417,-171517,-179617,OK
512.548722,TraderOne,Tick,2812,2785,27,-27,150600,151000,35417,-171517,-179617,OK
512.705391,TraderOne,Tick,2822,2785,37,-37,150400,151000,35266,-169366,-180466,OK
512.996734,TraderOne,Tick,2822,2792,30,-30,150700,151000,35161,-171361,-180361,OK
513.23982,TraderOne,Tick,2822,2792,30,-30,150700,151000,35161,-171361,-180361,OK
513.459749,TraderOne,Tick,2822,2792,30,-30,150700,150900,35161,-171361,-177361,OK
513.718119,TraderOne,Tick,2822,2792,30,-30,150700,150900,35161,-171361,-177361,OK
514.017915,TraderOne,Tick,2832,2792,40,-40,150500,151400,35010,-168210,-180210,OK
514.2523,TraderOne,Tick,2842,2792,50,-50,150800,151400,35312,-164512,-179512,OK
514.483246,TraderOne,Tick,2842,2792,50,-50,150800,151300,35312,-164512,-179512,OK
514.73015,TraderOne,Tick,2842,2802,40,-40,151000,151300,35161,-168361,-180361,OK
515.011654,TraderOne,Tick,2842,2802,40,-40,151000,151300,35161,-168361,-180361,OK
515.203933,TraderOne,Tick,2842,2802,40,-40,151000,151300,35161,-168361,-180361,OK
515.459712,TraderOne,Tick,2842,2802,40,-40,151000,151300,35161,-168361,-180361,OK
515.73076,TraderOne,Tick,2842,2802,40,-40,151000,151200,35161,-168361,-176361,OK
515.957928,TraderOne,Tick,2842,2802,40,-40,151000,151200,35161,-168361,-176361,OK
516.239241,TraderOne,Tick,2842,2802,40,-40,151000,151000,35161,-168361,-168361,OK
516.55041,TraderOne,Tick,2842,2812,30,-30,151000,151000,35010,-172210,-172210,OK
516.797501,TraderOne,Tick,2842,2812,30,-30,151000,151000,35010,-172210,-172210,OK
517.009928,TraderOne,Tick,2842,2812,30,-30,151000,151000,35010,-172210,-172210,OK
517.223836,TraderOne,Tick,2842,2812,30,-30,151000,151000,35010,-172210,-172210,OK
517.538622,TraderOne,Tick,2842,2812,30,-30,151000,151000,35010,-172210,-172210,OK
517.76619,TraderOne,Tick,2842,2812,30,-30,151000,151000,35010,-172210,-172210,OK
517.982895,TraderOne,Tick,2852,2812,40,-40,151000,151400,35312,-168512,-180512,OK
518.319026,TraderOne,Tick,2862,2822,40,-40,151100,151500,35463,-171663,-183663,OK
518.48785,TraderOne,Tick,2872,2822,50,-50,151200,151500,35765,-167965,-182965,OK
518.775353,TraderOne,Tick,2872,2822,50,-50,151200,151500,35765,-167965,-182965,OK
518.986957,TraderOne,Tick,2872,2832,40,-40,151100,151500,36067,-173267,-185267,OK
519.205508,TraderOne,Tick,2872,2832,40,-40,151100,151500,36067,-173267,-185267,OK
519.520202,TraderOne,Tick,2872,2832,40,-40,151100,151500,36067,-173267,-185267,OK
519.769122,TraderOne,Tick,2872,2842,30,-30,151100,151500,36369,-177569,-186569,OK
520.04275,TraderOne,Tick,2872,2842,30,-30,151100,151500,36369,-177569,-186569,OK
520.209254,TraderOne,Tick,2882,2842,40,-40,151200,151500,36671,-174871,-186871,OK
520.462483,TraderOne,Tick,2882,2842,40,-40,151200,151500,36671,-174871,-186871,OK
520.713549,TraderOne,Tick,2882,2842,40,-40,151200,151500,36671,-174871,-186871,OK
521.036115,TraderOne,Tick,2882,2842,40,-40,151200,151600,36671,-174871,-186871,OK
521.216558,TraderOne,Tick,2882,2842,40,-40,151200,151600,36671,-174871,-186871,OK
521.490323,TraderOne,Tick,2882,2842,40,-40,151200,151600,36671,-174871,-186871,OK
521.71874,TraderOne,Tick,2892,2842,50,-50,151100,151700,36973,-171173,-186173,OK
522.001353,TraderOne,Tick,2902,2842,60,-60,151100,151700,37275,-166475,-184475,OK
522.297924,TraderOne,Tick,2902,2852,50,-50,151100,151700,37577,-172777,-187777,OK
522.495101,TraderOne,Tick,2902,2852,50,-50,151100,151500,37577,-172777,-187777,OK
522.756491,TraderOne,Tick,2902,2852,50,-50,150900,151500,37577,-172777,-187777,OK
522.969014,TraderOne,Tick,2902,2852,50,-50,151000,151500,37577,-172777,-187777,OK
523.282643,TraderOne,Tick,2902,2852,50,-50,151000,151500,37577,-172777,-187777,OK
523.464001,TraderOne,Tick,2902,2852,50,-50,151200,151500,37577,-172777,-187777,OK
523.798394,TraderOne,Tick,2902,2852,50,-50,151200,151500,37577,-172777,-187777,OK
523.958796,TraderOne,Tick,2912,2852,60,-60,151300,151500,37880,-168080,-180080,OK
524.235736,TraderOne,Tick,2912,2852,60,-60,151300,151500,37880,-168080,-180080,OK
524.539445,TraderOne,Tick,2922,2852,70,-70,151200,151500,37729,-162929,-183929,OK
524.772005,TraderOne,Tick,2922,2862,60,-60,151300,151900,38031,-170231,-188231,OK
524.976697,TraderOne,Tick,2932,2862,70,-70,151300,151900,38334,-166534,-187534,OK
525.293673,TraderOne,Tick,2932,2862,70,-70,151300,151900,38334,-166534,-187534,OK
525.492696,TraderOne,Tick,2932,2872,60,-60,151200,151900,38636,-172836,-190836,OK
525.708697,TraderOne,Tick,2932,2872,60,-60,151200,151900,38636,-172836,-190836,OK
526.015977,TraderOne,Tick,2932,2872,60,-60,151200,151900,38636,-172836,-190836,OK
526.295214,TraderOne,Tick,2932,2882,50,-50,151100,151700,38938,-179138,-194138,OK
526.513287,TraderOne,Tick,2932,2882,50,-50,151100,151700,38938,-179138,-194138,OK
526.748367,TraderOne,Tick,2932,2892,40,-40,151400,151700,38787,-183987,-195987,OK
527.04775,TraderOne,Tick,2932,2892,40,-40,151400,151700,38787,-183987,-195987,OK
527.276259,TraderOne,Tick,2932,2892,40,-40,151400,151700,38787,-183987,-195987,OK
527.472874,TraderOne,Tick,2932,2892,40,-40,151400,151700,38787,-183987,-195987,OK
527.754556,TraderOne,Tick,2932,2892,40,-40,151400,151700,38787,-183987,-195987,OK
527.972247,TraderOne,Tick,2932,2892,40,-40,151400,151700,38787,-183987,-195987,OK
528.221062,TraderOne,Tick,2932,2892,40,-40,151400,151700,38787,-183987,-195987,OK
528.473037,TraderOne,Tick,2932,2892,40,-40,151400,151700,38787,-183987,-195987,OK
528.720616,TraderOne,Tick,2932,2892,40,-40,151400,151400,38787,-183987,-183987,OK
529.026942,TraderOne,Tick,2932,2902,30,-30,151000,151400,39089,-188289,-197289,OK
529.218677,TraderOne,Tick,2932,2902,30,-30,151000,151400,39089,-188289,-197289,OK
529.456476,TraderOne,Tick,2932,2902,30,-30,151000,151200,39089,-188289,-194289,OK
529.753256,TraderOne,Tick,2932,2912,20,-20,151000,151200,39391,-190591,-194591,OK
530.022405,TraderOne,Tick,2932,2922,10,-10,151000,151200,39693,-192893,-194893,OK
530.228709,TraderOne,Tick,2932,2922,10,-10,151000,151100,39693,-192893,-193893,OK
530.506993,TraderOne,Tick,2932,2922,10,-10,151000,151200,39693,-192893,-194893,OK
530.752738,TraderOne,Tick,2932,2922,10,-10,151000,151400,39693,-192893,-195893,OK
530.995828,TraderOne,Tick,2932,2922,10,-10,151000,150900,39693,-192893,-191893,OK
531.298115,TraderOne,Tick,2932,2932,0,0,150900,150900,39995,-193195,-193195,OK
531.481171,TraderOne,Tick,2932,2932,0,0,150900,150900,39995,-193195,-193195,OK
531.783858,TraderOne,Tick,2932,2932,0,0,150900,150900,39995,-193195,-193195,OK
532.023608,TraderOne,Tick,2932,2942,-10,10,151500,151000,39844,-193044,-196044,OK
532.264203,TraderOne,Tick,2932,2942,-10,10,151500,151000,39844,-193044,-196044,OK
532.501569,TraderOne,Tick,2932,2942,-10,10,151500,151000,39844,-193044,-196044,OK
532.739719,TraderOne,Tick,2932,2942,-10,10,151500,151000,39844,-193044,-196044,OK
532.968943,TraderOne,Tick,2942,2942,0,0,150800,150900,39693,-194893,-194893,OK
533.269124,TraderOne,Tick,2942,2942,0,0,150800,150900,39693,-194893,-194893,OK
533.489999,TraderOne,Tick,2942,2942,0,0,150800,150900,39693,-194893,-194893,OK
533.781252,TraderOne,Tick,2952,2942,10,-10,150800,150900,39542,-194742,-195742,OK
534.032735,TraderOne,Tick,2952,2960,-8,8,150800,150900,39723,-195123,-194323,OK
534.277905,TraderOne,Tick,2952,2970,-18,18,151400,150700,39572,-193972,-199372,OK
534.532581,TraderOne,Tick,2952,2970,-18,18,151400,150700,39572,-193972,-199372,OK
534.7693,TraderOne,Tick,2952,2970,-18,18,151400,150700,39572,-193972,-199372,OK
535.037225,TraderOne,Tick,2952,2980,-28,28,151400,150700,39421,-191821,-200221,OK
535.23963,TraderOne,Tick,2955,2980,-25,25,150900,150700,39376,-192676,-197676,OK
535.461817,TraderOne,Tick,2955,2980,-25,25,150900,150700,39376,-192676,-197676,OK
535.729443,TraderOne,Tick,2955,2980,-25,25,150900,150800,39376,-192676,-195176,OK
535.966407,TraderOne,Tick,2955,2980,-25,25,150900,150900,39376,-192676,-192676,OK
536.279517,TraderOne,Tick,2955,2980,-25,25,150900,150800,39376,-192676,-195176,OK
536.460332,TraderOne,Tick,2955,2980,-25,25,150900,150800,39376,-192676,-195176,OK
536.796767,TraderOne,Tick,2965,2980,-15,15,150800,150800,39225,-195525,-195525,OK
537.025911,TraderOne,Tick,2975,2980,-5,5,150600,150800,39074,-197374,-196374,OK
537.288302,TraderOne,Tick,2975,2980,-5,5,150600,150800,39074,-197374,-196374,OK
537.49291,TraderOne,Tick,2975,2980,-5,5,150600,150800,39074,-197374,-196374,OK
537.771103,TraderOne,Tick,2975,2980,-5,5,150600,151100,39074,-197374,-195874,OK
538.049122,TraderOne,Tick,2975,2980,-5,5,150600,151100,39074,-197374,-195874,OK
538.269556,TraderOne,Tick,2975,2980,-5,5,150600,151100,39074,-197374,-195874,OK
538.505623,TraderOne,Tick,2975,2980,-5,5,150600,151100,39074,-197374,-195874,OK
538.780709,TraderOne,Tick,2975,2980,-5,5,150600,151000,39074,-197374,-195874,OK
538.976517,TraderOne,Tick,2985,3000,-15,15,151500,151000,38621,-194921,-199421,OK
539.253441,TraderOne,Tick,2985,3000,-15,15,151500,150900,38621,-194921,-199421,OK
539.493112,TraderOne,Tick,2985,3000,-15,15,151500,150900,38621,-194921,-199421,OK
539.783094,TraderOne,Tick,2985,3000,-15,15,151500,150900,38621,-194921,-199421,OK
539.973346,TraderOne,Tick,2985,3000,-15,15,151500,150900,38621,-194921,-199421,OK
540.29537,TraderOne,Tick,2985,3000,-15,15,151500,150900,38621,-194921,-199421,OK
540.527965,TraderOne,Tick,2985,3000,-15,15,151500,150900,38621,-194921,-199421,OK
540.767139,TraderOne,Tick,2985,3000,-15,15,151500,151000,38621,-194921,-199421,OK
540.979184,TraderOne,Tick,2985,3000,-15,15,151500,151000,38621,-194921,-199421,OK
541.296126,TraderOne,Tick,2985,3000,-15,15,151500,151100,38621,-194921,-199421,OK
541.533415,TraderOne,Tick,2985,3010,-25,25,151600,151600,38470,-198770,-198770,OK
541.773086,TraderOne,Tick,2995,3010,-15,15,151600,151800,38773,-197073,-194073,OK
541.96415,TraderOne,Tick,3005,3010,-5,5,151600,151800,39076,-195376,-194376,OK
542.296427,TraderOne,Tick,3015,3010,5,-5,151600,151800,39379,-193679,-194679,OK
542.481733,TraderOne,Tick,3025,3010,15,-15,151600,151900,39682,-193982,-198482,OK
542.790874,TraderOne,Tick,3035,3010,25,-25,151600,152000,39985,-191285,-198785,OK
542.991595,TraderOne,Tick,3045,3010,35,-35,151600,152000,40288,-188588,-199088,OK
543.261454,TraderOne,Tick,3055,3010,45,-45,151400,152000,40591,-185891,-199391,OK
543.50775,TraderOne,Tick,3055,3010,45,-45,151400,152000,40591,-185891,-199391,OK
543.781437,TraderOne,Tick,3055,3010,45,-45,151600,152500,40591,-185891,-199391,OK
544.02016,TraderOne,Tick,3065,3010,55,-55,151800,152500,40895,-182195,-198695,OK
544.248049,TraderOne,Tick,3065,3010,55,-55,151800,152500,40895,-182195,-198695,OK
544.503247,TraderOne,Tick,3065,3010,55,-55,151800,152500,40895,-182195,-198695,OK
544.795187,TraderOne,Tick,3075,3010,65,-65,152000,152500,41199,-177499,-196999,OK
545.024392,TraderOne,Tick,3075,3010,65,-65,152000,152600,41199,-177499,-196999,OK
545.226235,TraderOne,Tick,3075,3010,65,-65,152000,152600,41199,-177499,-196999,OK
545.530642,TraderOne,Tick,3075,3020,55,-55,152200,152400,41047,-184347,-195347,OK
545.709193,TraderOne,Tick,3075,3020,55,-55,152200,152400,41047,-184347,-195347,OK
545.993943,TraderOne,Tick,3085,3020,65,-65,152200,152400,41351,-180651,-193651,OK
546.236053,TraderOne,Tick,3085,3030,55,-55,152200,152400,41655,-185955,-196955,OK
546.485208,TraderOne,Tick,3085,3030,55,-55,152200,152400,41655,-185955,-196955,OK
546.701703,TraderOne,Tick,3085,3030,55,-55,152200,152400,41655,-185955,-196955,OK
547.019365,TraderOne,Tick,3085,3030,55,-55,152200,152400,41655,-185955,-196955,OK
547.294253,TraderOne,Tick,3085,3030,55,-55,152200,152400,41655,-185955,-196955,OK
547.461318,TraderOne,Tick,3085,3030,55,-55,152200,152400,41655,-185955,-196955,OK
547.751319,TraderOne,Tick,3085,3040,45,-45,152200,152400,41503,-192803,-201803,OK
547.950473,TraderOne,Tick,3095,3040,55,-55,152300,152400,41808,-189108,-194608,OK
548.225764,TraderOne,Tick,3095,3040,55,-55,152300,152400,41808,-189108,-194608,OK
548.461737,TraderOne,Tick,3095,3050,45,-45,152200,152400,42112,-192412,-201412,OK
548.756663,TraderOne,Tick,3095,3060,35,-35,152300,152400,41960,-196260,-199760,OK
548.971633,TraderOne,Tick,3095,3060,35,-35,152300,152400,41960,-196260,-199760,OK
549.227373,TraderOne,Tick,3095,3060,35,-35,152300,152400,41960,-196260,-199760,OK
549.491393,TraderOne,Tick,3095,3060,35,-35,152300,152500,41960,-196260,-203260,OK
549.726933,TraderOne,Tick,3095,3060,35,-35,152300,152700,41960,-196260,-206760,OK
549.98649,TraderOne,Tick,3105,3060,45,-45,152300,152700,42265,-192565,-206065,OK
550.296683,TraderOne,Tick,3115,3060,55,-55,152400,152700,42570,-188870,-205370,OK
550.491016,TraderOne,Tick,3115,3060,55,-55,152400,152700,42570,-188870,-205370,OK
550.784103,TraderOne,Tick,3115,3060,55,-55,152400,152700,42570,-188870,-205370,OK
551.041187,TraderOne,Tick,3115,3060,55,-55,152400,152700,42570,-188870,-205370,OK
551.288683,TraderOne,Tick,3115,3070,45,-55,152400,153000,42418,1335282,-208218,OK
551.522252,TraderOne,Tick,3125,3070,55,-55,152500,153000,42723,-192023,-208523,OK
551.735025,TraderOne,Tick,3125,3070,55,-55,152500,153000,42723,-192023,-208523,OK
551.973303,TraderOne,Tick,3125,3070,55,-55,152500,153000,42723,-192023,-208523,OK
552.273967,TraderOne,Tick,3125,3070,55,-55,152500,153000,42723,-192023,-208523,OK
552.465347,TraderOne,Tick,3135,3070,65,-65,152600,153000,43028,-185328,-204828,OK
552.728147,TraderOne,Tick,3145,3070,75,-75,152800,153600,43334,-177834,-200334,OK
552.998527,TraderOne,Tick,3145,3080,65,-65,153100,153600,43181,-183681,-203181,OK
553.219668,TraderOne,Tick,3145,3090,55,-55,153100,153600,43487,-188987,-205487,OK
553.501489,TraderOne,Tick,3155,3090,65,-65,153000,153600,43334,-183834,-203334,OK
553.794849,TraderOne,Tick,3155,3100,55,-55,153300,153600,43181,-189681,-206181,OK
553.963002,TraderOne,Tick,3155,3100,55,-55,153300,153600,43181,-189681,-206181,OK
554.255522,TraderOne,Tick,3155,3100,55,-55,153300,153600,43181,-189681,-206181,OK
554.501451,TraderOne,Tick,3155,3110,45,-45,153300,153600,43487,-194987,-208487,OK
554.727078,TraderOne,Tick,3155,3110,45,-45,153300,153600,43487,-194987,-208487,OK
554.959105,TraderOne,Tick,3155,3120,35,-35,153300,153600,43334,-196834,-207334,OK
555.220335,TraderOne,Tick,3155,3120,35,-35,153300,153600,43334,-196834,-207334,OK
555.482616,TraderOne,Tick,3155,3120,35,-35,153300,153200,43334,-196834,-193334,OK
555.784253,TraderOne,Tick,3155,3120,35,-35,153300,153200,43334,-196834,-193334,OK
556.044364,TraderOne,Tick,3155,3120,35,-35,153300,153200,43334,-196834,-193334,OK
556.238035,TraderOne,Tick,3155,3120,35,-35,153300,153300,43334,-196834,-196834,OK
556.47739,TraderOne,Tick,3165,3120,45,-45,152900,153300,43640,-193140,-206640,OK
556.785052,TraderOne,Tick,3165,3130,35,-35,153100,153600,43487,-200987,-211487,OK
556.974865,TraderOne,Tick,3175,3130,45,-45,153300,153600,43794,-197294,-210794,OK
557.226086,TraderOne,Tick,3185,3130,55,-55,153300,153600,44101,-193601,-210101,OK
557.538332,TraderOne,Tick,3185,3130,55,-55,153300,153600,44101,-193601,-210101,OK
557.787855,TraderOne,Tick,3185,3140,45,-45,153200,153600,43948,-200448,-213948,OK
557.979626,TraderOne,Tick,3195,3140,55,-55,153300,153600,44255,-196755,-213255,OK
558.290215,TraderOne,Tick,3195,3140,55,-55,153300,153600,44255,-196755,-213255,OK
558.485743,TraderOne,Tick,3195,3140,55,-55,153300,153600,44255,-196755,-213255,OK
558.707738,TraderOne,Tick,3195,3140,55,-55,153300,153600,44255,-196755,-213255,OK
558.962501,TraderOne,Tick,3195,3150,45,-45,153200,153600,44561,-201061,-214561,OK
559.28962,TraderOne,Tick,3198,3150,48,-48,153100,153600,44515,-199815,-214215,OK
559.538265,TraderOne,Tick,3198,3150,48,-48,153300,153600,44515,-199815,-214215,OK
559.79644,TraderOne,Tick,3198,3150,48,-48,153300,153600,44515,-199815,-214215,OK
559.952675,TraderOne,Tick,3208,3150,58,-58,153300,153600,44822,-196122,-213522,OK
560.243986,TraderOne,Tick,3216,3150,66,-66,153200,153600,44699,-191999,-211799,OK
560.505359,TraderOne,Tick,3216,3160,56,-56,153400,153600,44546,-197846,-209046,OK
560.730707,TraderOne,Tick,3216,3160,56,-56,153400,153600,44546,-197846,-209046,OK
560.99629,TraderOne,Tick,3226,3160,66,-66,153100,153600,44393,-192693,-212493,OK
561.209799,TraderOne,Tick,3226,3170,56,-56,153500,154200,44240,-201540,-218340,OK
561.496878,TraderOne,Tick,3226,3170,56,-56,153500,154400,44240,-201540,-218340,OK
561.703737,TraderOne,Tick,3226,3180,46,-46,153800,154400,44086,-209386,-223186,OK
562.017319,TraderOne,Tick,3236,3180,56,-56,153900,154400,44394,-205694,-222494,OK
562.287496,TraderOne,Tick,3236,3180,56,-56,154000,154600,44394,-205694,-222494,OK
562.526894,TraderOne,Tick,3236,3180,56,-56,154000,154900,44394,-205694,-222494,OK
562.784824,TraderOne,Tick,3246,3180,66,-66,154100,154900,44702,-201002,-220802,OK
562.988477,TraderOne,Tick,3246,3180,66,-66,154100,154800,44702,-201002,-220802,OK
563.292102,TraderOne,Tick,3246,3180,66,-66,154100,154600,44702,-201002,-220802,OK
563.498262,TraderOne,Tick,3246,3180,66,-66,153900,154600,44702,-201002,-220802,OK
563.744972,TraderOne,Tick,3246,3190,56,-56,154200,154700,44548,-208848,-225648,OK
564.02552,TraderOne,Tick,3246,3190,56,-56,154200,154700,44548,-208848,-225648,OK
564.250367,TraderOne,Tick,3246,3200,46,-46,154200,154900,44394,-215694,-229494,OK
564.478169,TraderOne,Tick,3256,3200,56,-56,154200,154900,44703,-213003,-229803,OK
564.722414,TraderOne,Tick,3256,3200,56,-56,154100,154900,44703,-213003,-229803,OK
564.9644,TraderOne,Tick,3256,3200,56,-56,154100,154900,44703,-213003,-229803,OK
565.274333,TraderOne,Tick,3256,3200,56,-56,154100,154900,44703,-213003,-229803,OK
565.527892,TraderOne,Tick,3256,3200,56,-56,154100,154700,44703,-213003,-229803,OK
565.798386,TraderOne,Tick,3256,3200,56,-56,154100,154700,44703,-213003,-229803,OK
566.035658,TraderOne,Tick,3256,3200,56,-56,154100,154700,44703,-213003,-229803,OK
566.225462,TraderOne,Tick,3256,3200,56,-56,154100,154700,44703,-213003,-229803,OK
566.503408,TraderOne,Tick,3256,3200,56,-56,154100,154700,44703,-213003,-229803,OK
566.741012,TraderOne,Tick,3256,3200,56,-56,154100,154700,44703,-213003,-229803,OK
566.999457,TraderOne,Tick,3256,3200,56,-56,154100,154700,44703,-213003,-229803,OK
567.209465,TraderOne,Tick,3256,3200,56,-56,154100,154700,44703,-213003,-229803,OK
567.458952,TraderOne,Tick,3256,3200,56,-56,154100,154700,44703,-213003,-229803,OK
567.711117,TraderOne,Tick,3256,3200,56,-56,154100,154700,44703,-213003,-229803,OK
568.028004,TraderOne,Tick,3256,3200,56,-56,154100,154700,44703,-213003,-229803,OK
568.258528,TraderOne,Tick,3256,3200,56,-56,154100,154400,44703,-213003,-229803,OK
568.518813,TraderOne,Tick,3256,3200,56,-56,154100,154400,44703,-213003,-229803,OK
568.764275,TraderOne,Tick,3256,3210,46,-46,154400,154400,44549,-217849,-217849,OK
569.03005,TraderOne,Tick,3256,3210,46,-46,154400,154400,44549,-217849,-217849,OK
569.301485,TraderOne,Tick,3266,3210,56,-56,154000,154700,44395,-211695,-228495,OK
569.486771,TraderOne,Tick,3266,3210,56,-56,154400,154700,44395,-211695,-228495,OK
569.724653,TraderOne,Tick,3266,3210,56,-56,154400,154700,44395,-211695,-228495,OK
569.986822,TraderOne,Tick,3266,3210,56,-56,154400,154700,44395,-211695,-228495,OK
570.260244,TraderOne,Tick,3266,3210,56,-56,154400,154700,44395,-211695,-228495,OK
570.47896,TraderOne,Tick,3266,3210,56,-56,154400,154700,44395,-211695,-228495,OK
570.717936,TraderOne,Tick,3266,3210,56,-56,154400,154700,44395,-211695,-228495,OK
571.013104,TraderOne,Tick,3266,3210,56,-56,154400,154700,44395,-211695,-228495,OK
571.249042,TraderOne,Tick,3266,3220,46,-46,154600,155400,44241,-222541,-236341,OK
571.528772,TraderOne,Tick,3276,3220,56,-56,154800,155500,44550,-217850,-234650,OK
571.788978,TraderOne,Tick,3286,3220,66,-66,155000,155600,44860,-212160,-231960,OK
571.989365,TraderOne,Tick,3286,3230,56,-66,155100,155700,44705,1338995,-234805,OK
572.271767,TraderOne,Tick,3286,3230,56,-56,155100,155700,44705,-219005,-235805,OK
572.504478,TraderOne,Tick,3286,3230,56,-56,155100,155700,44705,-219005,-235805,OK
572.796793,TraderOne,Tick,3286,3230,56,-56,155200,155700,44705,-219005,-235805,OK
572.982205,TraderOne,Tick,3296,3230,66,-66,155200,155700,45015,-214315,-234115,OK
573.25622,TraderOne,Tick,3306,3230,76,-76,155000,155700,44860,-209160,-231960,OK
573.529645,TraderOne,Tick,3306,3240,66,-66,155700,155700,45170,-216470,-216470,OK
573.785968,TraderOne,Tick,3306,3240,66,-66,155000,155700,45170,-216470,-236270,OK
573.953057,TraderOne,Tick,3306,3240,66,-66,155000,155700,45170,-216470,-236270,OK
574.259296,TraderOne,Tick,3306,3240,66,-66,155000,155500,45170,-216470,-236270,OK
574.550199,TraderOne,Tick,3306,3240,66,-66,155000,155300,45170,-216470,-236270,OK
574.768271,TraderOne,Tick,3306,3250,56,-56,154900,155300,45480,-220780,-237580,OK
575.023075,TraderOne,Tick,3306,3250,56,-56,154600,155300,45480,-220780,-237580,OK
575.300682,TraderOne,Tick,3306,3250,56,-56,154600,155300,45480,-220780,-237580,OK
575.46442,TraderOne,Tick,3306,3250,56,-56,154600,155300,45480,-220780,-237580,OK
575.728342,TraderOne,Tick,3306,3250,56,-56,154600,155300,45480,-220780,-237580,OK
575.980151,TraderOne,Tick,3306,3250,56,-56,154600,155300,45480,-220780,-237580,OK
576.239065,TraderOne,Tick,3306,3250,56,-56,154600,155300,45480,-220780,-237580,OK
576.472783,TraderOne,Tick,3306,3250,56,-56,154600,155300,45480,-220780,-237580,OK
576.735838,TraderOne,Tick,3306,3250,56,-56,154600,155300,45480,-220780,-237580,OK
577.007447,TraderOne,Tick,3306,3250,56,-56,154600,155100,45480,-220780,-237580,OK
577.272175,TraderOne,Tick,3306,3250,56,-56,154600,155100,45480,-220780,-237580,OK
577.474301,TraderOne,Tick,3306,3260,46,-46,154800,155100,45325,-226625,-240425,OK
577.7066,TraderOne,Tick,3306,3263,43,-43,155100,155100,45418,-227618,-227618,OK
577.963313,TraderOne,Tick,3316,3263,53,-53,154600,155100,45263,-223463,-239363,OK
578.224296,TraderOne,Tick,3316,3263,53,-53,154600,155100,45263,-223463,-239363,OK
578.476729,TraderOne,Tick,3316,3263,53,-53,154600,155100,45263,-223463,-239363,OK
578.798454,TraderOne,Tick,3316,3263,53,-53,154600,155100,45263,-223463,-239363,OK
578.99817,TraderOne,Tick,3316,3263,53,-53,154600,155100,45263,-223463,-239363,OK
579.258699,TraderOne,Tick,3316,3263,53,-53,154600,155100,45263,-223463,-239363,OK
579.531764,TraderOne,Tick,3316,3263,53,-53,154600,155100,45263,-223463,-239363,OK
579.753913,TraderOne,Tick,3316,3263,53,-53,154600,155100,45263,-223463,-239363,OK
579.96394,TraderOne,Tick,3316,3263,53,-53,154600,155100,45263,-223463,-239363,OK
580.207522,TraderOne,Tick,3316,3263,53,-53,154600,155400,45263,-223463,-239363,OK
580.470668,TraderOne,Tick,3326,3263,63,-63,154600,155400,45108,-217308,-236208,OK
580.746658,TraderOne,Tick,3326,3263,63,-63,154600,155400,45108,-217308,-236208,OK
581.022308,TraderOne,Tick,3326,3273,53,-53,155300,155400,44953,-224153,-229453,OK
581.25722,TraderOne,Tick,3326,3283,43,-43,155200,155400,45263,-226463,-235063,OK
581.455261,TraderOne,Tick,3326,3293,33,-33,155500,155400,45573,-228773,-225473,OK
581.787923,TraderOne,Tick,3326,3303,23,-23,155200,155500,45883,-232083,-238983,OK
582.047081,TraderOne,Tick,3336,3303,33,-33,155500,155500,46194,-230394,-230394,OK
582.271426,TraderOne,Tick,3336,3303,33,-33,155500,155500,46194,-230394,-230394,OK
582.517796,TraderOne,Tick,3336,3303,33,-33,155500,155600,46194,-230394,-233694,OK
582.746161,TraderOne,Tick,3336,3303,33,-33,155500,155600,46194,-230394,-233694,OK
583.021416,TraderOne,Tick,3336,3303,33,-33,155200,155600,46194,-230394,-240294,OK
583.257453,TraderOne,Tick,3336,3303,33,-33,155200,155600,46194,-230394,-240294,OK
583.464241,TraderOne,Tick,3336,3313,23,-23,155200,155600,46504,-233704,-240604,OK
583.74018,TraderOne,Tick,3336,3323,13,-23,155800,155600,46349,1319451,-233949,OK
583.991421,TraderOne,Tick,3336,3323,13,-13,155800,155600,46349,-236549,-233949,OK
584.242945,TraderOne,Tick,3336,3333,3,-3,156000,155600,46193,-237393,-236493,OK
584.51017,TraderOne,Tick,3336,3333,3,-3,156000,155600,46193,-237393,-236493,OK
584.72402,TraderOne,Tick,3336,3333,3,-3,156000,155600,46193,-237393,-236493,OK
585.023099,TraderOne,Tick,3336,3333,3,-3,156000,155600,46193,-237393,-236493,OK
585.254016,TraderOne,Tick,3336,3333,3,-3,156000,155600,46193,-237393,-236493,OK
585.48061,TraderOne,Tick,3336,3333,3,-3,156000,155600,46193,-237393,-236493,OK
585.74125,TraderOne,Tick,3336,3333,3,-3,156000,155600,46193,-237393,-236493,OK
585.960222,TraderOne,Tick,3336,3333,3,-3,156000,155300,46193,-237393,-236493,OK
586.280017,TraderOne,Tick,3336,3333,3,-3,156000,155500,46193,-237393,-236493,OK
586.494495,TraderOne,Tick,3346,3333,13,-13,155200,155400,46038,-238238,-240838,OK
586.753116,TraderOne,Tick,3346,3333,13,-13,155200,155500,46038,-238238,-242138,OK
587.010197,TraderOne,Tick,3346,3333,13,-13,155200,155600,46038,-238238,-242138,OK
587.230381,TraderOne,Tick,3346,3333,13,-13,155200,155600,46038,-238238,-242138,OK
587.499597,TraderOne,Tick,3346,3333,13,-13,155200,155600,46038,-238238,-242138,OK
587.79336,TraderOne,Tick,3353,3333,20,-20,155400,155600,45929,-237429,-241429,OK
588.020374,TraderOne,Tick,3353,3333,20,-20,155400,155600,45929,-237429,-241429,OK
588.284586,TraderOne,Tick,3353,3333,20,-20,155400,155600,45929,-237429,-241429,OK
588.531731,TraderOne,Tick,3353,3343,10,-10,155900,155600,45773,-239273,-236273,OK
588.794752,TraderOne,Tick,3363,3343,20,-20,155200,155600,45617,-240117,-246117,OK
589.008001,TraderOne,Tick,3363,3343,20,-20,155200,155600,45617,-240117,-246117,OK
589.297752,TraderOne,Tick,3363,3343,20,-20,155200,155600,45617,-240117,-246117,OK
589.511493,TraderOne,Tick,3363,3343,20,-20,155200,155600,45617,-240117,-246117,OK
589.708588,TraderOne,Tick,3363,3343,20,-20,155200,155600,45617,-240117,-246117,OK
589.993341,TraderOne,Tick,3363,3343,20,-20,155200,155600,45617,-240117,-246117,OK
590.272965,TraderOne,Tick,3363,3343,20,-20,155200,155600,45617,-240117,-246117,OK
590.51367,TraderOne,Tick,3363,3343,20,-20,155200,155600,45617,-240117,-246117,OK
590.741785,TraderOne,Tick,3363,3351,12,-12,155200,155600,45865,-241965,-245565,OK
590.981675,TraderOne,Tick,3363,3351,12,-12,155200,155600,45865,-241965,-245565,OK
591.284982,TraderOne,Tick,3363,3351,12,-12,155200,155000,45865,-241965,-239565,OK
591.508053,TraderOne,Tick,3363,3361,2,-2,155100,155000,46175,-244275,-244075,OK
591.79273,TraderOne,Tick,3363,3361,2,-2,155100,155000,46175,-244275,-244075,OK
592.038764,TraderOne,Tick,3363,3361,2,-2,155100,155000,46175,-244275,-244075,OK
592.276036,TraderOne,Tick,3363,3361,2,-2,155100,155300,46175,-244275,-244675,OK
592.532527,TraderOne,Tick,3363,3361,2,-2,155100,155300,46175,-244275,-244675,OK
592.798384,TraderOne,Tick,3363,3361,2,-2,155100,155300,46175,-244275,-244675,OK
593.016482,TraderOne,Tick,3363,3361,2,-2,155100,155500,46175,-244275,-244875,OK
593.278659,TraderOne,Tick,3363,3370,-7,-2,155600,155500,46035,1156265,-243935,OK
593.516777,TraderOne,Tick,3363,3370,-7,7,155600,155500,46035,-243935,-244635,OK
593.774572,TraderOne,Tick,3363,3370,-7,7,155600,155400,46035,-243935,-245335,OK
593.991777,TraderOne,Tick,3363,3377,-14,14,155500,155400,45926,-243126,-244526,OK
594.207739,TraderOne,Tick,3363,3377,-14,14,155500,155300,45926,-243126,-245926,OK
594.543741,TraderOne,Tick,3363,3377,-14,14,155500,155400,45926,-243126,-244526,OK
594.726548,TraderOne,Tick,3373,3377,-4,4,155500,155400,45770,-244970,-245370,OK
594.999771,TraderOne,Tick,3383,3377,6,-6,155400,155400,46081,-246281,-246281,OK
595.293035,TraderOne,Tick,3383,3377,6,-6,155400,155400,46081,-246281,-246281,OK
595.538718,TraderOne,Tick,3393,3379,14,-16,155500,155300,46361,64439,-243361,OK
595.759715,TraderOne,Tick,3393,3379,14,-14,155500,155300,46361,-246361,-243561,OK
595.970771,TraderOne,Tick,3393,3379,14,-14,155500,155300,46361,-246361,-243561,OK
596.271706,TraderOne,Tick,3393,3379,14,-14,155500,155300,46361,-246361,-243561,OK
596.544829,TraderOne,Tick,3393,3379,14,-14,155500,155300,46361,-246361,-243561,OK
596.773935,TraderOne,Tick,3393,3379,14,-14,155500,155200,46361,-246361,-242161,OK
596.97835,TraderOne,Tick,3393,3389,4,-4,155100,155100,46671,-247671,-247671,OK
597.22834,TraderOne,Tick,3393,3389,4,-4,155100,155100,46671,-247671,-247671,OK
597.493134,TraderOne,Tick,3393,3389,4,-4,155100,155100,46671,-247671,-247671,OK
597.748383,TraderOne,Tick,3393,3389,4,-4,155100,155100,46671,-247671,-247671,OK
597.98781,TraderOne,Tick,3393,3399,-6,6,155100,155100,46981,-247981,-247981,OK
598.292431,TraderOne,Tick,3393,3399,-6,6,155100,154900,46981,-247981,-249181,OK
598.539747,TraderOne,Tick,3393,3409,-16,16,155100,154900,47291,-247291,-250491,OK
598.777603,TraderOne,Tick,3393,3409,-16,16,155100,155100,47291,-247291,-247291,OK
599.00061,TraderOne,Tick,3393,3419,-26,26,155600,155100,47136,-245136,-252936,OK
599.284487,TraderOne,Tick,3393,3419,-26,26,155600,155100,47136,-245136,-252936,OK
599.45724,TraderOne,Tick,3393,3429,-36,36,155600,155100,46981,-242981,-253781,OK
599.732834,TraderOne,Tick,3393,3429,-36,36,155600,155100,46981,-242981,-253781,OK
600.026655,TraderOne,Tick,3393,3429,-36,36,155600,155100,46981,-242981,-253781,OK
600.24119,TraderOne,Tick,3393,3429,-36,36,155600,155100,46981,-242981,-253781,OK
600.508497,TraderOne,Tick,3393,3429,-36,36,155600,155100,46981,-242981,-253781,OK
600.756278,TraderOne,Tick,3393,3431,-38,38,155500,155100,46950,-242150,-253550,OK
600.972813,TraderOne,Tick,3393,3431,-38,38,155500,155100,46950,-242150,-253550,OK
601.224173,TraderOne,Tick,3393,3431,-38,38,155500,155100,46950,-242150,-253550,OK
601.533049,TraderOne,Tick,3393,3431,-38,38,155500,155100,46950,-242150,-253550,OK
601.777735,TraderOne,Tick,3393,3441,-48,48,155800,155100,46794,-237994,-252394,OK
601.977652,TraderOne,Tick,3393,3441,-48,48,155800,155100,46794,-237994,-252394,OK
602.206875,TraderOne,Tick,3393,3441,-48,48,155800,155100,46794,-237994,-252394,OK
602.524256,TraderOne,Tick,3393,3441,-48,48,155800,155100,46794,-237994,-252394,OK
602.717702,TraderOne,Tick,3400,3441,-41,41,155600,155100,46685,-241385,-253685,OK
603.018926,TraderOne,Tick,3400,3441,-41,41,155600,155100,46685,-241385,-253685,OK
603.253825,TraderOne,Tick,3400,3441,-41,41,155600,155100,46685,-241385,-253685,OK
603.50594,TraderOne,Tick,3400,3441,-41,41,155600,155100,46685,-241385,-253685,OK
603.799195,TraderOne,Tick,3400,3441,-41,41,155600,155100,46685,-241385,-253685,OK
604.006901,TraderOne,Tick,3400,3441,-41,41,155600,155100,46685,-241385,-253685,OK
604.250573,TraderOne,Tick,3400,3441,-41,41,155600,155100,46685,-241385,-253685,OK
604.517664,TraderOne,Tick,3400,3441,-41,41,155600,155100,46685,-241385,-253685,OK
604.755694,TraderOne,Tick,3400,3441,-41,41,155600,155100,46685,-241385,-253685,OK
604.989427,TraderOne,Tick,3400,3441,-41,41,155600,155100,46685,-241385,-253685,OK
605.25948,TraderOne,Tick,3410,3441,-31,31,155300,154600,46530,-250230,-259530,OK
605.504694,TraderOne,Tick,3420,3441,-21,21,155000,154600,46375,-256075,-262375,OK
605.791836,TraderOne,Tick,3420,3441,-21,21,155000,154600,46375,-256075,-262375,OK
605.987878,TraderOne,Tick,3420,3441,-21,21,155000,154600,46375,-256075,-262375,OK
606.242426,TraderOne,Tick,3420,3451,-31,31,154900,154600,46685,-253385,-262685,OK
606.507505,TraderOne,Tick,3420,3451,-31,31,154900,154700,46685,-253385,-259585,OK
606.741103,TraderOne,Tick,3420,3451,-31,31,154900,154700,46685,-253385,-259585,OK
607.039589,TraderOne,Tick,3420,3451,-31,31,154900,154700,46685,-253385,-259585,OK
607.220912,TraderOne,Tick,3420,3451,-31,31,154900,155000,46685,-253385,-250285,OK
607.461641,TraderOne,Tick,3430,3451,-21,21,154900,155000,46529,-258229,-256129,OK
607.794865,TraderOne,Tick,3430,3461,-31,31,155500,155000,46373,-256073,-265373,OK
607.999914,TraderOne,Tick,3430,3461,-31,31,155500,155000,46373,-256073,-265373,OK
608.23734,TraderOne,Tick,3430,3461,-31,31,155500,155000,46373,-256073,-265373,OK
608.548444,TraderOne,Tick,3434,3461,-27,27,155600,155400,46311,-257211,-262611,OK
608.762696,TraderOne,Tick,3434,3461,-27,27,155600,155400,46311,-257211,-262611,OK
609.0493,TraderOne,Tick,3434,3461,-27,27,155600,155400,46311,-257211,-262611,OK
609.21228,TraderOne,Tick,3434,3461,-27,27,155600,155400,46311,-257211,-262611,OK
609.548214,TraderOne,Tick,3444,3461,-17,17,155700,155700,46155,-260055,-260055,OK
609.731992,TraderOne,Tick,3448,3461,-13,13,155100,155700,46279,-258979,-255079,OK
610.042985,TraderOne,Tick,3454,3461,-7,7,155000,155700,46186,-261286,-259186,OK
610.214666,TraderOne,Tick,3454,3461,-7,7,155000,155700,46186,-261286,-259186,OK
610.475704,TraderOne,Tick,3454,3461,-7,7,155000,155700,46186,-261286,-259186,OK
610.757978,TraderOne,Tick,3454,3461,-7,7,155000,155500,46186,-261286,-259186,OK
610.980477,TraderOne,Tick,3464,3461,3,-3,155800,155500,46030,-262130,-261230,OK
611.281167,TraderOne,Tick,3464,3461,3,-3,155800,155500,46030,-262130,-261230,OK
611.499965,TraderOne,Tick,3474,3461,13,-13,155900,155500,46342,-263442,-259542,OK
611.756355,TraderOne,Tick,3474,3461,13,-13,155900,155500,46342,-263442,-259542,OK
611.998945,TraderOne,Tick,3474,3461,13,-13,155900,155500,46342,-263442,-259542,OK
612.293975,TraderOne,Tick,3474,3471,3,-3,155900,156000,46186,-266286,-266586,OK
612.54304,TraderOne,Tick,3484,3471,13,-13,155900,156000,46498,-266598,-267898,OK
612.756423,TraderOne,Tick,3484,3471,13,-13,155900,156000,46498,-266598,-267898,OK
613.02845,TraderOne,Tick,3494,3471,23,-23,155400,156200,46342,-265442,-272342,OK
613.285727,TraderOne,Tick,3494,3471,23,-23,155400,156300,46342,-265442,-272342,OK
613.506079,TraderOne,Tick,3494,3471,23,-23,155400,156100,46342,-265442,-272342,OK
613.764175,TraderOne,Tick,3494,3471,23,-23,155400,156100,46342,-265442,-272342,OK
614.049297,TraderOne,Tick,3494,3471,23,-23,155400,156400,46342,-265442,-272342,OK
614.291825,TraderOne,Tick,3504,3471,33,-33,155900,156400,46654,-262754,-272654,OK
614.504676,TraderOne,Tick,3511,3471,40,-40,155900,156400,46872,-260172,-272172,OK
614.730274,TraderOne,Tick,3511,3471,40,-40,155900,156400,46872,-260172,-272172,OK
615.020871,TraderOne,Tick,3511,3471,40,-40,155900,156400,46872,-260172,-272172,OK
615.216924,TraderOne,Tick,3511,3471,40,-40,155900,156400,46872,-260172,-272172,OK
615.483092,TraderOne,Tick,3511,3471,40,-40,155900,156400,46872,-260172,-272172,OK
615.701988,TraderOne,Tick,3511,3471,40,-40,155900,156400,46872,-260172,-272172,OK
616.007499,TraderOne,Tick,3511,3471,40,-40,155900,156400,46872,-260172,-272172,OK
616.283952,TraderOne,Tick,3511,3471,40,-40,155900,156400,46872,-260172,-272172,OK
616.463845,TraderOne,Tick,3511,3471,40,-40,155900,156400,46872,-260172,-272172,OK
616.749719,TraderOne,Tick,3511,3471,40,-40,155900,156400,46872,-260172,-272172,OK
616.959287,TraderOne,Tick,3511,3471,40,-40,155900,156400,46872,-260172,-272172,OK
617.25904,TraderOne,Tick,3511,3471,40,-40,155900,156400,46872,-260172,-272172,OK
617.549572,TraderOne,Tick,3511,3471,40,-40,155900,155900,46872,-260172,-260172,OK
617.794184,TraderOne,Tick,3511,3471,40,-40,155900,155900,46872,-260172,-260172,OK
617.989302,TraderOne,Tick,3511,3471,40,-40,155900,155900,46872,-260172,-260172,OK
618.283652,TraderOne,Tick,3511,3471,40,-40,155900,155900,46872,-260172,-260172,OK
618.487182,TraderOne,Tick,3511,3471,40,-40,155900,155900,46872,-260172,-260172,OK
618.765818,TraderOne,Tick,3511,3471,40,-40,155900,155700,46872,-260172,-252172,OK
618.969666,TraderOne,Tick,3511,3481,30,-30,155400,155600,47183,-264483,-270483,OK
619.299555,TraderOne,Tick,3521,3481,40,-40,155000,155600,47028,-261328,-273328,OK
619.485891,TraderOne,Tick,3521,3491,30,-40,156000,155600,46873,1292827,-254173,OK
619.72921,TraderOne,Tick,3521,3491,30,-30,156000,155600,46873,-263173,-254173,OK
619.987433,TraderOne,Tick,3521,3498,23,-23,155400,155600,46764,-265164,-269764,OK
620.240727,TraderOne,Tick,3521,3498,23,-23,155400,155600,46764,-265164,-269764,OK
620.54567,TraderOne,Tick,3521,3498,23,-23,155400,155600,46764,-265164,-269764,OK
620.768482,TraderOne,Tick,3521,3498,23,-23,155400,155700,46764,-265164,-272064,OK
620.965235,TraderOne,Tick,3530,3498,32,-32,155400,155700,46624,-262324,-271924,OK
621.256337,TraderOne,Tick,3530,3498,32,-32,155400,155700,46624,-262324,-271924,OK
621.551939,TraderOne,Tick,3530,3498,32,-32,155400,155700,46624,-262324,-271924,OK
621.742433,TraderOne,Tick,3540,3498,42,-42,155400,155700,46468,-259168,-271768,OK
622.029508,TraderOne,Tick,3540,3498,42,-42,155400,156200,46468,-259168,-271768,OK
622.21793,TraderOne,Tick,3540,3498,42,-42,155400,156200,46468,-259168,-271768,OK
622.507326,TraderOne,Tick,3540,3498,42,-42,155400,156200,46468,-259168,-271768,OK
622.762983,TraderOne,Tick,3540,3508,32,-32,156100,156200,46312,-264012,-267212,OK
622.996371,TraderOne,Tick,3540,3508,32,-32,156100,156200,46312,-264012,-267212,OK
623.307026,TraderOne,Tick,3540,3508,32,-32,156100,156200,46312,-264012,-267212,OK
623.548005,TraderOne,Tick,3540,3508,32,-32,156100,156200,46312,-264012,-267212,OK
623.701147,TraderOne,Tick,3540,3518,22,-22,156400,156200,46156,-267856,-263456,OK
624.028475,TraderOne,Tick,3540,3518,22,-22,156400,156200,46156,-267856,-263456,OK
624.299386,TraderOne,Tick,3540,3528,12,-12,156000,155900,46000,-272700,-271500,OK
624.499155,TraderOne,Tick,3540,3528,12,-12,156000,155900,46000,-272700,-271500,OK
624.727818,TraderOne,Tick,3540,3528,12,-12,156000,155900,46000,-272700,-271500,OK
625.00159,TraderOne,Tick,3540,3528,12,-12,156000,155900,46000,-272700,-271500,OK
625.233949,TraderOne,Tick,3540,3528,12,-12,156000,155900,46000,-272700,-271500,OK
625.492582,TraderOne,Tick,3540,3528,12,-12,156000,155500,46000,-272700,-269100,OK
625.788616,TraderOne,Tick,3540,3528,12,-12,156000,155400,46000,-272700,-269100,OK
625.95525,TraderOne,Tick,3540,3528,12,-12,156000,155200,46000,-272700,-269100,OK
626.272976,TraderOne,Tick,3540,3528,12,-12,156000,155200,46000,-272700,-269100,OK
626.46543,TraderOne,Tick,3540,3528,12,-12,156000,155200,46000,-272700,-269100,OK
626.743149,TraderOne,Tick,3540,3528,12,-12,156000,155200,46000,-272700,-269100,OK
626.975218,TraderOne,Tick,3540,3528,12,-12,156000,155200,46000,-272700,-269100,OK
627.25002,TraderOne,Tick,3540,3528,12,-12,156000,155500,46000,-272700,-269100,OK
627.475524,TraderOne,Tick,3540,3528,12,-12,156000,155500,46000,-272700,-269100,OK
627.742538,TraderOne,Tick,3540,3528,12,-12,156000,155500,46000,-272700,-269100,OK
627.957842,TraderOne,Tick,3540,3528,12,-12,156000,155500,46000,-272700,-269100,OK
628.254267,TraderOne,Tick,3540,3528,12,-12,156000,155800,46000,-272700,-270300,OK
628.476002,TraderOne,Tick,3540,3528,12,-12,156000,155800,46000,-272700,-270300,OK
628.740179,TraderOne,Tick,3540,3528,12,-12,156000,155800,46000,-272700,-270300,OK
628.986264,TraderOne,Tick,3540,3528,12,-12,156000,155800,46000,-272700,-270300,OK
629.277459,TraderOne,Tick,3540,3528,12,-12,156000,155800,46000,-272700,-270300,OK
629.464823,TraderOne,Tick,3540,3528,12,-12,156000,155800,46000,-272700,-270300,OK
629.719337,TraderOne,Tick,3540,3528,12,-12,156000,155800,46000,-272700,-270300,OK
630.002094,TraderOne,Tick,3540,3528,12,-12,156000,155800,46000,-272700,-270300,OK
630.232972,TraderOne,Tick,3540,3528,12,-12,156000,155800,46000,-272700,-270300,OK
630.474784,TraderOne,Tick,3540,3528,12,-12,156000,155800,46000,-272700,-270300,OK
630.786017,TraderOne,Tick,3540,3528,12,-12,156000,155700,46000,-272700,-269100,OK
631.027902,TraderOne,Tick,3540,3538,2,-2,155900,155700,45844,-273544,-273144,OK
631.272237,TraderOne,Tick,3540,3538,2,-2,155900,155700,45844,-273544,-273144,OK
631.473543,TraderOne,Tick,3540,3538,2,-2,155900,155700,45844,-273544,-273144,OK
631.733937,TraderOne,Tick,3540,3538,2,-2,155900,155700,45844,-273544,-273144,OK
631.957321,TraderOne,Tick,3550,3538,12,-12,156000,155700,46156,-273856,-270256,OK
632.251145,TraderOne,Tick,3550,3538,12,-12,156000,156000,46156,-273856,-273856,OK
632.503216,TraderOne,Tick,3550,3548,2,-2,155900,156000,46468,-275168,-275368,OK
632.741727,TraderOne,Tick,3550,3548,2,-2,155900,156000,46468,-275168,-275368,OK
632.983546,TraderOne,Tick,3550,3548,2,-2,155900,155800,46468,-275168,-274968,OK
633.265285,TraderOne,Tick,3550,3558,-8,8,155900,155800,46780,-274480,-275280,OK
633.530985,TraderOne,Tick,3550,3568,-18,18,155900,155800,47092,-273792,-275592,OK
633.79656,TraderOne,Tick,3550,3568,-18,18,155900,155800,47092,-273792,-275592,OK
634.046216,TraderOne,Tick,3560,3568,-8,8,155600,155800,46936,-275636,-274036,OK
634.278554,TraderOne,Tick,3560,3568,-8,8,155600,155800,46936,-275636,-274036,OK
634.5342,TraderOne,Tick,3560,3568,-8,8,155600,155800,46936,-275636,-274036,OK
634.787322,TraderOne,Tick,3560,3568,-8,8,155600,155800,46936,-275636,-274036,OK
635.001433,TraderOne,Tick,3560,3568,-8,8,155600,155800,46936,-275636,-274036,OK
635.213305,TraderOne,Tick,3570,3568,2,-2,155700,155800,46780,-276480,-276680,OK
635.485425,TraderOne,Tick,3570,3568,2,-2,155700,155800,46780,-276480,-276680,OK
635.740289,TraderOne,Tick,3580,3568,12,-12,155700,155800,47091,-276791,-277991,OK
636.01996,TraderOne,Tick,3580,3568,12,-12,155600,155800,47091,-276791,-279191,OK
636.300144,TraderOne,Tick,3590,3568,22,-22,155700,155800,47402,-276102,-278302,OK
636.544923,TraderOne,Tick,3590,3568,22,-22,155700,155900,47402,-276102,-280502,OK
636.711381,TraderOne,Tick,3590,3568,22,-22,155600,155900,47402,-276102,-282702,OK
636.969438,TraderOne,Tick,3590,3568,22,-22,155600,155900,47402,-276102,-282702,OK
637.231612,TraderOne,Tick,3590,3568,22,-22,155600,155900,47402,-276102,-282702,OK
637.51265,TraderOne,Tick,3590,3568,22,-22,155600,155900,47402,-276102,-282702,OK
637.706746,TraderOne,Tick,3590,3568,22,-22,155600,155900,47402,-276102,-282702,OK
637.959318,TraderOne,Tick,3600,3568,32,-32,155700,155900,47713,-274413,-280813,OK
638.27894,TraderOne,Tick,3610,3568,42,-42,155400,155900,47557,-271257,-283857,OK
638.545715,TraderOne,Tick,3610,3568,42,-42,155800,155900,47557,-271257,-275457,OK
638.796727,TraderOne,Tick,3610,3568,42,-42,155800,155900,47557,-271257,-275457,OK
638.988396,TraderOne,Tick,3610,3568,42,-42,155800,155900,47557,-271257,-275457,OK
639.208418,TraderOne,Tick,3610,3568,42,-42,155800,155900,47557,-271257,-275457,OK
639.532755,TraderOne,Tick,3610,3568,42,-42,155800,155900,47557,-271257,-275457,OK
639.729762,TraderOne,Tick,3610,3568,42,-42,155800,155900,47557,-271257,-275457,OK
640.037376,TraderOne,Tick,3610,3568,42,-42,155800,155900,47557,-271257,-275457,OK
640.286285,TraderOne,Tick,3610,3568,42,-42,155800,155900,47557,-271257,-275457,OK
640.462159,TraderOne,Tick,3610,3578,32,-32,155800,155900,47401,-274101,-277301,OK
640.756515,TraderOne,Tick,3610,3578,32,-32,155500,155900,47401,-274101,-283701,OK
640.999594,TraderOne,Tick,3610,3588,22,-22,156100,155900,47245,-276945,-272545,OK
641.225683,TraderOne,Tick,3610,3588,22,-22,156100,155900,47245,-276945,-272545,OK
641.535509,TraderOne,Tick,3610,3588,22,-22,156100,155700,47245,-276945,-270345,OK
641.773246,TraderOne,Tick,3610,3588,22,-22,156100,156000,47245,-276945,-274745,OK
641.98501,TraderOne,Tick,3610,3588,22,-22,156100,156000,47245,-276945,-274745,OK
642.213458,TraderOne,Tick,3610,3598,12,-12,156100,156000,47089,-278789,-277589,OK
642.452842,TraderOne,Tick,3620,3598,22,-22,156000,156000,46933,-277633,-277633,OK
642.756316,TraderOne,Tick,3630,3598,32,-32,155600,156000,47245,-274945,-284545,OK
642.952953,TraderOne,Tick,3630,3598,32,-32,155600,156500,47245,-274945,-284545,OK
643.299036,TraderOne,Tick,3640,3598,42,-42,155900,156500,47557,-271257,-283857,OK
643.516518,TraderOne,Tick,3650,3598,52,-52,155900,156500,47869,-265569,-281169,OK
643.78548,TraderOne,Tick,3650,3598,52,-52,156100,156700,47869,-265569,-281169,OK
644.01801,TraderOne,Tick,3660,3608,52,-52,156200,156700,48025,-267725,-283325,OK
644.204188,TraderOne,Tick,3660,3608,52,-52,156200,157100,48025,-267725,-283325,OK
644.476237,TraderOne,Tick,3670,3608,62,-62,156400,157000,48338,-262038,-280638,OK
644.800706,TraderOne,Tick,3670,3618,52,-52,156400,157000,48651,-267351,-282951,OK
644.982514,TraderOne,Tick,3670,3618,52,-52,156400,157000,48651,-267351,-282951,OK
645.281705,TraderOne,Tick,3680,3628,52,-52,156600,157000,48339,-268039,-283639,OK
645.493245,TraderOne,Tick,3680,3628,52,-52,156600,157000,48339,-268039,-283639,OK
645.772341,TraderOne,Tick,3680,3628,52,-52,156600,156400,48339,-268039,-257639,OK
646.040619,TraderOne,Tick,3680,3638,42,-42,155900,156400,48651,-273351,-285951,OK
646.233432,TraderOne,Tick,3680,3638,42,-42,155900,156400,48651,-273351,-285951,OK
646.510584,TraderOne,Tick,3680,3638,42,-42,155900,156400,48651,-273351,-285951,OK
646.765416,TraderOne,Tick,3680,3638,42,-42,155900,156400,48651,-273351,-285951,OK
647.02361,TraderOne,Tick,3680,3638,42,-42,155900,156400,48651,-273351,-285951,OK
647.261525,TraderOne,Tick,3680,3648,32,-32,156100,156400,48495,-277195,-286795,OK
647.519067,TraderOne,Tick,3680,3648,32,-32,156100,156300,48495,-277195,-283595,OK
647.775138,TraderOne,Tick,3680,3648,32,-32,156100,156300,48495,-277195,-283595,OK
648.013713,TraderOne,Tick,3680,3648,32,-32,156100,156200,48495,-277195,-280395,OK
648.254316,TraderOne,Tick,3680,3648,32,-32,156100,156200,48495,-277195,-280395,OK
648.504717,TraderOne,Tick,3680,3648,32,-32,156100,156000,48495,-277195,-273995,OK
648.777494,TraderOne,Tick,3680,3648,32,-32,156100,156000,48495,-277195,-273995,OK
649.009813,TraderOne,Tick,3680,3648,32,-32,156100,156000,48495,-277195,-273995,OK
649.258445,TraderOne,Tick,3680,3658,22,-32,156600,156000,48339,1280961,-272439,OK
649.523975,TraderOne,Tick,3680,3658,22,-22,156600,156000,48339,-281039,-274439,OK
649.783949,TraderOne,Tick,3680,3668,12,-12,156600,156000,48183,-282883,-279283,OK
650.02621,TraderOne,Tick,3680,3668,12,-12,156600,156000,48183,-282883,-279283,OK
650.267706,TraderOne,Tick,3680,3668,12,-12,156600,156000,48183,-282883,-279283,OK
650.513182,TraderOne,Tick,3680,3668,12,-12,156600,156000,48183,-282883,-279283,OK
650.74908,TraderOne,Tick,3680,3668,12,-12,156600,155900,48183,-282883,-279283,OK
650.97245,TraderOne,Tick,3680,3668,12,-12,155500,155800,48183,-282883,-286483,OK
651.208262,TraderOne,Tick,3680,3668,12,-12,155500,155800,48183,-282883,-286483,OK
651.473129,TraderOne,Tick,3680,3678,2,-2,155700,155800,48027,-284727,-284927,OK
651.743422,TraderOne,Tick,3680,3688,-8,8,156000,155800,48339,-284039,-285639,OK
651.96054,TraderOne,Tick,3680,3698,-18,18,156000,155800,48651,-283351,-286951,OK
652.22873,TraderOne,Tick,3680,3698,-18,18,156000,155800,48651,-283351,-286951,OK
652.47236,TraderOne,Tick,3680,3708,-28,28,156000,155700,48963,-281663,-290063,OK
652.786856,TraderOne,Tick,3680,3708,-28,28,156000,155700,48963,-281663,-290063,OK
653.018582,TraderOne,Tick,3680,3708,-28,28,156000,155700,48963,-281663,-290063,OK
653.23264,TraderOne,Tick,3680,3708,-28,28,156000,155800,48963,-281663,-287263,OK
653.508471,TraderOne,Tick,3680,3708,-28,28,156000,155800,48963,-281663,-287263,OK
653.719571,TraderOne,Tick,3680,3708,-28,28,156000,155800,48963,-281663,-287263,OK
653.954577,TraderOne,Tick,3680,3708,-28,28,156000,155800,48963,-281663,-287263,OK
654.255816,TraderOne,Tick,3680,3708,-28,28,156000,155800,48963,-281663,-287263,OK
654.51077,TraderOne,Tick,3680,3708,-28,28,156000,155800,48963,-281663,-287263,OK
654.711759,TraderOne,Tick,3680,3708,-28,28,156000,155800,48963,-281663,-287263,OK
655.023622,TraderOne,Tick,3680,3708,-28,28,156000,155700,48963,-281663,-290063,OK
655.298092,TraderOne,Tick,3680,3708,-28,28,156000,155700,48963,-281663,-290063,OK
655.482537,TraderOne,Tick,3680,3718,-38,38,156300,155700,48807,-278507,-289907,OK
655.744215,TraderOne,Tick,3680,3718,-38,38,156300,155700,48807,-278507,-289907,OK
655.999295,TraderOne,Tick,3680,3718,-38,38,156300,155700,48807,-278507,-289907,OK
656.219265,TraderOne,Tick,3680,3718,-38,38,156300,155700,48807,-278507,-289907,OK
656.504042,TraderOne,Tick,3680,3718,-38,38,156300,155800,48807,-278507,-289907,OK
656.748286,TraderOne,Tick,3690,3718,-28,38,155500,155800,48651,-1839351,-272951,OK
657.03478,TraderOne,Tick,3690,3718,-28,28,155500,155800,48651,-282351,-273951,OK
657.268845,TraderOne,Tick,3700,3718,-18,18,156000,155800,48495,-284195,-287795,OK
657.47857,TraderOne,Tick,3707,3718,-11,11,155600,155800,48713,-282313,-280113,OK
657.776903,TraderOne,Tick,3707,3728,-21,21,156600,155800,48557,-280157,-286457,OK
658.024061,TraderOne,Tick,3707,3738,-31,31,156600,155800,48401,-277001,-286301,OK
658.292034,TraderOne,Tick,3707,3738,-31,31,156600,155800,48401,-277001,-286301,OK
658.550961,TraderOne,Tick,3717,3738,-21,21,155500,155800,48245,-280845,-274545,OK
658.779732,TraderOne,Tick,3727,3738,-11,11,156200,155800,48089,-284689,-287989,OK
658.982673,TraderOne,Tick,3727,3738,-11,11,156200,155800,48089,-284689,-287989,OK
659.245771,TraderOne,Tick,3727,3738,-11,11,156200,155800,48089,-284689,-287989,OK
659.535724,TraderOne,Tick,3727,3738,-11,11,156200,155800,48089,-284689,-287989,OK
659.757775,TraderOne,Tick,3727,3738,-11,11,156200,155800,48089,-284689,-287989,OK
660.045304,TraderOne,Tick,3727,3738,-11,11,156200,155900,48089,-284689,-287989,OK
660.301756,TraderOne,Tick,3727,3738,-11,11,156200,155900,48089,-284689,-287989,OK
660.451396,TraderOne,Tick,3727,3738,-11,11,156200,156100,48089,-284689,-285789,OK
660.768866,TraderOne,Tick,3737,3738,-1,1,156200,156100,48401,-286001,-286101,OK
660.994866,TraderOne,Tick,3747,3738,9,-9,156200,156100,48713,-287313,-286413,OK
661.228982,TraderOne,Tick,3747,3738,9,-9,156200,156000,48713,-287313,-285513,OK
661.464648,TraderOne,Tick,3747,3738,9,-9,156200,156000,48713,-287313,-285513,OK
661.764718,TraderOne,Tick,3747,3748,-1,1,156200,156000,48557,-289157,-289357,OK
662.02756,TraderOne,Tick,3747,3748,-1,1,156200,156000,48557,-289157,-289357,OK
662.242822,TraderOne,Tick,3747,3748,-1,1,156200,156000,48557,-289157,-289357,OK
662.483568,TraderOne,Tick,3747,3748,-1,1,156200,156000,48557,-289157,-289357,OK
662.753089,TraderOne,Tick,3757,3748,9,-9,155900,156000,48401,-290001,-290901,OK
663.019301,TraderOne,Tick,3757,3748,9,-9,155900,156000,48401,-290001,-290901,OK
663.28038,TraderOne,Tick,3757,3748,9,-9,155900,156000,48401,-290001,-290901,OK
663.527618,TraderOne,Tick,3757,3758,-1,1,156200,155900,48245,-289845,-290145,OK
663.745307,TraderOne,Tick,3757,3758,-1,1,156200,155900,48245,-289845,-290145,OK
663.960327,TraderOne,Tick,3757,3758,-1,1,156200,155900,48245,-289845,-290145,OK
664.28197,TraderOne,Tick,3757,3758,-1,1,156200,155900,48245,-289845,-290145,OK
664.526452,TraderOne,Tick,3767,3758,9,-9,155700,155800,48089,-290689,-291589,OK
664.719715,TraderOne,Tick,3767,3758,9,-9,155700,155800,48089,-290689,-291589,OK
665.012612,TraderOne,Tick,3767,3758,9,-9,155700,155800,48089,-290689,-291589,OK
665.29912,TraderOne,Tick,3767,3758,9,-9,155700,155900,48089,-290689,-292489,OK
665.545369,TraderOne,Tick,3767,3758,9,-9,155700,155900,48089,-290689,-292489,OK
665.761747,TraderOne,Tick,3767,3758,9,-9,155700,155900,48089,-290689,-292489,OK
665.966028,TraderOne,Tick,3767,3758,9,-9,155700,155900,48089,-290689,-292489,OK
666.250122,TraderOne,Tick,3767,3768,-1,1,156500,155900,47933,-291533,-291833,OK
666.472427,TraderOne,Tick,3767,3768,-1,1,156500,155900,47933,-291533,-291833,OK
666.800486,TraderOne,Tick,3767,3768,-1,1,156500,156200,47933,-291533,-291833,OK
667.035979,TraderOne,Tick,3767,3778,-11,11,156700,156600,47776,-293376,-294476,OK
667.217238,TraderOne,Tick,3777,3778,-1,1,156800,156800,48090,-295690,-295690,OK
667.54623,TraderOne,Tick,3777,3778,-1,1,156800,156800,48090,-295690,-295690,OK
667.702417,TraderOne,Tick,3787,3778,9,-9,156800,156800,48404,-298004,-298004,OK
668.006485,TraderOne,Tick,3787,3778,9,-9,156800,156800,48404,-298004,-298004,OK
668.242505,TraderOne,Tick,3787,3778,9,-9,156800,156400,48404,-298004,-295304,OK
668.531733,TraderOne,Tick,3787,3788,-1,1,156800,156400,48717,-297317,-297617,OK
668.730873,TraderOne,Tick,3787,3798,-11,11,156700,156400,49030,-296630,-299930,OK
668.997284,TraderOne,Tick,3787,3798,-11,11,156700,156400,49030,-296630,-299930,OK
669.219265,TraderOne,Tick,3787,3798,-11,11,156700,156400,49030,-296630,-299930,OK
669.479269,TraderOne,Tick,3787,3798,-11,11,156700,156400,49030,-296630,-299930,OK
669.771888,TraderOne,Tick,3797,3798,-1,1,156100,156400,48874,-298474,-298174,OK
669.956113,TraderOne,Tick,3797,3798,-1,1,156100,156400,48874,-298474,-298174,OK
670.278514,TraderOne,Tick,3797,3798,-1,1,156100,156300,48874,-298474,-298274,OK
670.5446,TraderOne,Tick,3797,3798,-1,1,156100,156400,48874,-298474,-298174,OK
670.796367,TraderOne,Tick,3797,3798,-1,1,156100,156400,48874,-298474,-298174,OK
671.035389,TraderOne,Tick,3797,3798,-1,1,156100,156400,48874,-298474,-298174,OK
671.273246,TraderOne,Tick,3797,3798,-1,1,156100,156400,48874,-298474,-298174,OK
671.525123,TraderOne,Tick,3797,3798,-1,1,156100,156400,48874,-298474,-298174,OK
671.74713,TraderOne,Tick,3797,3798,-1,1,156100,156200,48874,-298474,-298374,OK
672.028093,TraderOne,Tick,3797,3798,-1,1,156100,156200,48874,-298474,-298374,OK
672.297794,TraderOne,Tick,3797,3798,-1,1,156100,156200,48874,-298474,-298374,OK
672.541915,TraderOne,Tick,3797,3808,-11,11,156100,156200,49186,-298786,-297686,OK
672.768384,TraderOne,Tick,3797,3808,-11,11,156800,156200,49186,-298786,-302086,OK
673.04026,TraderOne,Tick,3797,3808,-11,11,156800,156200,49186,-298786,-302086,OK
673.277665,TraderOne,Tick,3797,3808,-11,11,156800,156200,49186,-298786,-302086,OK
673.466027,TraderOne,Tick,3797,3808,-11,11,156800,156200,49186,-298786,-302086,OK
673.750332,TraderOne,Tick,3797,3808,-11,11,156800,156200,49186,-298786,-302086,OK
673.988164,TraderOne,Tick,3807,3808,-1,1,156100,156200,49030,-300630,-300530,OK
674.272175,TraderOne,Tick,3807,3808,-1,1,156100,156200,49030,-300630,-300530,OK
674.5425,TraderOne,Tick,3807,3808,-1,1,156100,156200,49030,-300630,-300530,OK
674.780891,TraderOne,Tick,3807,3808,-1,1,156100,155800,49030,-300630,-300930,OK
674.988154,TraderOne,Tick,3807,3818,-11,11,156200,155800,49342,-297942,-301242,OK
675.252147,TraderOne,Tick,3807,3818,-11,11,156600,155800,49342,-297942,-301242,OK
675.483189,TraderOne,Tick,3807,3818,-11,11,156600,155800,49342,-297942,-301242,OK
675.756335,TraderOne,Tick,3807,3818,-11,11,156600,155800,49342,-297942,-301242,OK
676.001697,TraderOne,Tick,3807,3828,-21,21,156200,155800,49654,-296254,-302554,OK
676.260101,TraderOne,Tick,3807,3828,-21,21,156200,155800,49654,-296254,-302554,OK
676.469915,TraderOne,Tick,3807,3828,-21,21,156200,155800,49654,-296254,-302554,OK
676.75084,TraderOne,Tick,3817,3828,-11,11,155700,155800,49498,-299098,-297998,OK
676.97517,TraderOne,Tick,3827,3828,-1,1,155700,155800,49809,-297409,-297309,OK
677.297025,TraderOne,Tick,3837,3828,9,-9,155700,155800,50120,-295720,-296620,OK
677.47736,TraderOne,Tick,3847,3828,19,-19,155700,155800,50431,-295031,-296931,OK
677.752239,TraderOne,Tick,3857,3828,29,-29,155700,155800,50742,-294342,-297242,OK
677.954684,TraderOne,Tick,3857,3828,29,-29,155700,155900,50742,-294342,-300142,OK
678.214906,TraderOne,Tick,3867,3828,39,-39,155700,155900,51053,-292653,-300453,OK
678.523332,TraderOne,Tick,3867,3828,39,-39,155700,155900,51053,-292653,-300453,OK
678.72411,TraderOne,Tick,3867,3828,39,-39,155700,155900,51053,-292653,-300453,OK
679.01854,TraderOne,Tick,3867,3838,29,-29,155500,155900,51364,-295264,-303964,OK
679.287587,TraderOne,Tick,3867,3838,29,-29,155500,155700,51364,-295264,-301064,OK
679.519133,TraderOne,Tick,3867,3848,19,-19,155700,155700,51675,-297575,-297575,OK
679.738398,TraderOne,Tick,3867,3848,19,-19,155700,155700,51675,-297575,-297575,OK
680.050929,TraderOne,Tick,3867,3848,19,-19,155700,155700,51675,-297575,-297575,OK
680.202472,TraderOne,Tick,3867,3858,9,-9,155700,155700,51519,-298419,-298419,OK
680.464375,TraderOne,Tick,3877,3868,9,-9,155500,155600,51675,-296575,-297475,OK
680.73271,TraderOne,Tick,3877,3868,9,-9,155500,155600,51675,-296575,-297475,OK
680.980286,TraderOne,Tick,3877,3868,9,-9,155500,155600,51675,-296575,-297475,OK
681.232863,TraderOne,Tick,3877,3868,9,-9,155500,155600,51675,-296575,-297475,OK
681.53506,TraderOne,Tick,3877,3868,9,-9,155500,155600,51675,-296575,-297475,OK
681.79014,TraderOne,Tick,3877,3874,3,-3,155700,155600,51582,-296482,-296182,OK
681.996804,TraderOne,Tick,3877,3874,3,-3,155700,155600,51582,-296482,-296182,OK
682.232429,TraderOne,Tick,3877,3874,3,-3,155700,155700,51582,-296482,-296482,OK
682.522384,TraderOne,Tick,3877,3874,3,-3,155700,155700,51582,-296482,-296482,OK
682.787956,TraderOne,Tick,3877,3878,-1,1,156200,155400,51520,-295220,-295520,OK
683.049692,TraderOne,Tick,3877,3886,-9,9,155500,155400,51769,-294669,-295569,OK
683.233351,TraderOne,Tick,3877,3886,-9,9,155500,155400,51769,-294669,-295569,OK
683.455496,TraderOne,Tick,3877,3886,-9,9,155500,155400,51769,-294669,-295569,OK
683.737263,TraderOne,Tick,3877,3886,-9,9,155500,155400,51769,-294669,-295569,OK
683.962982,TraderOne,Tick,3877,3886,-9,9,155500,155400,51769,-294669,-295569,OK
684.264366,TraderOne,Tick,3877,3888,-11,11,155300,155400,51738,-294438,-293338,OK
684.469623,TraderOne,Tick,3877,3888,-11,11,155300,155400,51738,-294438,-293338,OK
684.715962,TraderOne,Tick,3877,3888,-11,11,155300,155400,51738,-294438,-293338,OK
684.981918,TraderOne,Tick,3877,3888,-11,11,155300,155400,51738,-294438,-293338,OK
685.283504,TraderOne,Tick,3877,3888,-11,11,155300,155400,51738,-294438,-293338,OK
685.470754,TraderOne,Tick,3877,3888,-11,11,155300,155400,51738,-294438,-293338,OK
685.778419,TraderOne,Tick,3887,3888,-1,1,155600,155500,52049,-297749,-297849,OK
686.048775,TraderOne,Tick,3887,3888,-1,1,155600,155600,52049,-297749,-297749,OK
686.269493,TraderOne,Tick,3897,3888,9,-9,155600,155600,52360,-298060,-298060,OK
686.539645,TraderOne,Tick,3907,3888,19,-19,155600,155600,52671,-298371,-298371,OK
686.713805,TraderOne,Tick,3907,3888,19,-19,155600,155600,52671,-298371,-298371,OK
686.987657,TraderOne,Tick,3907,3898,9,-9,155700,155600,52516,-299216,-298316,OK
687.27409,TraderOne,Tick,3907,3898,9,-9,155700,155600,52516,-299216,-298316,OK
687.509234,TraderOne,Tick,3907,3898,9,-9,155700,155200,52516,-299216,-296516,OK
687.733445,TraderOne,Tick,3907,3908,-1,1,155300,155200,52827,-297527,-297627,OK
688.037816,TraderOne,Tick,3907,3918,-11,11,155300,155000,53138,-295838,-299138,OK
688.248358,TraderOne,Tick,3907,3926,-19,19,155300,155000,53386,-294486,-300186,OK
688.514004,TraderOne,Tick,3907,3936,-29,29,155200,155000,53696,-292796,-298596,OK
688.776374,TraderOne,Tick,3907,3936,-29,29,155200,155000,53696,-292796,-298596,OK
688.981569,TraderOne,Tick,3907,3936,-29,29,155200,155000,53696,-292796,-298596,OK
689.276712,TraderOne,Tick,3907,3936,-29,29,155200,155000,53696,-292796,-298596,OK
689.456056,TraderOne,Tick,3907,3946,-39,39,155300,155000,53541,-289641,-301341,OK
689.73021,TraderOne,Tick,3907,3946,-39,39,155300,155000,53541,-289641,-301341,OK
690.032887,TraderOne,Tick,3907,3946,-39,39,155300,155000,53541,-289641,-301341,OK
690.293272,TraderOne,Tick,3907,3946,-39,39,155300,155100,53541,-289641,-297441,OK
690.540621,TraderOne,Tick,3907,3946,-39,39,155300,155200,53541,-289641,-293541,OK
690.748686,TraderOne,Tick,3907,3946,-39,39,155300,155200,53541,-289641,-293541,OK
690.966894,TraderOne,Tick,3907,3946,-39,39,155300,155200,53541,-289641,-293541,OK
691.203251,TraderOne,Tick,3907,3946,-39,39,155300,155200,53541,-289641,-293541,OK
691.456995,TraderOne,Tick,3907,3946,-39,39,155300,155200,53541,-289641,-293541,OK
691.739766,TraderOne,Tick,3907,3946,-39,39,155300,155200,53541,-289641,-293541,OK
691.998082,TraderOne,Tick,3917,3946,-29,29,155200,155200,53385,-294485,-294485,OK
692.287223,TraderOne,Tick,3917,3946,-29,29,155200,155200,53385,-294485,-294485,OK
692.522002,TraderOne,Tick,3917,3946,-29,29,155200,155200,53385,-294485,-294485,OK
692.781991,TraderOne,Tick,3927,3956,-29,29,155500,155200,53074,-294174,-302874,OK
693.019947,TraderOne,Tick,3927,3956,-29,29,155500,155200,53074,-294174,-302874,OK
693.294467,TraderOne,Tick,3927,3956,-29,29,155500,155200,53074,-294174,-302874,OK
693.497925,TraderOne,Tick,3927,3956,-29,29,155500,155200,53074,-294174,-302874,OK
693.762963,TraderOne,Tick,3928,3956,-28,28,155400,155100,53058,-294558,-302958,OK
694.000501,TraderOne,Tick,3928,3956,-28,28,155400,155100,53058,-294558,-302958,OK
694.303889,TraderOne,Tick,3928,3956,-28,28,155400,155100,53058,-294558,-302958,OK
694.462327,TraderOne,Tick,3928,3956,-28,28,155400,155100,53058,-294558,-302958,OK
694.735055,TraderOne,Tick,3928,3956,-28,28,155400,155100,53058,-294558,-302958,OK
695.04422,TraderOne,Tick,3928,3956,-28,28,155400,155100,53058,-294558,-302958,OK
695.271795,TraderOne,Tick,3928,3956,-28,28,155400,155100,53058,-294558,-302958,OK
695.481098,TraderOne,Tick,3928,3956,-28,28,155400,155100,53058,-294558,-302958,OK
695.733595,TraderOne,Tick,3938,3956,-18,18,155200,155100,52903,-297403,-299203,OK
695.983379,TraderOne,Tick,3938,3956,-18,18,155200,155100,52903,-297403,-299203,OK
696.23321,TraderOne,Tick,3938,3956,-18,18,155200,155100,52903,-297403,-299203,OK
696.50841,TraderOne,Tick,3938,3956,-18,18,155200,155100,52903,-297403,-299203,OK
696.794937,TraderOne,Tick,3948,3956,-8,8,155200,155100,52748,-297248,-298048,OK
697.034932,TraderOne,Tick,3958,3956,2,-2,155100,155100,52592,-299092,-299092,OK
697.23813,TraderOne,Tick,3958,3956,2,-2,155100,155600,52592,-299092,-299692,OK
697.468137,TraderOne,Tick,3958,3956,2,-2,155100,155600,52592,-299092,-299692,OK
697.703703,TraderOne,Tick,3958,3956,2,-2,155100,155700,52592,-299092,-299692,OK
698.011847,TraderOne,Tick,3968,3966,2,-2,156000,155700,52747,-299247,-298647,OK
698.28377,TraderOne,Tick,3968,3966,2,-2,156000,155700,52747,-299247,-298647,OK
698.451221,TraderOne,Tick,3968,3966,2,-2,156000,155700,52747,-299247,-298647,OK
698.726282,TraderOne,Tick,3978,3966,12,-12,155100,155700,52591,-299091,-302691,OK
699.022928,TraderOne,Tick,3978,3966,12,-12,155100,155700,52591,-299091,-302691,OK
699.257059,TraderOne,Tick,3978,3966,12,-12,155100,155700,52591,-299091,-302691,OK
699.519084,TraderOne,Tick,3978,3966,12,-12,155100,155700,52591,-299091,-302691,OK
699.765628,TraderOne,Tick,3978,3966,12,-12,155100,155700,52591,-299091,-302691,OK
700.030909,TraderOne,Tick,3978,3966,12,-12,155100,155700,52591,-299091,-302691,OK
700.258696,TraderOne,Tick,3978,3966,12,-12,155100,155700,52591,-299091,-302691,OK
700.522038,TraderOne,Tick,3978,3976,2,-2,155300,155700,52436,-299936,-300536,OK
700.777289,TraderOne,Tick,3978,3986,-8,8,155900,155700,52420,-299020,-300620,OK
701.00436,TraderOne,Tick,3978,3986,-8,8,155900,155700,52420,-299020,-300620,OK
701.219106,TraderOne,Tick,3978,3993,-15,15,155500,155200,52311,-298211,-302711,OK
701.542756,TraderOne,Tick,3978,3993,-15,15,155500,155200,52311,-298211,-302711,OK
701.771631,TraderOne,Tick,3978,3993,-15,15,155500,155200,52311,-298211,-302711,OK
701.96266,TraderOne,Tick,3978,3993,-15,15,155500,155200,52311,-298211,-302711,OK
702.21214,TraderOne,Tick,3978,4013,-35,35,155400,155200,52001,-294901,-301901,OK
702.494431,TraderOne,Tick,3988,4013,-25,25,155100,155200,51846,-298746,-296246,OK
702.737374,TraderOne,Tick,3988,4013,-25,25,155100,155200,51846,-298746,-296246,OK
703.026667,TraderOne,Tick,3988,4013,-25,25,155100,155200,51846,-298746,-296246,OK
703.221362,TraderOne,Tick,3988,4013,-25,25,155100,155200,51846,-298746,-296246,OK
703.48762,TraderOne,Tick,3988,4013,-25,25,155100,155200,51846,-298746,-296246,OK
703.760195,TraderOne,Tick,3988,4013,-25,25,155100,155200,51846,-298746,-296246,OK
704.028588,TraderOne,Tick,3988,4018,-30,30,155400,155200,52001,-297401,-303401,OK
704.311963,TraderOne,Tick,3998,4018,-20,20,154900,155000,51846,-300246,-298246,OK
704.560638,TraderOne,Tick,3998,4018,-20,20,154900,155000,51846,-300246,-298246,OK
704.766926,TraderOne,Tick,3998,4020,-22,22,155300,155000,51815,-299815,-306415,OK
705.050482,TraderOne,Tick,3998,4020,-22,22,155300,155000,51815,-299815,-306415,OK
705.27273,TraderOne,Tick,3998,4020,-22,22,155300,155000,51815,-299815,-306415,OK
705.532591,TraderOne,Tick,3998,4020,-22,22,155300,155000,51815,-299815,-306415,OK
705.746393,TraderOne,Tick,3998,4020,-22,22,155300,155000,51815,-299815,-306415,OK
706.016387,TraderOne,Tick,3998,4020,-22,22,155300,154800,51815,-299815,-306415,OK
706.282711,TraderOne,Tick,4008,4020,-12,12,154900,154800,51660,-302660,-303860,OK
706.497655,TraderOne,Tick,4008,4020,-12,12,154900,154800,51660,-302660,-303860,OK
706.784343,TraderOne,Tick,4008,4020,-12,12,154900,154600,51660,-302660,-306260,OK
706.95632,TraderOne,Tick,4008,4020,-12,12,154900,154600,51660,-302660,-306260,OK
707.289756,TraderOne,Tick,4008,4030,-22,22,154800,154600,51970,-300570,-304970,OK
707.474566,TraderOne,Tick,4008,4030,-22,22,154800,154500,51970,-300570,-307170,OK
707.762163,TraderOne,Tick,4008,4030,-22,22,154800,154700,51970,-300570,-302770,OK
708.036936,TraderOne,Tick,4018,4038,-20,20,154800,154700,51691,-300891,-302891,OK
708.253862,TraderOne,Tick,4018,4038,-20,20,154800,154700,51691,-300891,-302891,OK
708.505878,TraderOne,Tick,4026,4038,-12,12,155000,154700,51567,-303167,-306767,OK
708.735431,TraderOne,Tick,4026,4038,-12,12,155000,154600,51567,-303167,-306767,OK
709.02186,TraderOne,Tick,4026,4038,-12,12,155000,154600,51567,-303167,-306767,OK
709.238606,TraderOne,Tick,4026,4038,-12,12,155000,154600,51567,-303167,-306767,OK
709.457752,TraderOne,Tick,4026,4038,-12,12,155000,154600,51567,-303167,-306767,OK
709.72668,TraderOne,Tick,4026,4038,-12,12,155000,154600,51567,-303167,-306767,OK
710.049398,TraderOne,Tick,4026,4048,-22,22,154800,154500,51877,-301477,-308077,OK
710.236207,TraderOne,Tick,4026,4048,-22,22,154800,154500,51877,-301477,-308077,OK
710.458195,TraderOne,Tick,4026,4048,-22,22,154800,154500,51877,-301477,-308077,OK
710.785324,TraderOne,Tick,4026,4048,-22,22,154800,154500,51877,-301477,-308077,OK
711.015597,TraderOne,Tick,4026,4058,-32,32,154800,154500,52187,-298787,-308387,OK
711.259739,TraderOne,Tick,4026,4068,-42,42,155000,154400,52032,-294632,-307232,OK
711.469088,TraderOne,Tick,4026,4068,-42,42,154800,154400,52032,-294632,-307232,OK
711.738266,TraderOne,Tick,4026,4068,-42,42,154800,154400,52032,-294632,-307232,OK
712.039237,TraderOne,Tick,4026,4078,-52,52,155000,154400,51877,-288477,-304077,OK
712.201764,TraderOne,Tick,4026,4078,-52,52,154900,154400,51877,-288477,-304077,OK
712.459435,TraderOne,Tick,4036,4078,-42,42,154900,154400,52187,-294787,-307387,OK
712.749241,TraderOne,Tick,4036,4078,-42,42,154800,154400,52187,-294787,-307387,OK
713.0212,TraderOne,Tick,4036,4078,-42,42,154800,154400,52187,-294787,-307387,OK
713.20499,TraderOne,Tick,4036,4078,-42,42,154800,154400,52187,-294787,-307387,OK
713.509088,TraderOne,Tick,4046,4078,-32,32,154800,154400,52497,-300097,-309697,OK
713.731563,TraderOne,Tick,4046,4078,-32,32,154800,154400,52497,-300097,-309697,OK
713.974933,TraderOne,Tick,4046,4078,-32,32,154800,154400,52497,-300097,-309697,OK
714.210662,TraderOne,Tick,4046,4078,-32,32,154800,154200,52497,-300097,-309697,OK
714.485558,TraderOne,Tick,4046,4088,-42,42,154700,154200,52807,-294607,-307207,OK
714.773898,TraderOne,Tick,4056,4088,-32,32,154500,153800,52653,-301453,-311053,OK
714.962395,TraderOne,Tick,4056,4098,-42,42,154400,154000,52962,-297762,-310362,OK
715.299588,TraderOne,Tick,4056,4098,-42,42,154400,154100,52962,-297762,-310362,OK
715.495919,TraderOne,Tick,4056,4098,-42,42,154400,153900,52962,-297762,-310362,OK
715.768292,TraderOne,Tick,4056,4098,-42,42,154400,153900,52962,-297762,-310362,OK
715.954938,TraderOne,Tick,4056,4098,-42,42,154400,153900,52962,-297762,-310362,OK
716.20036,TraderOne,Tick,4056,4098,-42,42,154400,153800,52962,-297762,-310362,OK
716.474781,TraderOne,Tick,4056,4108,-52,52,154400,153900,53271,-293071,-308671,OK
716.788179,TraderOne,Tick,4066,4108,-42,42,154500,153900,53117,-299917,-312517,OK
717.002743,TraderOne,Tick,4066,4108,-42,42,154400,153900,53117,-299917,-312517,OK
717.296968,TraderOne,Tick,4066,4108,-42,42,154400,153900,53117,-299917,-312517,OK
717.453263,TraderOne,Tick,4066,4118,-52,52,154300,153700,53426,-295226,-310826,OK
717.771582,TraderOne,Tick,4066,4128,-62,62,154400,153700,53272,-289072,-307672,OK
717.972101,TraderOne,Tick,4076,4128,-52,52,154200,153700,53580,-295380,-310980,OK
718.217547,TraderOne,Tick,4086,4128,-42,42,154200,153700,53888,-301688,-314288,OK
718.484567,TraderOne,Tick,4086,4128,-42,42,154200,153700,53888,-301688,-314288,OK
718.80312,TraderOne,Tick,4086,4128,-42,42,154200,153600,53888,-301688,-314288,OK
719.039468,TraderOne,Tick,4086,4128,-42,42,154200,153600,53888,-301688,-314288,OK
719.28892,TraderOne,Tick,4086,4128,-42,42,154200,153600,53888,-301688,-314288,OK
719.543222,TraderOne,Tick,4086,4138,-52,52,154300,153600,53734,-296534,-312134,OK
719.704,TraderOne,Tick,4086,4138,-52,52,154300,153800,53734,-296534,-312134,OK
720.026431,TraderOne,Tick,4096,4138,-42,42,154100,153800,54043,-302843,-315443,OK
720.233547,TraderOne,Tick,4106,4138,-32,32,154200,153700,53889,-308689,-318289,OK
720.543062,TraderOne,Tick,4106,4148,-42,42,154100,153700,54197,-304997,-317597,OK
720.760899,TraderOne,Tick,4106,4148,-42,42,154100,153700,54197,-304997,-317597,OK
721.039562,TraderOne,Tick,4106,4148,-42,42,154100,153700,54197,-304997,-317597,OK
721.2013,TraderOne,Tick,4106,4148,-42,42,154100,153700,54197,-304997,-317597,OK
721.464227,TraderOne,Tick,4106,4148,-42,42,154000,153700,54197,-304997,-317597,OK
721.747369,TraderOne,Tick,4106,4148,-42,42,154000,153700,54197,-304997,-317597,OK
722.007555,TraderOne,Tick,4106,4148,-42,42,154000,153700,54197,-304997,-317597,OK
722.204121,TraderOne,Tick,4106,4148,-42,42,154000,153700,54197,-304997,-317597,OK
722.468328,TraderOne,Tick,4106,4148,-42,42,154000,153700,54197,-304997,-317597,OK
722.783999,TraderOne,Tick,4106,4158,-52,52,154000,153700,54505,-300305,-315905,OK
722.981803,TraderOne,Tick,4116,4158,-42,42,154000,153700,54813,-306613,-319213,OK
723.277063,TraderOne,Tick,4116,4158,-42,42,154100,153700,54813,-306613,-319213,OK
723.514545,TraderOne,Tick,4116,4158,-42,42,154100,153700,54813,-306613,-319213,OK
723.800646,TraderOne,Tick,4116,4158,-42,42,154100,153000,54813,-306613,-319213,OK
723.986678,TraderOne,Tick,4126,4158,-32,32,153700,153000,54659,-315459,-325059,OK
724.278705,TraderOne,Tick,4126,4158,-32,32,153700,153000,54659,-315459,-325059,OK
724.512117,TraderOne,Tick,4126,4168,-42,42,153500,153000,54966,-311766,-324366,OK
724.764189,TraderOne,Tick,4126,4168,-42,42,153500,153000,54966,-311766,-324366,OK
725.006732,TraderOne,Tick,4136,4168,-32,32,153400,152900,54813,-317613,-327213,OK
725.237652,TraderOne,Tick,4136,4168,-32,32,153400,152800,54813,-317613,-327213,OK
725.545689,TraderOne,Tick,4136,4168,-32,32,153400,152900,54813,-317613,-327213,OK
725.731127,TraderOne,Tick,4146,4168,-22,22,153100,152800,54660,-323460,-330060,OK
725.971192,TraderOne,Tick,4146,4168,-22,22,153100,152800,54660,-323460,-330060,OK
726.260188,TraderOne,Tick,4146,4168,-22,22,153100,152600,54660,-323460,-330060,OK
726.493527,TraderOne,Tick,4146,4178,-32,32,153100,152700,54966,-319766,-329366,OK
726.793559,TraderOne,Tick,4146,4188,-42,42,153100,152700,55272,-316072,-328672,OK
727.012227,TraderOne,Tick,4146,4188,-42,42,153100,152700,55272,-316072,-328672,OK
727.219356,TraderOne,Tick,4156,4188,-32,32,153200,152700,55578,-321378,-330978,OK
727.47552,TraderOne,Tick,4156,4188,-32,32,153200,152700,55578,-321378,-330978,OK
727.70932,TraderOne,Tick,4156,4198,-42,42,153500,152700,55425,-317225,-329825,OK
728.016806,TraderOne,Tick,4166,4198,-32,32,153000,152700,55272,-322072,-331672,OK
728.22704,TraderOne,Tick,4166,4198,-32,32,153000,152700,55272,-322072,-331672,OK
728.530049,TraderOne,Tick,4166,4198,-32,32,153000,152700,55272,-322072,-331672,OK
728.760641,TraderOne,Tick,4166,4198,-32,32,153000,152700,55272,-322072,-331672,OK
729.024876,TraderOne,Tick,4166,4198,-32,32,153000,152700,55272,-322072,-331672,OK
729.299032,TraderOne,Tick,4176,4198,-22,22,153000,152700,55119,-325919,-332519,OK
729.470105,TraderOne,Tick,4176,4198,-22,22,153000,152700,55119,-325919,-332519,OK
729.749314,TraderOne,Tick,4176,4201,-25,25,153200,152700,55073,-325273,-332773,OK
730.05033,TraderOne,Tick,4176,4201,-25,25,153200,152700,55073,-325273,-332773,OK
730.238335,TraderOne,Tick,4176,4201,-25,25,153200,152700,55073,-325273,-332773,OK
730.459444,TraderOne,Tick,4176,4201,-25,25,153200,152700,55073,-325273,-332773,OK
730.761089,TraderOne,Tick,4176,4201,-25,25,153200,152900,55073,-325273,-332773,OK
730.969472,TraderOne,Tick,4176,4201,-25,25,153200,152900,55073,-325273,-332773,OK
731.293676,TraderOne,Tick,4176,4201,-25,25,153200,152900,55073,-325273,-332773,OK
731.542144,TraderOne,Tick,4186,4201,-15,15,153100,152900,55379,-327579,-330579,OK
731.759867,TraderOne,Tick,4186,4201,-15,15,153100,152900,55379,-327579,-330579,OK
732.049236,TraderOne,Tick,4196,4201,-5,5,153100,152900,55685,-328885,-329885,OK
732.234955,TraderOne,Tick,4196,4201,-5,5,153100,152900,55685,-328885,-329885,OK
732.533353,TraderOne,Tick,4196,4201,-5,5,153100,152900,55685,-328885,-329885,OK
732.771617,TraderOne,Tick,4196,4201,-5,5,153100,152900,55685,-328885,-329885,OK
732.995392,TraderOne,Tick,4196,4201,-5,5,153100,152900,55685,-328885,-329885,OK
733.214202,TraderOne,Tick,4196,4201,-5,5,153100,152900,55685,-328885,-329885,OK
733.517145,TraderOne,Tick,4196,4201,-5,5,153100,152900,55685,-328885,-329885,OK
733.758082,TraderOne,Tick,4196,4201,-5,5,153100,152900,55685,-328885,-329885,OK
734.043785,TraderOne,Tick,4196,4201,-5,5,153100,152900,55685,-328885,-329885,OK
734.288433,TraderOne,Tick,4196,4201,-5,5,153100,152800,55685,-328885,-330385,OK
734.467217,TraderOne,Tick,4196,4201,-5,5,153100,152800,55685,-328885,-330385,OK
734.732642,TraderOne,Tick,4196,4201,-5,5,153100,152800,55685,-328885,-330385,OK
734.981815,TraderOne,Tick,4196,4201,-5,5,153100,152800,55685,-328885,-330385,OK
735.247404,TraderOne,Tick,4196,4201,-5,5,153100,153100,55685,-328885,-328885,OK
735.470685,TraderOne,Tick,4196,4211,-15,15,153600,152900,55532,-327732,-332232,OK
735.742358,TraderOne,Tick,4206,4211,-5,5,153000,152900,55379,-329579,-330079,OK
736.025644,TraderOne,Tick,4206,4211,-5,5,153000,152800,55379,-329579,-330579,OK
736.257933,TraderOne,Tick,4206,4221,-15,15,153000,152600,55685,-325885,-330385,OK
736.494894,TraderOne,Tick,4206,4231,-25,25,153000,152500,55991,-323191,-330691,OK
736.771687,TraderOne,Tick,4206,4231,-25,25,153000,152500,55991,-323191,-330691,OK
736.985013,TraderOne,Tick,4206,4231,-25,25,153000,152500,55991,-323191,-330691,OK
737.278664,TraderOne,Tick,4206,4231,-25,25,152800,152500,55991,-323191,-330691,OK
737.49692,TraderOne,Tick,4206,4231,-25,25,152800,152500,55991,-323191,-330691,OK
737.732639,TraderOne,Tick,4206,4231,-25,25,152800,152500,55991,-323191,-330691,OK
738.005207,TraderOne,Tick,4206,4241,-35,35,153200,152500,56297,-321497,-331997,OK
738.242758,TraderOne,Tick,4206,4241,-35,35,153200,152500,56297,-321497,-331997,OK
738.540605,TraderOne,Tick,4216,4241,-25,25,152700,152500,56144,-325344,-330344,OK
738.76262,TraderOne,Tick,4216,4241,-25,25,152700,152500,56144,-325344,-330344,OK
739.008953,TraderOne,Tick,4216,4251,-35,35,152700,152500,56449,-322649,-329649,OK
739.230508,TraderOne,Tick,4216,4251,-35,35,152700,152100,56449,-322649,-333149,OK
739.500807,TraderOne,Tick,4216,4251,-35,35,152700,152100,56449,-322649,-333149,OK
739.802579,TraderOne,Tick,4216,4251,-35,35,152600,152100,56449,-322649,-333149,OK
740.006555,TraderOne,Tick,4216,4251,-35,35,152600,152100,56449,-322649,-333149,OK
740.252723,TraderOne,Tick,4216,4251,-35,35,152600,152400,56449,-322649,-329649,OK
740.459237,TraderOne,Tick,4216,4251,-35,35,152600,152400,56449,-322649,-329649,OK
740.785964,TraderOne,Tick,4216,4251,-35,35,152600,152500,56449,-322649,-326149,OK
740.974239,TraderOne,Tick,4216,4251,-35,35,152600,152500,56449,-322649,-326149,OK
741.308614,TraderOne,Tick,4216,4251,-35,35,152600,151900,56449,-322649,-333149,OK
741.464485,TraderOne,Tick,4216,4261,-45,45,152600,151900,56754,-319954,-333454,OK
741.754467,TraderOne,Tick,4226,4261,-35,35,152600,151900,56601,-326801,-337301,OK
741.993293,TraderOne,Tick,4226,4261,-35,35,152600,151800,56601,-326801,-337301,OK
742.299523,TraderOne,Tick,4226,4261,-35,35,152600,151800,56601,-326801,-337301,OK
742.520282,TraderOne,Tick,4226,4261,-35,35,152600,151700,56601,-326801,-337301,OK
742.720579,TraderOne,Tick,4226,4261,-35,35,152600,151700,56601,-326801,-337301,OK
742.981595,TraderOne,Tick,4226,4261,-35,35,152600,151700,56601,-326801,-337301,OK
743.294898,TraderOne,Tick,4226,4261,-35,35,152600,151900,56601,-326801,-337301,OK
743.46415,TraderOne,Tick,4226,4261,-35,35,152600,151900,56601,-326801,-337301,OK
743.795336,TraderOne,Tick,4226,4261,-35,35,152600,151900,56601,-326801,-337301,OK
744.009753,TraderOne,Tick,4226,4261,-35,35,152600,151900,56601,-326801,-337301,OK
744.291328,TraderOne,Tick,4226,4261,-35,35,152600,151900,56601,-326801,-337301,OK
744.474113,TraderOne,Tick,4226,4261,-35,35,152600,151900,56601,-326801,-337301,OK
744.730706,TraderOne,Tick,4226,4261,-35,35,152600,151900,56601,-326801,-337301,OK
744.957719,TraderOne,Tick,4226,4261,-35,35,152600,151900,56601,-326801,-337301,OK
745.227106,TraderOne,Tick,4226,4261,-35,35,152600,151900,56601,-326801,-337301,OK
745.507902,TraderOne,Tick,4226,4261,-35,35,152600,151900,56601,-326801,-337301,OK
745.750287,TraderOne,Tick,4236,4261,-25,25,152200,151900,56449,-330649,-338149,OK
745.958416,TraderOne,Tick,4236,4261,-25,25,152200,151900,56449,-330649,-338149,OK
746.246374,TraderOne,Tick,4236,4261,-25,25,152200,151800,56449,-330649,-338149,OK
746.474073,TraderOne,Tick,4236,4261,-25,25,152200,151800,56449,-330649,-338149,OK
746.807273,TraderOne,Tick,4236,4261,-25,25,152200,151900,56449,-330649,-338149,OK
746.983983,TraderOne,Tick,4236,4261,-25,25,152200,151900,56449,-330649,-338149,OK
747.2739,TraderOne,Tick,4236,4271,-35,35,152100,151700,56753,-327953,-338453,OK
747.526838,TraderOne,Tick,4236,4271,-35,35,152100,151700,56753,-327953,-338453,OK
747.72951,TraderOne,Tick,4236,4281,-45,45,152100,151700,57057,-324257,-337757,OK
748.049054,TraderOne,Tick,4236,4281,-45,45,152000,151700,57057,-324257,-337757,OK
748.24044,TraderOne,Tick,4236,4281,-45,45,152000,151700,57057,-324257,-337757,OK
748.547625,TraderOne,Tick,4236,4281,-45,45,152000,151700,57057,-324257,-337757,OK
748.720189,TraderOne,Tick,4236,4281,-45,45,152000,151700,57057,-324257,-337757,OK
748.996141,TraderOne,Tick,4246,4281,-35,35,152000,151700,56905,-328105,-338605,OK
749.23769,TraderOne,Tick,4246,4281,-35,35,152000,151700,56905,-328105,-338605,OK
749.547243,TraderOne,Tick,4256,4281,-25,25,151500,151700,56753,-332953,-327953,OK
749.745608,TraderOne,Tick,4266,4281,-15,15,151400,151700,57056,-331256,-326756,OK
749.968373,TraderOne,Tick,4276,4281,-5,5,151400,151700,57359,-329559,-328059,OK
750.233387,TraderOne,Tick,4286,4281,5,-5,151400,151700,57662,-328862,-330362,OK
750.533509,TraderOne,Tick,4296,4281,15,-15,151000,151700,57556,-328656,-333156,OK
750.795641,TraderOne,Tick,4296,4281,15,-15,151000,151500,57556,-328656,-333156,OK
750.956836,TraderOne,Tick,4296,4281,15,-15,151000,151500,57556,-328656,-333156,OK
751.226189,TraderOne,Tick,4296,4281,15,-15,151000,151500,57556,-328656,-333156,OK
751.525012,TraderOne,Tick,4296,4281,15,-15,151000,151500,57556,-328656,-333156,OK
751.75218,TraderOne,Tick,4296,4281,15,-15,151000,151500,57556,-328656,-333156,OK
751.966221,TraderOne,Tick,4296,4281,15,-15,151000,151500,57556,-328656,-333156,OK
752.251573,TraderOne,Tick,4296,4281,15,-15,151000,151500,57556,-328656,-333156,OK
752.483562,TraderOne,Tick,4296,4281,15,-15,151000,151700,57556,-328656,-333156,OK
752.716708,TraderOne,Tick,4296,4281,15,-15,151000,151700,57556,-328656,-333156,OK
753.050783,TraderOne,Tick,4296,4281,15,-15,151000,151000,57556,-328656,-328656,OK
753.250144,TraderOne,Tick,4296,4281,15,-15,151000,151000,57556,-328656,-328656,OK
753.549261,TraderOne,Tick,4296,4283,13,-13,151000,151000,57616,-328916,-328916,OK
753.705666,TraderOne,Tick,4296,4283,13,-13,151000,151000,57616,-328916,-328916,OK
753.95283,TraderOne,Tick,4296,4283,13,-13,151000,151100,57616,-328916,-330216,OK
754.306245,TraderOne,Tick,4296,4283,13,-13,151000,151100,57616,-328916,-330216,OK
754.526263,TraderOne,Tick,4296,4283,13,-13,151000,151100,57616,-328916,-330216,OK
754.716733,TraderOne,Tick,4296,4283,13,-13,151000,151100,57616,-328916,-330216,OK
754.960885,TraderOne,Tick,4296,4283,13,-13,151000,151100,57616,-328916,-330216,OK
755.202452,TraderOne,Tick,4296,4283,13,-13,151000,151100,57616,-328916,-330216,OK
755.508425,TraderOne,Tick,4296,4283,13,-13,151000,151200,57616,-328916,-331516,OK
755.758561,TraderOne,Tick,4306,4283,23,-23,150800,151200,57465,-326765,-333665,OK
755.956657,TraderOne,Tick,4306,4283,23,-23,150800,151200,57465,-326765,-333665,OK
756.27068,TraderOne,Tick,4306,4290,16,-16,151300,151300,57359,-327359,-327359,OK
756.54425,TraderOne,Tick,4306,4290,16,-16,151300,151100,57359,-327359,-324159,OK
756.791766,TraderOne,Tick,4306,4290,16,-16,151300,151100,57359,-327359,-324159,OK
756.967201,TraderOne,Tick,4306,4300,6,-6,151900,151100,57208,-329208,-327408,OK
757.277724,TraderOne,Tick,4306,4300,6,-6,151900,151100,57208,-329208,-327408,OK
757.537982,TraderOne,Tick,4306,4300,6,-6,151900,151100,57208,-329208,-327408,OK
757.764443,TraderOne,Tick,4306,4300,6,-6,151900,151100,57208,-329208,-327408,OK
758.026335,TraderOne,Tick,4306,4300,6,-6,151900,151100,57208,-329208,-327408,OK
758.244886,TraderOne,Tick,4306,4310,-4,4,151900,151100,57056,-328056,-329256,OK
758.504843,TraderOne,Tick,4306,4310,-4,4,151900,151100,57056,-328056,-329256,OK
758.791018,TraderOne,Tick,4306,4310,-4,4,151900,151400,57056,-328056,-329256,OK
758.964213,TraderOne,Tick,4306,4310,-4,4,151900,151500,57056,-328056,-329256,OK
759.266373,TraderOne,Tick,4306,4310,-4,4,151900,151500,57056,-328056,-329256,OK
759.511103,TraderOne,Tick,4306,4310,-4,4,151900,151500,57056,-328056,-329256,OK
759.786354,TraderOne,Tick,4306,4320,-14,14,151800,151500,56905,-326905,-331105,OK
760.027323,TraderOne,Tick,4306,4330,-24,24,151800,151500,56753,-324753,-331953,OK
760.293689,TraderOne,Tick,4306,4330,-24,24,151800,151500,56753,-324753,-331953,OK
760.532635,TraderOne,Tick,4316,4330,-14,14,150900,151500,56602,-327602,-323402,OK
760.762002,TraderOne,Tick,4316,4330,-14,14,150900,151500,56602,-327602,-323402,OK
760.986346,TraderOne,Tick,4316,4330,-14,14,150900,151500,56602,-327602,-323402,OK
761.235403,TraderOne,Tick,4316,4330,-14,14,150900,151300,56602,-327602,-323402,OK
761.482974,TraderOne,Tick,4316,4330,-14,14,150900,151300,56602,-327602,-323402,OK
761.747033,TraderOne,Tick,4316,4340,-24,24,151800,151300,56450,-325450,-332650,OK
761.953507,TraderOne,Tick,4316,4350,-34,34,151800,151300,56298,-321298,-331498,OK
762.266382,TraderOne,Tick,4316,4350,-34,34,151800,151000,56298,-321298,-331498,OK
762.511766,TraderOne,Tick,4326,4360,-34,34,151600,151000,55996,-322996,-333196,OK
762.74031,TraderOne,Tick,4326,4360,-34,34,151600,151100,55996,-322996,-333196,OK
762.98532,TraderOne,Tick,4326,4360,-34,34,151600,151000,55996,-322996,-333196,OK
763.299871,TraderOne,Tick,4326,4360,-34,34,151600,151000,55996,-322996,-333196,OK
763.509001,TraderOne,Tick,4326,4360,-34,34,151600,151000,55996,-322996,-333196,OK
763.791513,TraderOne,Tick,4336,4360,-24,24,150800,150900,55845,-326845,-324445,OK
763.960227,TraderOne,Tick,4336,4360,-24,24,150800,150900,55845,-326845,-324445,OK
764.310866,TraderOne,Tick,4343,4360,-17,24,151000,150900,55739,-1383739,-329139,OK
764.538965,TraderOne,Tick,4343,4360,-17,17,151000,150900,55739,-328839,-330539,OK
764.705932,TraderOne,Tick,4353,4360,-7,7,150800,150900,55588,-331688,-330988,OK
765.01713,TraderOne,Tick,4353,4360,-7,7,150800,150900,55588,-331688,-330988,OK
765.268867,TraderOne,Tick,4354,4360,-6,6,150800,150900,55618,-331818,-331218,OK
765.517334,TraderOne,Tick,4354,4360,-6,6,150800,150900,55618,-331818,-331218,OK
765.703196,TraderOne,Tick,4354,4360,-6,6,150800,150900,55618,-331818,-331218,OK
765.971555,TraderOne,Tick,4354,4360,-6,6,150800,150900,55618,-331818,-331218,OK
766.23231,TraderOne,Tick,4354,4360,-6,6,150800,150900,55618,-331818,-331218,OK
766.470269,TraderOne,Tick,4364,4360,4,-4,150700,150900,55467,-332667,-333467,OK
766.742876,TraderOne,Tick,4364,4360,4,-4,150700,150900,55467,-332667,-333467,OK
767.051081,TraderOne,Tick,4374,4360,14,-14,150900,150900,55316,-333516,-333516,OK
767.264579,TraderOne,Tick,4374,4360,14,-14,150900,150900,55316,-333516,-333516,OK
767.530304,TraderOne,Tick,4374,4370,4,-4,150700,150900,55617,-335817,-336617,OK
767.789742,TraderOne,Tick,4374,4370,4,-4,150700,150700,55617,-335817,-335817,OK
767.993507,TraderOne,Tick,4374,4370,4,-4,150700,150700,55617,-335817,-335817,OK
768.288855,TraderOne,Tick,4374,4370,4,-4,150700,150700,55617,-335817,-335817,OK
768.459634,TraderOne,Tick,4374,4370,4,-4,150700,150700,55617,-335817,-335817,OK
768.76396,TraderOne,Tick,4374,4370,4,-4,150700,150700,55617,-335817,-335817,OK
769.042125,TraderOne,Tick,4374,4370,4,-4,150700,150700,55617,-335817,-335817,OK
769.265829,TraderOne,Tick,4384,4370,14,-14,150600,150700,55919,-334119,-335519,OK
769.453859,TraderOne,Tick,4394,4370,24,-24,150900,151100,56221,-332421,-337221,OK
769.79233,TraderOne,Tick,4394,4370,24,-24,150900,151100,56221,-332421,-337221,OK
770.045459,TraderOne,Tick,4394,4370,24,-24,150900,151100,56221,-332421,-337221,OK
770.244668,TraderOne,Tick,4394,4370,24,-24,150900,151100,56221,-332421,-337221,OK
770.495092,TraderOne,Tick,4394,4370,24,-24,150900,151100,56221,-332421,-337221,OK
770.748812,TraderOne,Tick,4404,4370,34,-34,150900,151100,56523,-329723,-336523,OK
771.019084,TraderOne,Tick,4404,4370,34,-34,150900,151100,56523,-329723,-336523,OK
771.220604,TraderOne,Tick,4404,4370,34,-34,150900,151100,56523,-329723,-336523,OK
771.481711,TraderOne,Tick,4404,4370,34,-34,150900,151100,56523,-329723,-336523,OK
771.715225,TraderOne,Tick,4404,4370,34,-34,150900,151100,56523,-329723,-336523,OK
772.005273,TraderOne,Tick,4404,4370,34,-34,150900,151100,56523,-329723,-336523,OK
772.29503,TraderOne,Tick,4404,4370,34,-34,150900,151100,56523,-329723,-336523,OK
772.548097,TraderOne,Tick,4404,4370,34,-34,150900,151100,56523,-329723,-336523,OK
772.753698,TraderOne,Tick,4404,4370,34,-34,150900,151100,56523,-329723,-336523,OK
772.991277,TraderOne,Tick,4404,4370,34,-34,150600,151100,56523,-329723,-339923,OK
773.29873,TraderOne,Tick,4404,4380,24,-24,151400,151100,56824,-333024,-325824,OK
773.46594,TraderOne,Tick,4404,4380,24,-24,151400,151100,56824,-333024,-325824,OK
773.732437,TraderOne,Tick,4414,4380,34,-34,150500,151100,56673,-330873,-341073,OK
774.042597,TraderOne,Tick,4414,4380,34,-34,150500,151100,56673,-330873,-341073,OK
774.277403,TraderOne,Tick,4414,4380,34,-34,150500,151100,56673,-330873,-341073,OK
774.536083,TraderOne,Tick,4414,4380,34,-34,150500,151100,56673,-330873,-341073,OK
774.748061,TraderOne,Tick,4414,4380,34,-34,150500,151100,56673,-330873,-341073,OK
775.009373,TraderOne,Tick,4414,4380,34,-34,150500,151100,56673,-330873,-341073,OK
775.28454,TraderOne,Tick,4414,4380,34,-34,150500,151100,56673,-330873,-341073,OK
775.490309,TraderOne,Tick,4414,4380,34,-34,150500,151100,56673,-330873,-341073,OK
775.725452,TraderOne,Tick,4414,4380,34,-34,150500,151100,56673,-330873,-341073,OK
776.050133,TraderOne,Tick,4414,4390,24,-24,151000,151100,56522,-334722,-337122,OK
776.260585,TraderOne,Tick,4414,4400,14,-14,151500,151100,56825,-333025,-328825,OK
776.571258,TraderOne,Tick,4414,4410,4,-4,151500,151100,57128,-331328,-330128,OK
776.74305,TraderOne,Tick,4414,4412,2,-2,151500,151100,57189,-330789,-330189,OK
777.00397,TraderOne,Tick,4414,4412,2,-2,151500,151100,57189,-330789,-330189,OK
777.220641,TraderOne,Tick,4414,4412,2,-2,151500,151100,57189,-330789,-330189,OK
777.506875,TraderOne,Tick,4414,4412,2,-2,151500,151100,57189,-330789,-330189,OK
777.759342,TraderOne,Tick,4414,4412,2,-2,151500,151100,57189,-330789,-330189,OK
777.997635,TraderOne,Tick,4414,4412,2,-2,151500,151100,57189,-330789,-330189,OK
778.251034,TraderOne,Tick,4414,4422,-8,8,151100,151100,57038,-331638,-331638,OK
778.524377,TraderOne,Tick,4414,4422,-8,8,151300,151100,57038,-331638,-333238,OK
778.787569,TraderOne,Tick,4414,4422,-8,8,151300,151100,57038,-331638,-333238,OK
779.039137,TraderOne,Tick,4414,4432,-18,18,151700,151100,56887,-330487,-335887,OK
779.24057,TraderOne,Tick,4414,4432,-18,18,151700,151100,56887,-330487,-335887,OK
779.509183,TraderOne,Tick,4414,4432,-18,18,151700,151100,56887,-330487,-335887,OK
779.759654,TraderOne,Tick,4416,4432,-16,16,151100,151100,56857,-330657,-330657,OK
780.049003,TraderOne,Tick,4416,4432,-16,16,151100,151100,56857,-330657,-330657,OK
780.275695,TraderOne,Tick,4416,4432,-16,16,151100,151100,56857,-330657,-330657,OK
780.54527,TraderOne,Tick,4416,4432,-16,16,151100,151100,56857,-330657,-330657,OK
780.744615,TraderOne,Tick,4416,4432,-16,16,151100,151100,56857,-330657,-330657,OK
781.021107,TraderOne,Tick,4416,4432,-16,16,151100,150800,56857,-330657,-335457,OK
781.30051,TraderOne,Tick,4416,4442,-26,26,151600,150800,56706,-326506,-334306,OK
781.53834,TraderOne,Tick,4416,4442,-26,26,151600,150800,56706,-326506,-334306,OK
781.766714,TraderOne,Tick,4416,4442,-26,26,151600,150800,56706,-326506,-334306,OK
782.006577,TraderOne,Tick,4416,4442,-26,26,151600,150800,56706,-326506,-334306,OK
782.269028,TraderOne,Tick,4416,4442,-26,26,151600,151200,56706,-326506,-334306,OK
782.544121,TraderOne,Tick,4416,4442,-26,26,151600,151200,56706,-326506,-334306,OK
782.792085,TraderOne,Tick,4426,4442,-16,16,150900,151400,56555,-327355,-322555,OK
783.012513,TraderOne,Tick,4426,4442,-16,16,150900,151400,56555,-327355,-322555,OK
783.223334,TraderOne,Tick,4426,4442,-16,16,150900,151400,56555,-327355,-322555,OK
783.469967,TraderOne,Tick,4426,4442,-16,16,150900,151400,56555,-327355,-322555,OK
783.753917,TraderOne,Tick,4426,4452,-26,26,151500,151400,56404,-322204,-324804,OK
783.996059,TraderOne,Tick,4426,4452,-26,26,151500,151400,56404,-322204,-324804,OK
784.21943,TraderOne,Tick,4426,4452,-26,26,151500,151400,56404,-322204,-324804,OK
784.45758,TraderOne,Tick,4426,4452,-26,26,151500,151400,56404,-322204,-324804,OK
784.779255,TraderOne,Tick,4426,4462,-36,26,151500,151400,56253,1190947,-326653,OK
784.955603,TraderOne,Tick,4426,4462,-36,36,151500,151400,56253,-320053,-323653,OK
785.286965,TraderOne,Tick,4436,4462,-26,26,150500,151400,56102,-323902,-316102,OK
785.520715,TraderOne,Tick,4436,4462,-26,26,150500,151400,56102,-323902,-316102,OK
785.715884,TraderOne,Tick,4436,4462,-26,26,150500,151400,56102,-323902,-316102,OK
785.96597,TraderOne,Tick,4446,4462,-16,16,150500,151400,55951,-326751,-321951,OK
786.237022,TraderOne,Tick,4446,4462,-16,16,150500,151400,55951,-326751,-321951,OK
786.494938,TraderOne,Tick,4446,4462,-16,16,150500,151400,55951,-326751,-321951,OK
786.73315,TraderOne,Tick,4446,4462,-16,16,150500,151400,55951,-326751,-321951,OK
786.976752,TraderOne,Tick,4446,4462,-16,16,150500,151400,55951,-326751,-321951,OK
787.217565,TraderOne,Tick,4446,4462,-16,16,150500,151400,55951,-326751,-321951,OK
787.49186,TraderOne,Tick,4456,4462,-6,16,150500,150800,55800,-1836600,-326800,OK
787.787482,TraderOne,Tick,4456,4462,-6,6,150500,150800,55800,-329600,-327800,OK
787.972219,TraderOne,Tick,4456,4472,-16,16,151400,150500,55649,-325449,-330249,OK
788.211153,TraderOne,Tick,4456,4472,-16,16,151400,150500,55649,-325449,-330249,OK
788.477651,TraderOne,Tick,4456,4472,-16,16,151400,150500,55649,-325449,-330249,OK
788.73114,TraderOne,Tick,4466,4482,-16,16,151100,150500,55347,-324147,-328947,OK
788.957053,TraderOne,Tick,4466,4482,-16,16,150500,150300,55347,-324147,-327347,OK
789.288321,TraderOne,Tick,4466,4482,-16,16,150500,150200,55347,-324147,-328947,OK
789.541282,TraderOne,Tick,4466,4492,-26,26,150500,150200,55648,-321448,-329248,OK
789.788989,TraderOne,Tick,4466,4492,-26,26,150500,150200,55648,-321448,-329248,OK
789.969348,TraderOne,Tick,4466,4492,-26,26,150500,150200,55648,-321448,-329248,OK
790.280244,TraderOne,Tick,4466,4501,-35,35,150700,150200,55512,-318612,-329112,OK
790.520049,TraderOne,Tick,4466,4502,-36,36,150900,150200,55497,-318297,-329097,OK
790.743593,TraderOne,Tick,4466,4502,-36,36,150900,150200,55497,-318297,-329097,OK
790.962405,TraderOne,Tick,4466,4502,-36,36,150900,150200,55497,-318297,-329097,OK
791.262785,TraderOne,Tick,4466,4502,-36,36,150900,150400,55497,-318297,-329097,OK
791.540623,TraderOne,Tick,4466,4512,-46,46,151100,150800,55346,-316146,-329946,OK
791.730516,TraderOne,Tick,4476,4512,-36,36,151100,150800,55648,-321448,-332248,OK
791.972392,TraderOne,Tick,4476,4512,-36,36,151100,150800,55648,-321448,-332248,OK
792.257207,TraderOne,Tick,4486,4512,-26,26,150500,150800,55497,-324297,-316497,OK
792.53419,TraderOne,Tick,4486,4512,-26,26,150500,150800,55497,-324297,-316497,OK
792.748733,TraderOne,Tick,4486,4512,-26,26,150500,150900,55497,-324297,-316497,OK
793.01481,TraderOne,Tick,4486,4512,-26,26,150500,150900,55497,-324297,-316497,OK
793.291071,TraderOne,Tick,4486,4512,-26,26,150500,150900,55497,-324297,-316497,OK
793.540055,TraderOne,Tick,4496,4512,-16,16,150300,150900,55346,-327146,-322346,OK
793.760185,TraderOne,Tick,4496,4512,-16,16,150300,151000,55346,-327146,-322346,OK
793.998852,TraderOne,Tick,4496,4512,-16,16,150300,151000,55346,-327146,-322346,OK
794.212158,TraderOne,Tick,4496,4512,-16,16,150300,151000,55346,-327146,-322346,OK
794.470578,TraderOne,Tick,4496,4512,-16,16,150300,151000,55346,-327146,-322346,OK
794.760937,TraderOne,Tick,4496,4512,-16,16,150300,151000,55346,-327146,-322346,OK
794.964621,TraderOne,Tick,4496,4512,-16,16,150300,150900,55346,-327146,-322346,OK
795.247881,TraderOne,Tick,4496,4512,-16,16,150300,150900,55346,-327146,-322346,OK
795.493185,TraderOne,Tick,4496,4512,-16,16,150300,150900,55346,-327146,-322346,OK
795.75943,TraderOne,Tick,4496,4512,-16,16,150300,150900,55346,-327146,-322346,OK
795.95488,TraderOne,Tick,4496,4522,-26,26,151500,150900,55195,-323995,-331795,OK
796.270149,TraderOne,Tick,4496,4522,-26,26,151500,150500,55195,-323995,-331795,OK
796.496551,TraderOne,Tick,4496,4522,-26,26,151500,150500,55195,-323995,-331795,OK
796.737206,TraderOne,Tick,4496,4532,-36,36,150700,150500,55496,-321296,-328496,OK
797.014642,TraderOne,Tick,4496,4532,-36,36,150700,150500,55496,-321296,-328496,OK
797.297285,TraderOne,Tick,4496,4532,-36,36,150700,150500,55496,-321296,-328496,OK
797.550435,TraderOne,Tick,4496,4532,-36,36,150700,150500,55496,-321296,-328496,OK
797.785872,TraderOne,Tick,4496,4532,-36,36,150700,150500,55496,-321296,-328496,OK
798.031115,TraderOne,Tick,4496,4532,-36,36,150700,150500,55496,-321296,-328496,OK
798.28915,TraderOne,Tick,4496,4532,-36,36,150700,150500,55496,-321296,-328496,OK
798.536447,TraderOne,Tick,4506,4532,-26,26,150700,150500,55345,-325145,-330345,OK
798.753419,TraderOne,Tick,4506,4532,-26,26,150700,150500,55345,-325145,-330345,OK
799.030513,TraderOne,Tick,4506,4532,-26,26,150700,150500,55345,-325145,-330345,OK
799.282802,TraderOne,Tick,4506,4532,-26,26,150700,150500,55345,-325145,-330345,OK
799.545192,TraderOne,Tick,4506,4532,-26,26,150700,150500,55345,-325145,-330345,OK
799.753686,TraderOne,Tick,4506,4532,-26,26,150700,150500,55345,-325145,-330345,OK
800.006279,TraderOne,Tick,4506,4532,-26,26,150700,150500,55345,-325145,-330345,OK
800.247847,TraderOne,Tick,4506,4532,-26,26,150700,150500,55345,-325145,-330345,OK
800.48451,TraderOne,Tick,4516,4532,-16,16,150400,150800,55194,-327994,-323194,OK
800.774856,TraderOne,Tick,4516,4532,-16,16,150400,150800,55194,-327994,-323194,OK
800.951918,TraderOne,Tick,4516,4532,-16,16,150400,150800,55194,-327994,-323194,OK
801.295707,TraderOne,Tick,4526,4532,-6,6,150200,150800,55043,-327843,-326043,OK
801.471518,TraderOne,Tick,4526,4532,-6,6,150200,150800,55043,-327843,-326043,OK
801.760812,TraderOne,Tick,4526,4532,-6,6,150200,150800,55043,-327843,-326043,OK
802.035995,TraderOne,Tick,4536,4532,4,-4,150800,151100,54892,-328692,-329892,OK
802.291224,TraderOne,Tick,4536,4532,4,-4,150800,151100,54892,-328692,-329892,OK
802.539636,TraderOne,Tick,4536,4532,4,-4,150800,151000,54892,-328692,-329492,OK
802.713827,TraderOne,Tick,4536,4532,4,-4,150800,151200,54892,-328692,-329892,OK
803.052307,TraderOne,Tick,4536,4532,4,-4,150800,151200,54892,-328692,-329892,OK
803.236759,TraderOne,Tick,4536,4532,4,-4,150800,151200,54892,-328692,-329892,OK
803.541018,TraderOne,Tick,4536,4532,4,-4,150800,151200,54892,-328692,-329892,OK
803.774023,TraderOne,Tick,4536,4542,-6,6,151600,151200,54741,-328541,-330341,OK
804.049722,TraderOne,Tick,4536,4542,-6,6,151600,151200,54741,-328541,-330341,OK
804.273549,TraderOne,Tick,4536,4542,-6,6,151600,150900,54741,-328541,-330341,OK
804.495454,TraderOne,Tick,4536,4542,-6,6,151600,150900,54741,-328541,-330341,OK
804.726886,TraderOne,Tick,4546,4542,4,-4,150300,150900,54590,-329390,-330590,OK
805.016345,TraderOne,Tick,4546,4542,4,-4,150300,150900,54590,-329390,-330590,OK
805.283664,TraderOne,Tick,4556,4542,14,-14,150400,150900,54439,-330239,-334439,OK
805.453994,TraderOne,Tick,4556,4542,14,-14,150400,150900,54439,-330239,-334439,OK
805.771365,TraderOne,Tick,4556,4542,14,-14,150400,150900,54439,-330239,-334439,OK
805.95884,TraderOne,Tick,4556,4542,14,-14,150400,150900,54439,-330239,-334439,OK
806.245067,TraderOne,Tick,4556,4552,4,-4,151600,150900,54288,-334088,-332888,OK
806.462672,TraderOne,Tick,4556,4552,4,-4,151600,150900,54288,-334088,-332888,OK
806.792658,TraderOne,Tick,4556,4552,4,-4,151600,151100,54288,-334088,-332888,OK
807.020377,TraderOne,Tick,4556,4562,-6,6,151800,151100,54137,-334937,-336737,OK
807.206708,TraderOne,Tick,4556,4562,-6,6,151800,151100,54137,-334937,-336737,OK
807.537594,TraderOne,Tick,4556,4562,-6,6,151800,151100,54137,-334937,-336737,OK
807.758744,TraderOne,Tick,4556,4562,-6,6,151800,151100,54137,-334937,-336737,OK
807.998479,TraderOne,Tick,4556,4562,-6,6,151800,151100,54137,-334937,-336737,OK
808.214415,TraderOne,Tick,4566,4562,4,-4,150500,151300,53986,-336786,-337986,OK
808.492285,TraderOne,Tick,4576,4562,14,-14,150600,151300,53835,-337635,-341835,OK
808.72582,TraderOne,Tick,4576,4562,14,-14,150600,151300,53835,-337635,-341835,OK
809.019797,TraderOne,Tick,4576,4562,14,-14,150600,151300,53835,-337635,-341835,OK
809.269477,TraderOne,Tick,4576,4562,14,-14,150600,151300,53835,-337635,-341835,OK
809.481437,TraderOne,Tick,4576,4572,4,-14,151800,151300,53684,1176516,-335284,OK
809.769728,TraderOne,Tick,4576,4572,4,-4,151800,151300,53684,-338484,-337284,OK
810.02479,TraderOne,Tick,4586,4572,14,-14,150800,151300,53533,-338333,-342533,OK
810.207659,TraderOne,Tick,4586,4572,14,-14,150800,151300,53533,-338333,-342533,OK
810.491639,TraderOne,Tick,4586,4572,14,-14,150800,151300,53533,-338333,-342533,OK
810.772578,TraderOne,Tick,4586,4572,14,-14,150800,151300,53533,-338333,-342533,OK
811.049097,TraderOne,Tick,4586,4582,4,-4,151800,151300,53382,-338182,-336982,OK
811.223452,TraderOne,Tick,4586,4582,4,-4,151800,151300,53382,-338182,-336982,OK
811.48105,TraderOne,Tick,4586,4582,4,-4,151800,151300,53382,-338182,-336982,OK
811.720767,TraderOne,Tick,4586,4582,4,-4,151800,151400,53382,-338182,-336982,OK
812.031072,TraderOne,Tick,4586,4582,4,-4,151800,151500,53382,-338182,-336982,OK
812.296254,TraderOne,Tick,4596,4582,14,-14,150900,151500,53231,-339031,-343231,OK
812.544515,TraderOne,Tick,4596,4582,14,-14,150900,151500,53231,-339031,-343231,OK
812.746259,TraderOne,Tick,4596,4582,14,-14,150900,151400,53231,-339031,-343231,OK
813.054699,TraderOne,Tick,4598,4582,16,-14,151200,151400,53201,-641401,-341801,OK
813.28514,TraderOne,Tick,4598,4582,16,-16,151200,151900,53201,-338601,-343401,OK
813.47654,TraderOne,Tick,4608,4582,26,-26,151700,151900,53504,-337904,-343104,OK
813.762348,TraderOne,Tick,4608,4582,26,-26,151700,152100,53504,-337904,-345704,OK
814.01796,TraderOne,Tick,4618,4582,36,-36,151700,152100,53807,-336207,-347007,OK
814.290598,TraderOne,Tick,4618,4582,36,-36,151700,152100,53807,-336207,-347007,OK
814.461583,TraderOne,Tick,4618,4582,36,-36,151700,152100,53807,-336207,-347007,OK
814.777313,TraderOne,Tick,4618,4592,26,-26,151800,152100,53655,-339055,-346855,OK
814.974619,TraderOne,Tick,4618,4592,26,-26,151800,152100,53655,-339055,-346855,OK
815.265677,TraderOne,Tick,4618,4597,21,-21,151800,152100,53579,-340479,-346779,OK
815.543334,TraderOne,Tick,4628,4597,31,-31,151400,152100,53427,-337327,-346627,OK
815.734161,TraderOne,Tick,4628,4597,31,-31,151400,152100,53427,-337327,-346627,OK
816.005688,TraderOne,Tick,4628,4597,31,-31,151400,152100,53427,-337327,-346627,OK
816.222874,TraderOne,Tick,4638,4597,41,-41,151900,152100,53731,-334631,-342831,OK
816.543025,TraderOne,Tick,4648,4597,51,-51,151900,152100,54035,-331935,-342135,OK
816.727989,TraderOne,Tick,4648,4597,51,-51,151900,152100,54035,-331935,-342135,OK
817.030946,TraderOne,Tick,4648,4597,51,-51,151900,152100,54035,-331935,-342135,OK
817.218083,TraderOne,Tick,4648,4597,51,-51,151900,152100,54035,-331935,-342135,OK
817.506452,TraderOne,Tick,4648,4607,41,-41,151900,152100,53883,-336783,-344983,OK
817.761988,TraderOne,Tick,4658,4607,51,-51,151600,152100,53731,-332631,-347931,OK
817.987588,TraderOne,Tick,4658,4617,41,-41,151900,152100,53579,-338479,-346679,OK
818.236481,TraderOne,Tick,4658,4617,41,-41,151900,152100,53579,-338479,-346679,OK
818.452444,TraderOne,Tick,4658,4617,41,-41,151900,152400,53579,-338479,-350779,OK
818.765226,TraderOne,Tick,4668,4617,51,-51,151900,152400,53883,-334783,-350083,OK
818.981226,TraderOne,Tick,4678,4617,61,-61,151900,152400,54187,-330087,-348387,OK
819.287957,TraderOne,Tick,4678,4617,61,-61,151900,152300,54187,-330087,-348387,OK
819.544914,TraderOne,Tick,4678,4627,51,-51,151600,152300,54490,-335390,-350690,OK
819.709055,TraderOne,Tick,4678,4627,51,-51,151600,152300,54490,-335390,-350690,OK
820.049432,TraderOne,Tick,4678,4627,51,-51,151600,152300,54490,-335390,-350690,OK
820.234494,TraderOne,Tick,4678,4627,51,-51,151600,152300,54490,-335390,-350690,OK
820.540178,TraderOne,Tick,4678,4627,51,-51,151600,152300,54490,-335390,-350690,OK
820.770235,TraderOne,Tick,4688,4627,61,-61,151900,152300,54794,-330694,-348994,OK
820.975881,TraderOne,Tick,4688,4627,61,-61,151900,152300,54794,-330694,-348994,OK
821.217887,TraderOne,Tick,4688,4637,51,-51,151800,152300,55098,-336998,-352298,OK
821.476736,TraderOne,Tick,4698,4637,61,-61,151900,152300,55402,-332302,-350602,OK
821.767914,TraderOne,Tick,4698,4637,61,-61,151900,152300,55402,-332302,-350602,OK
822.005993,TraderOne,Tick,4698,4637,61,-61,151900,152500,55402,-332302,-350602,OK
822.217147,TraderOne,Tick,4698,4637,61,-61,151900,152500,55402,-332302,-350602,OK
822.542317,TraderOne,Tick,4698,4647,51,-51,151900,152500,55250,-339150,-354450,OK
822.735161,TraderOne,Tick,4698,4647,51,-51,151900,152500,55250,-339150,-354450,OK
823.038838,TraderOne,Tick,4698,4657,41,-41,151900,152300,55554,-344454,-356754,OK
823.29133,TraderOne,Tick,4698,4657,41,-41,151900,152300,55554,-344454,-356754,OK
823.46429,TraderOne,Tick,4698,4667,31,-31,152100,152100,55402,-348302,-348302,OK
823.711112,TraderOne,Tick,4698,4667,31,-31,152100,152100,55402,-348302,-348302,OK
824.025958,TraderOne,Tick,4698,4667,31,-31,152100,152200,55402,-348302,-351402,OK
824.299261,TraderOne,Tick,4698,4667,31,-31,152100,152200,55402,-348302,-351402,OK
824.498335,TraderOne,Tick,4698,4667,31,-31,152100,152200,55402,-348302,-351402,OK
824.767135,TraderOne,Tick,4698,4667,31,-31,152100,152000,55402,-348302,-345202,OK
824.960325,TraderOne,Tick,4708,4667,41,-41,151500,152000,55250,-345150,-357450,OK
825.228429,TraderOne,Tick,4708,4667,41,-41,151500,152000,55250,-345150,-357450,OK
825.497635,TraderOne,Tick,4708,4667,41,-41,151500,152000,55250,-345150,-357450,OK
825.745817,TraderOne,Tick,4708,4667,41,-41,151500,152000,55250,-345150,-357450,OK
826.04461,TraderOne,Tick,4708,4667,41,-41,151500,152000,55250,-345150,-357450,OK
826.235258,TraderOne,Tick,4708,4667,41,-41,151500,152000,55250,-345150,-357450,OK
826.502355,TraderOne,Tick,4708,4667,41,-41,151500,152000,55250,-345150,-357450,OK
826.774784,TraderOne,Tick,4708,4667,41,-41,151500,152000,55250,-345150,-357450,OK
826.977847,TraderOne,Tick,4708,4667,41,-41,151500,152000,55250,-345150,-357450,OK
827.24132,TraderOne,Tick,4718,4667,51,-51,151500,152000,55098,-340998,-356298,OK
827.489853,TraderOne,Tick,4718,4667,51,-51,151500,152000,55098,-340998,-356298,OK
827.776475,TraderOne,Tick,4728,4667,61,-61,151500,152000,54946,-335846,-354146,OK
828.028264,TraderOne,Tick,4728,4667,61,-61,151500,152000,54946,-335846,-354146,OK
828.266625,TraderOne,Tick,4728,4677,51,-51,151500,152000,54794,-345694,-360994,OK
828.480378,TraderOne,Tick,4728,4677,51,-51,151500,152300,54794,-345694,-360994,OK
828.72022,TraderOne,Tick,4728,4687,41,-41,152200,152300,54642,-350542,-354642,OK
828.950813,TraderOne,Tick,4728,4687,41,-41,152200,152300,54642,-350542,-354642,OK
829.210563,TraderOne,Tick,4728,4687,41,-41,152200,152500,54642,-350542,-362842,OK
829.514723,TraderOne,Tick,4728,4687,41,-41,152200,152500,54642,-350542,-362842,OK
829.721039,TraderOne,Tick,4728,4697,31,-31,152200,152500,54490,-353390,-362690,OK
829.971827,TraderOne,Tick,4728,4697,31,-31,152200,152400,54490,-353390,-359590,OK
830.297468,TraderOne,Tick,4728,4697,31,-31,152200,152400,54490,-353390,-359590,OK
830.464256,TraderOne,Tick,4738,4697,41,-41,151800,152400,54338,-350238,-362538,OK
830.79178,TraderOne,Tick,4748,4697,51,-51,151800,152500,54186,-346086,-361386,OK
830.973885,TraderOne,Tick,4748,4707,41,-41,152000,152500,54490,-351390,-363690,OK
831.289996,TraderOne,Tick,4748,4707,41,-41,152000,152500,54490,-351390,-363690,OK
831.510166,TraderOne,Tick,4748,4707,41,-41,152000,152500,54490,-351390,-363690,OK
831.800005,TraderOne,Tick,4748,4717,31,-31,152100,152600,54338,-355238,-364538,OK
831.99035,TraderOne,Tick,4758,4717,41,-41,152200,152600,54642,-352542,-364842,OK
832.278118,TraderOne,Tick,4758,4717,41,-41,152200,152500,54642,-352542,-364842,OK
832.529239,TraderOne,Tick,4758,4717,41,-41,152000,152500,54642,-352542,-364842,OK
832.744938,TraderOne,Tick,4758,4717,41,-41,152000,152500,54642,-352542,-364842,OK
833.005137,TraderOne,Tick,4758,4717,41,-41,152000,152600,54642,-352542,-364842,OK
833.241199,TraderOne,Tick,4768,4717,51,-51,152200,152600,54946,-349846,-365146,OK
833.490392,TraderOne,Tick,4768,4717,51,-51,152200,152600,54946,-349846,-365146,OK
833.778976,TraderOne,Tick,4768,4717,51,-51,152200,152600,54946,-349846,-365146,OK
833.981898,TraderOne,Tick,4768,4717,51,-51,152200,152600,54946,-349846,-365146,OK
834.23253,TraderOne,Tick,4768,4717,51,-51,152200,152600,54946,-349846,-365146,OK
834.538423,TraderOne,Tick,4768,4717,51,-51,152200,152600,54946,-349846,-365146,OK
834.723744,TraderOne,Tick,4768,4717,51,-51,152200,152400,54946,-349846,-360046,OK
834.981353,TraderOne,Tick,4768,4727,41,-41,151800,152400,55250,-356150,-368450,OK
835.2283,TraderOne,Tick,4768,4727,41,-41,151800,152400,55250,-356150,-368450,OK
835.545407,TraderOne,Tick,4768,4727,41,-41,151800,152400,55250,-356150,-368450,OK
835.800394,TraderOne,Tick,4768,4727,41,-41,151800,152400,55250,-356150,-368450,OK
835.971212,TraderOne,Tick,4768,4737,31,-31,152200,152400,55098,-359998,-366198,OK
836.263768,TraderOne,Tick,4768,4737,31,-31,152200,152200,55098,-359998,-359998,OK
836.531115,TraderOne,Tick,4768,4737,31,-31,152000,152200,55098,-359998,-366198,OK
836.769176,TraderOne,Tick,4768,4737,31,-31,152000,152200,55098,-359998,-366198,OK
836.993328,TraderOne,Tick,4768,4737,31,-31,152000,152200,55098,-359998,-366198,OK
837.272456,TraderOne,Tick,4778,4737,41,-41,151600,152200,54946,-355846,-368146,OK
837.500689,TraderOne,Tick,4778,4737,41,-41,151600,152200,54946,-355846,-368146,OK
837.726952,TraderOne,Tick,4778,4737,41,-41,151600,152200,54946,-355846,-368146,OK
838.001147,TraderOne,Tick,4778,4747,31,-31,152000,152200,54794,-360694,-366894,OK
838.23286,TraderOne,Tick,4778,4757,21,-21,152100,152200,55098,-362998,-365098,OK
838.456127,TraderOne,Tick,4778,4767,11,-11,152100,152200,55402,-365302,-366402,OK
838.783926,TraderOne,Tick,4778,4777,1,-1,152100,152100,55706,-366606,-366606,OK
839.034052,TraderOne,Tick,4778,4787,-9,9,152300,152100,55554,-366454,-368254,OK
839.260643,TraderOne,Tick,4778,4787,-9,9,152300,152100,55554,-366454,-368254,OK
839.523566,TraderOne,Tick,4782,4787,-5,5,152200,152100,55493,-365993,-366493,OK
839.782789,TraderOne,Tick,4782,4787,-5,5,152200,152100,55493,-365993,-366493,OK
839.976934,TraderOne,Tick,4782,4787,-5,5,152200,152100,55493,-365993,-366493,OK
840.279816,TraderOne,Tick,4782,4787,-5,5,152200,152100,55493,-365993,-366493,OK
840.491465,TraderOne,Tick,4788,4787,1,-1,152100,152100,55402,-364702,-364702,OK
840.745052,TraderOne,Tick,4798,4787,11,-11,152300,152100,55707,-364007,-361807,OK
841.015565,TraderOne,Tick,4808,4787,21,-21,152300,152100,56012,-362312,-358112,OK
841.286179,TraderOne,Tick,4818,4787,31,-31,152400,152100,56316,-360716,-351416,OK
841.505564,TraderOne,Tick,4818,4787,31,-31,152400,152400,56316,-360716,-360716,OK
841.743318,TraderOne,Tick,4818,4797,21,-21,152100,152400,56620,-364020,-370320,OK
842.005031,TraderOne,Tick,4818,4797,21,-21,152100,152400,56620,-364020,-370320,OK
842.284347,TraderOne,Tick,4818,4807,11,-11,152100,152400,56924,-366324,-369624,OK
842.480006,TraderOne,Tick,4818,4807,11,-11,152100,152400,56924,-366324,-369624,OK
842.785055,TraderOne,Tick,4818,4807,11,-11,152100,152400,56924,-366324,-369624,OK
843.036526,TraderOne,Tick,4818,4807,11,-11,152100,152400,56924,-366324,-369624,OK
843.286199,TraderOne,Tick,4818,4807,11,-11,152100,152400,56924,-366324,-369624,OK
843.516103,TraderOne,Tick,4818,4807,11,-11,152100,152400,56924,-366324,-369624,OK
843.799088,TraderOne,Tick,4818,4807,11,-11,152100,152400,56924,-366324,-369624,OK
844.007589,TraderOne,Tick,4818,4807,11,-11,152100,152400,56924,-366324,-369624,OK
844.240287,TraderOne,Tick,4818,4807,11,-11,152100,152700,56924,-366324,-369624,OK
844.547106,TraderOne,Tick,4828,4807,21,-21,152400,153000,57229,-363629,-369929,OK
844.799172,TraderOne,Tick,4838,4807,31,-31,152400,153100,57534,-358934,-368234,OK
844.971255,TraderOne,Tick,4848,4807,41,-41,152500,153100,57839,-355239,-367539,OK
845.25857,TraderOne,Tick,4858,4807,51,-51,152500,152900,58144,-352544,-367844,OK
845.45984,TraderOne,Tick,4858,4807,51,-51,152500,152900,58144,-352544,-367844,OK
845.759294,TraderOne,Tick,4858,4817,41,-41,152100,152400,58448,-357848,-370148,OK
846.02056,TraderOne,Tick,4858,4827,31,-31,152100,152400,58752,-362152,-371452,OK
846.20694,TraderOne,Tick,4858,4827,31,-31,152100,152400,58752,-362152,-371452,OK
846.494207,TraderOne,Tick,4858,4827,31,-31,152100,152400,58752,-362152,-371452,OK
846.714396,TraderOne,Tick,4858,4827,31,-31,152100,152400,58752,-362152,-371452,OK
847.020846,TraderOne,Tick,4860,4827,33,-33,152500,152400,58813,-361613,-358313,OK
847.285982,TraderOne,Tick,4860,4827,33,-33,152500,152700,58813,-361613,-368213,OK
847.550201,TraderOne,Tick,4860,4827,33,-33,152500,152700,58813,-361613,-368213,OK
847.746648,TraderOne,Tick,4860,4827,33,-33,152500,152700,58813,-361613,-368213,OK
848.04793,TraderOne,Tick,4860,4837,23,-23,152400,152700,58661,-368461,-375361,OK
848.258236,TraderOne,Tick,4870,4837,33,-33,152600,152700,58966,-365366,-368666,OK
848.536452,TraderOne,Tick,4880,4837,43,-43,152600,152700,59271,-362671,-366971,OK
848.763319,TraderOne,Tick,4880,4837,43,-43,152600,152700,59271,-362671,-366971,OK
848.986892,TraderOne,Tick,4890,4837,53,-53,152600,152700,59576,-358976,-364276,OK
849.28834,TraderOne,Tick,4890,4837,53,-53,152600,152900,59576,-358976,-374876,OK
849.534507,TraderOne,Tick,4890,4847,43,-43,152600,153100,59881,-364281,-377181,OK
849.741284,TraderOne,Tick,4890,4847,43,-43,152600,153100,59881,-364281,-377181,OK
849.955122,TraderOne,Tick,4890,4847,43,-43,152700,153100,59881,-364281,-377181,OK
850.264085,TraderOne,Tick,4890,4847,43,-43,152700,153100,59881,-364281,-377181,OK
850.561929,TraderOne,Tick,4890,4847,43,-43,152700,153200,59881,-364281,-377181,OK
850.753302,TraderOne,Tick,4900,4847,53,-53,152700,153200,60187,-359087,-374987,OK
850.965558,TraderOne,Tick,4910,4847,63,-63,152700,153200,60492,-354392,-373292,OK
851.204936,TraderOne,Tick,4910,4847,63,-63,152700,153200,60492,-354392,-373292,OK
851.537665,TraderOne,Tick,4910,4847,63,-63,152700,153800,60492,-354392,-373292,OK
851.715475,TraderOne,Tick,4920,4857,63,-63,153200,153800,60644,-351544,-370444,OK
852.050021,TraderOne,Tick,4920,4857,63,-63,153200,153700,60644,-351544,-370444,OK
852.207949,TraderOne,Tick,4920,4857,63,-63,153200,153700,60644,-351544,-370444,OK
852.499554,TraderOne,Tick,4920,4857,63,-63,153200,153700,60644,-351544,-370444,OK
852.754486,TraderOne,Tick,4920,4857,63,-63,153000,153600,60644,-351544,-370444,OK
852.992395,TraderOne,Tick,4920,4857,63,-63,153000,153600,60644,-351544,-370444,OK
853.289665,TraderOne,Tick,4920,4867,53,-53,153400,154100,60491,-359391,-375291,OK
853.471804,TraderOne,Tick,4920,4867,53,-53,153400,154100,60491,-359391,-375291,OK
853.74853,TraderOne,Tick,4920,4867,53,-53,153400,154000,60491,-359391,-375291,OK
853.957601,TraderOne,Tick,4920,4867,53,-53,153400,154000,60491,-359391,-375291,OK
854.266934,TraderOne,Tick,4920,4877,43,-43,153500,153900,60338,-364238,-377138,OK
854.516454,TraderOne,Tick,4920,4877,43,-43,153500,153900,60338,-364238,-377138,OK
854.717985,TraderOne,Tick,4920,4877,43,-43,153500,153900,60338,-364238,-377138,OK
854.955107,TraderOne,Tick,4920,4877,43,-43,153500,153900,60338,-364238,-377138,OK
855.208453,TraderOne,Tick,4920,4877,43,-43,153500,153900,60338,-364238,-377138,OK
855.481099,TraderOne,Tick,4920,4877,43,-43,153500,153900,60338,-364238,-377138,OK
855.750699,TraderOne,Tick,4920,4877,43,-43,153500,153900,60338,-364238,-377138,OK
855.959006,TraderOne,Tick,4920,4877,43,-43,153500,153800,60338,-364238,-377138,OK
856.241025,TraderOne,Tick,4920,4877,43,-43,153500,153800,60338,-364238,-377138,OK
856.549902,TraderOne,Tick,4920,4877,43,-43,153500,153700,60338,-364238,-372838,OK
856.788729,TraderOne,Tick,4920,4887,33,-33,153300,154000,60185,-370085,-379985,OK
856.979035,TraderOne,Tick,4920,4887,33,-33,153300,154000,60185,-370085,-379985,OK
857.226445,TraderOne,Tick,4920,4887,33,-33,153300,154000,60185,-370085,-379985,OK
857.466832,TraderOne,Tick,4920,4887,33,-33,153300,154000,60185,-370085,-379985,OK
857.715495,TraderOne,Tick,4930,4887,43,-43,153700,154000,60492,-367392,-380292,OK
858.048183,TraderOne,Tick,4930,4887,43,-43,153700,154000,60492,-367392,-380292,OK
858.274563,TraderOne,Tick,4930,4887,43,-43,153700,154000,60492,-367392,-380292,OK
858.503322,TraderOne,Tick,4930,4887,43,-43,153700,154000,60492,-367392,-380292,OK
858.794559,TraderOne,Tick,4930,4897,33,-33,153700,154000,60338,-370238,-380138,OK
859.035305,TraderOne,Tick,4930,4897,33,-33,153700,154000,60338,-370238,-380138,OK
859.225317,TraderOne,Tick,4930,4897,33,-33,153700,153600,60338,-370238,-366938,OK
859.520553,TraderOne,Tick,4940,4897,43,-43,153200,153800,60185,-368085,-380985,OK
859.746472,TraderOne,Tick,4940,4897,43,-43,153200,153800,60185,-368085,-380985,OK
859.954133,TraderOne,Tick,4940,4897,43,-43,153200,153600,60185,-368085,-380985,OK
860.267185,TraderOne,Tick,4940,4907,33,-33,153700,153600,60032,-370932,-367632,OK
860.501459,TraderOne,Tick,4940,4907,33,-33,153700,153600,60032,-370932,-367632,OK
860.715765,TraderOne,Tick,4940,4907,33,-33,153700,153600,60032,-370932,-367632,OK
860.970998,TraderOne,Tick,4940,4907,33,-33,153700,153600,60032,-370932,-367632,OK
861.201599,TraderOne,Tick,4940,4917,23,-23,153700,153600,59879,-373779,-371479,OK
861.482885,TraderOne,Tick,4940,4917,23,-23,153700,153700,59879,-373779,-373779,OK
861.705878,TraderOne,Tick,4940,4917,23,-23,153700,153700,59879,-373779,-373779,OK
861.977784,TraderOne,Tick,4940,4917,23,-23,153700,153600,59879,-373779,-371479,OK
862.267476,TraderOne,Tick,4940,4927,13,-13,153900,153600,59725,-375625,-371725,OK
862.517763,TraderOne,Tick,4950,4930,20,-20,153600,153600,59526,-373726,-373726,OK
862.795123,TraderOne,Tick,4950,4930,20,-20,153600,153400,59526,-373726,-369726,OK
863.0267,TraderOne,Tick,4950,4930,20,-20,153600,153300,59526,-373726,-367726,OK
863.223816,TraderOne,Tick,4950,4940,10,-10,152900,153000,59832,-376032,-377032,OK
863.546815,TraderOne,Tick,4950,4950,0,0,153000,153000,59679,-377879,-377879,OK
863.757407,TraderOne,Tick,4950,4960,-10,10,153200,153000,59985,-378185,-380185,OK
864.045515,TraderOne,Tick,4950,4970,-20,20,152900,153000,60291,-376491,-374491,OK
864.2883,TraderOne,Tick,4950,4980,-30,30,153400,153000,60230,-374430,-383430,OK
864.50119,TraderOne,Tick,4950,4980,-30,30,153400,153000,60230,-374430,-383430,OK
864.790501,TraderOne,Tick,4950,4990,-40,40,153400,153000,60077,-371277,-383277,OK
865.028786,TraderOne,Tick,4950,4990,-40,40,153400,153000,60077,-371277,-383277,OK
865.215722,TraderOne,Tick,4958,4990,-32,32,153200,153000,59954,-375154,-381554,OK
865.511088,TraderOne,Tick,4958,4990,-32,32,153200,153000,59954,-375154,-381554,OK
865.702312,TraderOne,Tick,4958,4990,-32,32,153200,153000,59954,-375154,-381554,OK
865.991711,TraderOne,Tick,4958,5000,-42,42,153400,153000,59801,-371001,-383601,OK
866.278449,TraderOne,Tick,4958,5000,-42,42,153400,152900,59801,-371001,-383601,OK
