Time,Team,Operation,BuyVolume,SellVolume,EtfPosition,FuturePosition,EtfPrice,FuturePrice,TotalFees,AccountBalance,ProfitOrLoss,Status
2e-06,TraderOne,Tick,0,0,0,0,,,0,0,0,OK
0.225434,TraderOne,Tick,0,0,0,0,,,0,0,0,OK
0.525415,TraderOne,Tick,0,0,0,0,,,0,0,0,OK
0.755451,TraderOne,Tick,0,0,0,0,,,0,0,0,OK
0.983641,TraderOne,Tick,0,10,-10,10,147600,,-147,147,147,OK
1.228647,TraderOne,Tick,1,10,-9,9,147100,147100,-162,162,162,OK
1.457162,TraderOne,Tick,1,10,-9,9,147100,147100,-162,162,162,OK
1.700863,TraderOne,Tick,1,10,-9,9,147100,147100,-162,162,162,OK
2.016488,TraderOne,Tick,1,10,-9,9,147100,147000,-162,162,-738,OK
2.284654,TraderOne,Tick,1,10,-9,9,147100,146900,-162,162,-1638,OK
2.548052,TraderOne,Tick,11,10,1,-1,146400,146900,-309,-1691,-1891,OK
2.703369,TraderOne,Tick,11,10,1,-1,146400,146900,-309,-1691,-1891,OK
2.981634,TraderOne,Tick,11,10,1,-1,146400,146900,-309,-1691,-1891,OK
3.263489,TraderOne,Tick,11,10,1,-1,146400,146900,-309,-1691,-1891,OK
3.461861,TraderOne,Tick,11,20,-9,9,147500,146900,-456,-1544,-3344,OK
3.758536,TraderOne,Tick,21,20,1,-1,146300,146900,-603,-2397,-2597,OK
3.993366,TraderOne,Tick,21,20,1,-1,146300,146900,-603,-2397,-2597,OK
4.249783,TraderOne,Tick,21,20,1,-1,146300,146900,-603,-2397,-2597,OK
4.519209,TraderOne,Tick,31,20,11,-11,146300,146900,-750,-2250,-4450,OK
4.782982,TraderOne,Tick,31,20,11,-11,146300,146900,-750,-2250,-4450,OK
4.953644,TraderOne,Tick,31,20,11,-11,146300,146900,-750,-2250,-4450,OK
5.207681,TraderOne,Tick,31,20,11,-11,146300,146800,-750,-2250,-4450,OK
5.524887,TraderOne,Tick,31,20,11,-11,146300,146800,-750,-2250,-4450,OK
5.703518,TraderOne,Tick,31,20,11,-11,146300,146800,-750,-2250,-4450,OK
6.033173,TraderOne,Tick,31,30,1,-1,147000,146800,-456,-2544,-2344,OK
6.24523,TraderOne,Tick,31,40,-9,9,147000,146800,-162,-1838,-3638,OK
6.540601,TraderOne,Tick,31,50,-19,19,147000,146800,132,868,-2932,OK
6.789652,TraderOne,Tick,31,60,-29,29,147200,146700,426,3574,-2226,OK
7.012355,TraderOne,Tick,31,60,-29,29,147200,146900,426,3574,-2226,OK
7.222758,TraderOne,Tick,31,60,-29,29,147200,146900,426,3574,-2226,OK
7.515584,TraderOne,Tick,31,60,-29,29,147200,146900,426,3574,-2226,OK
7.715523,TraderOne,Tick,31,60,-29,29,147200,146900,426,3574,-2226,OK
8.029236,TraderOne,Tick,31,60,-29,29,147200,146900,426,3574,-2226,OK
8.21653,TraderOne,Tick,41,60,-19,19,147000,146900,279,721,-1179,OK
8.506152,TraderOne,Tick,41,60,-19,19,147000,146900,279,721,-1179,OK
8.77623,TraderOne,Tick,41,60,-19,19,147000,146900,279,721,-1179,OK
8.952137,TraderOne,Tick,51,60,-9,9,146700,146900,132,-1132,668,OK
9.248268,TraderOne,Tick,61,60,1,-1,146400,146900,425,1575,1375,OK
9.453816,TraderOne,Tick,71,60,11,-11,146400,146900,718,4282,2082,OK
9.736204,TraderOne,Tick,81,60,21,-21,146400,146900,1011,5989,1789,OK
10.021358,TraderOne,Tick,81,60,21,-21,146400,146900,1011,5989,1789,OK
10.284062,TraderOne,Tick,91,60,31,-31,146400,146900,1304,7696,1496,OK
10.462196,TraderOne,Tick,101,60,41,-41,146400,146900,1597,11403,3203,OK
10.733551,TraderOne,Tick,111,60,51,-51,146200,147000,1890,15110,4910,OK
10.960494,TraderOne,Tick,111,80,31,-31,147300,147000,1597,3403,9603,OK
11.233278,TraderOne,Tick,111,80,31,-31,147300,147000,1597,3403,9603,OK
11.450045,TraderOne,Tick,111,80,31,-31,147300,147000,1597,3403,9603,OK
11.779636,TraderOne,Tick,111,90,21,-21,147400,147200,1450,550,4750,OK
12.005333,TraderOne,Tick,111,90,21,-21,147400,147200,1450,550,4750,OK
12.240278,TraderOne,Tick,111,90,21,-21,147400,147200,1450,550,4750,OK
12.520308,TraderOne,Tick,111,90,21,-21,147400,147200,1450,550,4750,OK
12.721715,TraderOne,Tick,111,90,21,-21,147400,147200,1450,550,4750,OK
12.957473,TraderOne,Tick,111,90,21,-21,147400,147200,1450,550,4750,OK
13.213711,TraderOne,Tick,121,90,31,-31,146700,147200,1303,2697,-3503,OK
13.48511,TraderOne,Tick,121,90,31,-31,146700,147200,1303,2697,-3503,OK
13.722587,TraderOne,Tick,121,90,31,-31,146700,147200,1303,2697,-3503,OK
13.966331,TraderOne,Tick,121,97,24,-24,146700,147200,1508,392,-4408,OK
14.298207,TraderOne,Tick,121,97,24,-24,146700,147200,1508,392,-4408,OK
14.53044,TraderOne,Tick,121,97,24,-24,146700,147200,1508,392,-4408,OK
14.727218,TraderOne,Tick,121,97,24,-24,146700,147200,1508,392,-4408,OK
14.970561,TraderOne,Tick,121,97,24,-24,146700,147200,1508,392,-4408,OK
15.215207,TraderOne,Tick,121,97,24,-24,146700,147200,1508,392,-4408,OK
15.451216,TraderOne,Tick,121,107,14,-14,146900,146800,1361,-1461,-61,OK
15.753908,TraderOne,Tick,121,107,14,-14,146900,146800,1361,-1461,-61,OK
15.974214,TraderOne,Tick,121,117,4,-4,146900,146900,1214,-4314,-4314,OK
16.205196,TraderOne,Tick,121,117,4,-4,146900,146900,1214,-4314,-4314,OK
16.483889,TraderOne,Tick,121,117,4,-4,146900,146900,1214,-4314,-4314,OK
16.7822,TraderOne,Tick,121,117,4,-4,146900,146900,1214,-4314,-4314,OK
17.035299,TraderOne,Tick,121,117,4,-4,146900,146900,1214,-4314,-4314,OK
17.241482,TraderOne,Tick,121,117,4,-4,146900,146900,1214,-4314,-4314,OK
17.512756,TraderOne,Tick,121,117,4,-4,146900,146900,1214,-4314,-4314,OK
17.773864,TraderOne,Tick,131,117,14,-14,146900,146900,1508,-3608,-3608,OK
18.045722,TraderOne,Tick,141,117,24,-24,146600,146900,1802,-2902,-7702,OK
18.209273,TraderOne,Tick,141,117,24,-24,146600,146900,1802,-2902,-7702,OK
18.550975,TraderOne,Tick,141,117,24,-24,146600,147100,1802,-2902,-7702,OK
18.723668,TraderOne,Tick,141,117,24,-24,146600,147100,1802,-2902,-7702,OK
18.956789,TraderOne,Tick,141,117,24,-24,146600,147100,1802,-2902,-7702,OK
19.218655,TraderOne,Tick,141,117,24,-24,146600,147100,1802,-2902,-7702,OK
19.508442,TraderOne,Tick,141,117,24,-24,146600,147200,1802,-2902,-7702,OK
19.735124,TraderOne,Tick,151,117,34,-34,146900,147200,2096,-1196,-7996,OK
19.98064,TraderOne,Tick,151,117,34,-34,146900,147200,2096,-1196,-7996,OK
20.293541,TraderOne,Tick,161,117,44,-44,146900,147200,2390,1510,-7290,OK
20.537709,TraderOne,Tick,171,117,54,-54,146900,147900,2684,6216,-4584,OK
20.71676,TraderOne,Tick,181,117,64,-64,147200,147900,2978,13922,1122,OK
21.016514,TraderOne,Tick,181,127,54,-54,147500,147900,3273,7627,-3173,OK
21.213978,TraderOne,Tick,181,137,44,-44,147600,147900,3568,4332,-4468,OK
21.472003,TraderOne,Tick,181,143,38,-38,147600,147900,3745,1755,-5845,OK
21.767139,TraderOne,Tick,181,143,38,-38,147600,147900,3745,1755,-5845,OK
21.951404,TraderOne,Tick,181,143,38,-38,147600,147900,3745,1755,-5845,OK
22.272676,TraderOne,Tick,181,143,38,-38,147600,148000,3745,1755,-5845,OK
22.547335,TraderOne,Tick,191,143,48,-48,147700,148100,4040,4460,-5140,OK
22.779022,TraderOne,Tick,191,143,48,-48,147700,148100,4040,4460,-5140,OK
22.962754,TraderOne,Tick,191,143,48,-48,147700,148000,4040,4460,-5140,OK
23.215793,TraderOne,Tick,191,143,48,-48,147700,148000,4040,4460,-5140,OK
23.486957,TraderOne,Tick,191,153,38,-38,147400,147700,4335,1165,-6435,OK
23.778336,TraderOne,Tick,191,153,38,-38,147400,147700,4335,1165,-6435,OK
24.000912,TraderOne,Tick,201,153,48,-48,147400,147700,4188,4312,-5288,OK
24.293532,TraderOne,Tick,201,153,48,-48,147400,147700,4188,4312,-5288,OK
24.456131,TraderOne,Tick,201,153,48,-48,147400,147700,4188,4312,-5288,OK
24.744008,TraderOne,Tick,211,153,58,-58,147400,147700,4483,8017,-3583,OK
24.999592,TraderOne,Tick,211,153,58,-58,147400,148100,4483,8017,-3583,OK
25.216597,TraderOne,Tick,221,153,68,-68,147700,148200,4778,12722,-878,OK
25.456044,TraderOne,Tick,221,163,58,-58,147600,147900,5073,6427,-5173,OK
25.705952,TraderOne,Tick,221,163,58,-58,147700,147900,5073,6427,-5173,OK
26.004717,TraderOne,Tick,221,163,58,-58,147700,147900,5073,6427,-5173,OK
26.268248,TraderOne,Tick,221,163,58,-58,147700,147900,5073,6427,-5173,OK
26.4777,TraderOne,Tick,221,163,58,-58,147400,147900,5073,6427,-5173,OK
26.753524,TraderOne,Tick,221,163,58,-58,147400,147900,5073,6427,-5173,OK
27.038414,TraderOne,Tick,221,163,58,-58,147400,147900,5073,6427,-5173,OK
27.280631,TraderOne,Tick,231,163,68,-68,147400,147900,4926,11574,-2026,OK
27.531445,TraderOne,Tick,231,163,68,-68,147400,147900,4926,11574,-2026,OK
27.723854,TraderOne,Tick,231,163,68,-68,147400,147900,4926,11574,-2026,OK
28.020469,TraderOne,Tick,241,173,68,-68,147200,147800,5074,9426,-4174,OK
28.299339,TraderOne,Tick,241,183,58,-58,147200,147800,5368,3132,-8468,OK
28.489062,TraderOne,Tick,241,183,58,-58,147700,147800,5368,3132,-2668,OK
28.712474,TraderOne,Tick,241,183,58,-58,147700,147600,5368,3132,8932,OK
28.98395,TraderOne,Tick,241,183,58,-58,147700,147600,5368,3132,8932,OK
29.203019,TraderOne,Tick,241,183,58,-58,147700,147600,5368,3132,8932,OK
29.45136,TraderOne,Tick,241,183,58,-58,147700,147600,5368,3132,8932,OK
29.712538,TraderOne,Tick,241,183,58,-58,147700,147600,5368,3132,8932,OK
29.997293,TraderOne,Tick,241,193,48,-48,147700,147600,5221,-1721,3079,OK
30.261161,TraderOne,Tick,241,193,48,-48,147700,147600,5221,-1721,3079,OK
30.541702,TraderOne,Tick,241,193,48,-48,147700,147600,5221,-1721,3079,OK
30.731855,TraderOne,Tick,241,193,48,-48,147700,147400,5221,-1721,7879,OK
31.025193,TraderOne,Tick,241,193,48,-48,147700,147400,5221,-1721,7879,OK
31.274097,TraderOne,Tick,251,193,58,-58,147000,147400,5515,1985,-9615,OK
31.451899,TraderOne,Tick,251,193,58,-58,147000,147400,5515,1985,-9615,OK
31.737365,TraderOne,Tick,251,193,58,-58,147000,147400,5515,1985,-9615,OK
31.969889,TraderOne,Tick,261,193,68,-68,147000,147400,5368,7132,-6468,OK
32.289483,TraderOne,Tick,261,193,68,-68,147000,147400,5368,7132,-6468,OK
32.451624,TraderOne,Tick,261,203,58,-58,147100,147400,5662,838,-10762,OK
32.761155,TraderOne,Tick,261,203,58,-58,147100,147600,5662,838,-10762,OK
32.969116,TraderOne,Tick,261,213,48,-48,147000,147600,5956,-4456,-14056,OK
33.208489,TraderOne,Tick,261,213,48,-48,147000,147600,5956,-4456,-14056,OK
33.519249,TraderOne,Tick,261,213,48,-48,147000,147600,5956,-4456,-14056,OK
33.792728,TraderOne,Tick,261,223,38,-38,146900,147600,6250,-8750,-16350,OK
34.024141,TraderOne,Tick,261,223,38,-38,146900,147600,6250,-8750,-16350,OK
34.252288,TraderOne,Tick,261,223,38,-38,146900,147200,6250,-8750,-16350,OK
34.478864,TraderOne,Tick,261,223,38,-38,146900,147200,6250,-8750,-16350,OK
34.708075,TraderOne,Tick,261,223,38,-38,146900,147200,6250,-8750,-16350,OK
34.951764,TraderOne,Tick,261,223,38,-38,146900,147200,6250,-8750,-16350,OK
35.275317,TraderOne,Tick,261,223,38,-38,146900,147300,6250,-8750,-16350,OK
35.534075,TraderOne,Tick,261,233,28,-28,147100,147000,6103,-13603,-10803,OK
35.766188,TraderOne,Tick,261,243,18,-18,147200,147000,6397,-14897,-11297,OK
36.026439,TraderOne,Tick,261,243,18,-18,147200,147000,6397,-14897,-11297,OK
36.255605,TraderOne,Tick,261,243,18,-18,147200,147000,6397,-14897,-11297,OK
36.469694,TraderOne,Tick,261,250,11,-11,147200,147000,6603,-15803,-13603,OK
36.789863,TraderOne,Tick,261,250,11,-11,147200,147000,6603,-15803,-13603,OK
36.951007,TraderOne,Tick,261,250,11,-11,147200,147000,6603,-15803,-13603,OK
37.246205,TraderOne,Tick,261,250,11,-11,147200,147000,6603,-15803,-13603,OK
37.505022,TraderOne,Tick,261,250,11,-11,147200,147300,6603,-15803,-16903,OK
37.79541,TraderOne,Tick,261,250,11,-11,147200,147300,6603,-15803,-16903,OK
38.028755,TraderOne,Tick,261,250,11,-11,147200,147300,6603,-15803,-16903,OK
38.267684,TraderOne,Tick,261,250,11,-11,147200,147300,6603,-15803,-16903,OK
38.54423,TraderOne,Tick,261,250,11,-11,147200,147300,6603,-15803,-16903,OK
38.787793,TraderOne,Tick,261,250,11,-11,147200,147300,6603,-15803,-16903,OK
39.027674,TraderOne,Tick,261,250,11,-11,147200,147300,6603,-15803,-16903,OK
39.257905,TraderOne,Tick,271,250,21,-21,147500,147300,6456,-14656,-10456,OK
39.470008,TraderOne,Tick,271,260,11,-11,147700,147300,6309,-16509,-14309,OK
39.718756,TraderOne,Tick,271,260,11,-11,147700,147300,6309,-16509,-14309,OK
40.036403,TraderOne,Tick,271,260,11,-11,147700,147300,6309,-16509,-14309,OK
40.20338,TraderOne,Tick,271,260,11,-11,147700,147300,6309,-16509,-14309,OK
40.501539,TraderOne,Tick,271,270,1,-1,147700,147300,6161,-14361,-14161,OK
40.793745,TraderOne,Tick,271,270,1,-1,147700,147300,6161,-14361,-14161,OK
41.018869,TraderOne,Tick,271,270,1,-1,147700,147300,6161,-14361,-14161,OK
41.29245,TraderOne,Tick,271,270,1,-1,147700,147300,6161,-14361,-14161,OK
41.524008,TraderOne,Tick,271,270,1,-1,147700,147300,6161,-14361,-14161,OK
41.704545,TraderOne,Tick,271,270,1,-1,147700,147300,6161,-14361,-14161,OK
41.996513,TraderOne,Tick,271,270,1,-1,147700,147300,6161,-14361,-14161,OK
42.24943,TraderOne,Tick,271,278,-7,7,147500,147200,6043,-13443,-14843,OK
42.450072,TraderOne,Tick,271,278,-7,7,147500,147200,6043,-13443,-14843,OK
42.740901,TraderOne,Tick,271,278,-7,7,147500,147200,6043,-13443,-14843,OK
43.022121,TraderOne,Tick,271,278,-7,7,147500,147200,6043,-13443,-14843,OK
43.263258,TraderOne,Tick,271,278,-7,7,147500,147200,6043,-13443,-14843,OK
43.547543,TraderOne,Tick,271,278,-7,7,147500,147200,6043,-13443,-14843,OK
43.76964,TraderOne,Tick,271,278,-7,7,147500,147400,6043,-13443,-14143,OK
43.999104,TraderOne,Tick,271,278,-7,7,147500,147400,6043,-13443,-14143,OK
44.286933,TraderOne,Tick,271,278,-7,7,147500,147400,6043,-13443,-14143,OK
44.491249,TraderOne,Tick,271,278,-7,7,147500,147400,6043,-13443,-14143,OK
44.770303,TraderOne,Tick,271,278,-7,7,147500,147400,6043,-13443,-14143,OK
44.96937,TraderOne,Tick,271,278,-7,7,147700,147400,6043,-13443,-14843,OK
45.21823,TraderOne,Tick,271,278,-7,7,147700,147500,6043,-13443,-14843,OK
45.502496,TraderOne,Tick,271,278,-7,7,147700,147500,6043,-13443,-14843,OK
45.705449,TraderOne,Tick,271,288,-17,17,147400,147500,6338,-12738,-11038,OK
46.002856,TraderOne,Tick,271,288,-17,17,147400,147500,6338,-12738,-11038,OK
46.281117,TraderOne,Tick,271,288,-17,17,147400,147500,6338,-12738,-11038,OK
46.510831,TraderOne,Tick,271,288,-17,17,147400,147500,6338,-12738,-11038,OK
46.716377,TraderOne,Tick,271,288,-17,17,147400,147500,6338,-12738,-11038,OK
47.01497,TraderOne,Tick,271,288,-17,17,147400,147500,6338,-12738,-11038,OK
47.208321,TraderOne,Tick,271,288,-17,17,147400,147500,6338,-12738,-11038,OK
47.503024,TraderOne,Tick,271,288,-17,17,147400,147500,6338,-12738,-11038,OK
47.776982,TraderOne,Tick,271,298,-27,27,147700,147500,6190,-10590,-15990,OK
48.021284,TraderOne,Tick,271,298,-27,27,147700,147500,6190,-10590,-15990,OK
48.288027,TraderOne,Tick,274,298,-24,24,147400,147500,6146,-11746,-9346,OK
48.496055,TraderOne,Tick,274,298,-24,24,147400,147500,6146,-11746,-9346,OK
48.771997,TraderOne,Tick,274,298,-24,24,147400,147500,6146,-11746,-9346,OK
48.954777,TraderOne,Tick,274,298,-24,24,147400,147500,6146,-11746,-9346,OK
49.293425,TraderOne,Tick,274,298,-24,24,147400,147500,6146,-11746,-9346,OK
49.456665,TraderOne,Tick,284,298,-14,14,147700,147500,6441,-15041,-17841,OK
49.724937,TraderOne,Tick,284,298,-14,14,147700,147500,6441,-15041,-17841,OK
49.991048,TraderOne,Tick,284,298,-14,14,147700,147500,6441,-15041,-17841,OK
50.300606,TraderOne,Tick,284,298,-14,14,147700,147500,6441,-15041,-17841,OK
50.530984,TraderOne,Tick,284,298,-14,14,147800,147500,6441,-15041,-17841,OK
50.793038,TraderOne,Tick,284,298,-14,14,147800,147500,6441,-15041,-17841,OK
50.999443,TraderOne,Tick,284,298,-14,14,147800,147500,6441,-15041,-17841,OK
51.261081,TraderOne,Tick,284,298,-14,14,147800,147500,6441,-15041,-17841,OK
51.522851,TraderOne,Tick,284,298,-14,14,147800,147500,6441,-15041,-17841,OK
51.70443,TraderOne,Tick,284,298,-14,14,147800,147500,6441,-15041,-17841,OK
52.013521,TraderOne,Tick,284,298,-14,14,147800,147300,6441,-15041,-17841,OK
52.263742,TraderOne,Tick,284,298,-14,14,147800,147300,6441,-15041,-17841,OK
52.535803,TraderOne,Tick,284,298,-14,14,147800,147300,6441,-15041,-17841,OK
52.75473,TraderOne,Tick,284,298,-14,14,147800,147300,6441,-15041,-17841,OK
53.000359,TraderOne,Tick,284,298,-14,14,147800,147300,6441,-15041,-17841,OK
53.24465,TraderOne,Tick,284,298,-14,14,147800,147300,6441,-15041,-17841,OK
53.541186,TraderOne,Tick,284,298,-14,14,147800,147300,6441,-15041,-17841,OK
53.79611,TraderOne,Tick,284,298,-14,14,147800,147300,6441,-15041,-17841,OK
53.99012,TraderOne,Tick,284,298,-14,14,147800,147300,6441,-15041,-17841,OK
54.222324,TraderOne,Tick,284,308,-24,24,147900,147300,6293,-12893,-17693,OK
54.528159,TraderOne,Tick,284,308,-24,24,147900,147200,6293,-12893,-17693,OK
54.714777,TraderOne,Tick,284,308,-24,24,147900,147200,6293,-12893,-17693,OK
55.006213,TraderOne,Tick,284,308,-24,24,147900,147200,6293,-12893,-17693,OK
55.215028,TraderOne,Tick,284,308,-24,24,147900,147300,6293,-12893,-17693,OK
55.528609,TraderOne,Tick,294,308,-14,14,147300,146900,6146,-14746,-17546,OK
55.704506,TraderOne,Tick,304,318,-14,14,147300,146900,6293,-18893,-21693,OK
56.049458,TraderOne,Tick,304,327,-23,23,147300,147100,6558,-17358,-21958,OK
56.257902,TraderOne,Tick,304,327,-23,23,147300,147100,6558,-17358,-21958,OK
56.458549,TraderOne,Tick,304,327,-23,23,147300,147100,6558,-17358,-21958,OK
56.716124,TraderOne,Tick,304,327,-23,23,147300,147100,6558,-17358,-21958,OK
57.000276,TraderOne,Tick,304,327,-23,23,147300,147100,6558,-17358,-21958,OK
57.215098,TraderOne,Tick,304,327,-23,23,147300,147100,6558,-17358,-21958,OK
57.465886,TraderOne,Tick,304,327,-23,23,147300,146800,6558,-17358,-21958,OK
57.747701,TraderOne,Tick,304,337,-33,33,147100,146700,6852,-13652,-20252,OK
58.01551,TraderOne,Tick,304,337,-33,33,147100,146600,6852,-13652,-20252,OK
58.298637,TraderOne,Tick,304,345,-41,41,147100,146700,7087,-10687,-18887,OK
58.527552,TraderOne,Tick,304,345,-41,41,147100,146700,7087,-10687,-18887,OK
58.723829,TraderOne,Tick,314,345,-31,31,147200,146700,7381,-15981,-22181,OK
59.036918,TraderOne,Tick,314,345,-31,31,147200,146700,7381,-15981,-22181,OK
59.205677,TraderOne,Tick,314,355,-41,41,147000,146700,7675,-12275,-20475,OK
59.468341,TraderOne,Tick,314,355,-41,41,147000,146500,7675,-12275,-20475,OK
59.786817,TraderOne,Tick,314,355,-41,41,147000,146500,7675,-12275,-20475,OK
59.996684,TraderOne,Tick,314,355,-41,41,147000,146500,7675,-12275,-20475,OK
60.225759,TraderOne,Tick,314,355,-41,41,147000,146700,7675,-12275,-20475,OK
60.519131,TraderOne,Tick,314,355,-41,41,147000,146700,7675,-12275,-20475,OK
60.795034,TraderOne,Tick,314,355,-41,41,147000,146600,7675,-12275,-20475,OK
60.994217,TraderOne,Tick,314,355,-41,41,147000,146500,7675,-12275,-20475,OK
61.296461,TraderOne,Tick,314,355,-41,41,147000,146500,7675,-12275,-20475,OK
61.481207,TraderOne,Tick,314,355,-41,41,147000,146500,7675,-12275,-20475,OK
61.784217,TraderOne,Tick,314,355,-41,41,147000,146500,7675,-12275,-20475,OK
61.981026,TraderOne,Tick,314,355,-41,41,147000,146500,7675,-12275,-20475,OK
62.217239,TraderOne,Tick,314,355,-41,41,147000,146500,7675,-12275,-20475,OK
62.499551,TraderOne,Tick,314,365,-51,51,146700,146300,7969,-5569,-15769,OK
62.70408,TraderOne,Tick,324,365,-41,41,146800,146300,8263,-11863,-20063,OK
62.974501,TraderOne,Tick,334,365,-31,31,146800,146300,8116,-17716,-23916,OK
63.284961,TraderOne,Tick,334,365,-31,31,146800,146300,8116,-17716,-23916,OK
63.528257,TraderOne,Tick,334,365,-31,31,146800,146300,8116,-17716,-23916,OK
63.738975,TraderOne,Tick,334,365,-31,31,146800,146300,8116,-17716,-23916,OK
63.985516,TraderOne,Tick,334,365,-31,31,146800,146300,8116,-17716,-23916,OK
64.280893,TraderOne,Tick,344,365,-21,21,146700,146300,8410,-21010,-25210,OK
64.498078,TraderOne,Tick,344,365,-21,21,146700,146300,8410,-21010,-25210,OK
64.76095,TraderOne,Tick,344,365,-21,21,146700,146300,8410,-21010,-25210,OK
65.022386,TraderOne,Tick,344,365,-21,21,146700,146300,8410,-21010,-25210,OK
65.208613,TraderOne,Tick,344,365,-21,21,146700,146900,8410,-21010,-16810,OK
65.488471,TraderOne,Tick,344,365,-21,21,146700,146900,8410,-21010,-16810,OK
65.731138,TraderOne,Tick,344,365,-21,21,146700,146900,8410,-21010,-16810,OK
66.020306,TraderOne,Tick,354,365,-11,11,146600,146900,8263,-23863,-21663,OK
66.259746,TraderOne,Tick,354,365,-11,11,146600,146900,8263,-23863,-21663,OK
66.481547,TraderOne,Tick,354,375,-21,21,147300,146900,8116,-20716,-24916,OK
66.70766,TraderOne,Tick,354,375,-21,21,147300,146900,8116,-20716,-24916,OK
66.970397,TraderOne,Tick,364,375,-11,11,146500,146900,7969,-23569,-21369,OK
67.253001,TraderOne,Tick,364,375,-11,11,146500,146900,7969,-23569,-21369,OK
67.478939,TraderOne,Tick,364,375,-11,11,146500,146900,7969,-23569,-21369,OK
67.722471,TraderOne,Tick,374,375,-1,1,146900,146900,8263,-25863,-25863,OK
68.006727,TraderOne,Tick,374,375,-1,1,146900,146900,8263,-25863,-25863,OK
68.26874,TraderOne,Tick,374,385,-11,11,146900,146900,8116,-25716,-25716,OK
68.538583,TraderOne,Tick,384,395,-11,11,146500,146900,8263,-24863,-22663,OK
68.704792,TraderOne,Tick,384,395,-11,11,146500,147200,8263,-24863,-22663,OK
69.041842,TraderOne,Tick,384,395,-11,11,146500,147200,8263,-24863,-22663,OK
69.255202,TraderOne,Tick,384,405,-21,21,147500,147200,8116,-22716,-26916,OK
69.498283,TraderOne,Tick,384,405,-21,21,147500,147200,8116,-22716,-26916,OK
69.752061,TraderOne,Tick,384,405,-21,21,147500,147300,8116,-22716,-26916,OK
70.048285,TraderOne,Tick,384,405,-21,21,147500,147300,8116,-22716,-26916,OK
70.232191,TraderOne,Tick,384,405,-21,21,147500,147300,8116,-22716,-26916,OK
70.502815,TraderOne,Tick,384,405,-21,21,147500,147300,8116,-22716,-26916,OK
70.751342,TraderOne,Tick,394,405,-11,11,146500,147300,7969,-25569,-23369,OK
71.032274,TraderOne,Tick,394,405,-11,11,146500,147300,7969,-25569,-23369,OK
71.25899,TraderOne,Tick,394,405,-11,11,146500,147300,7969,-25569,-23369,OK
71.50251,TraderOne,Tick,394,405,-11,11,146500,147300,7969,-25569,-23369,OK
71.729865,TraderOne,Tick,394,405,-11,11,146500,147300,7969,-25569,-23369,OK
71.955626,TraderOne,Tick,394,405,-11,11,146500,147300,7969,-25569,-23369,OK
72.213268,TraderOne,Tick,394,405,-11,11,146500,147300,7969,-25569,-23369,OK
72.505335,TraderOne,Tick,394,415,-21,21,147500,147300,7821,-24421,-28621,OK
72.778158,TraderOne,Tick,394,415,-21,21,147500,147300,7821,-24421,-28621,OK
73.033643,TraderOne,Tick,394,415,-21,21,147600,147300,7821,-24421,-28621,OK
73.249788,TraderOne,Tick,394,415,-21,21,147600,147300,7821,-24421,-28621,OK
73.521853,TraderOne,Tick,394,415,-21,21,147600,147200,7821,-24421,-28621,OK
73.75689,TraderOne,Tick,404,415,-11,11,147600,147200,8116,-27716,-29916,OK
73.975036,TraderOne,Tick,404,415,-11,11,147600,147200,8116,-27716,-29916,OK
74.257177,TraderOne,Tick,414,415,-1,1,147600,147200,8411,-30011,-30211,OK
74.496418,TraderOne,Tick,414,425,-11,11,147500,147200,8706,-29306,-31506,OK
74.76602,TraderOne,Tick,414,425,-11,11,147500,147200,8706,-29306,-31506,OK
75.032142,TraderOne,Tick,414,425,-11,11,147500,147200,8706,-29306,-31506,OK
75.246248,TraderOne,Tick,414,425,-11,11,147500,147400,8706,-29306,-30406,OK
75.507549,TraderOne,Tick,414,425,-11,11,147500,147400,8706,-29306,-30406,OK
75.751457,TraderOne,Tick,414,425,-11,11,147500,147400,8706,-29306,-30406,OK
76.018832,TraderOne,Tick,414,425,-11,11,147500,147400,8706,-29306,-30406,OK
76.23375,TraderOne,Tick,414,425,-11,11,147500,147400,8706,-29306,-30406,OK
76.486888,TraderOne,Tick,414,425,-11,11,147500,147500,8706,-29306,-29306,OK
76.767293,TraderOne,Tick,424,425,-1,1,147600,147600,9001,-30601,-30601,OK
76.962978,TraderOne,Tick,424,425,-1,1,147600,147600,9001,-30601,-30601,OK
77.223211,TraderOne,Tick,424,435,-11,11,147500,147600,9296,-29896,-28796,OK
77.451027,TraderOne,Tick,424,435,-11,11,147500,147600,9296,-29896,-28796,OK
77.779034,TraderOne,Tick,434,435,-1,1,147400,147600,9149,-31749,-31549,OK
77.975696,TraderOne,Tick,434,435,-1,1,147400,147600,9149,-31749,-31549,OK
78.253232,TraderOne,Tick,434,435,-1,1,147400,147600,9149,-31749,-31549,OK
78.493812,TraderOne,Tick,434,435,-1,1,147400,147600,9149,-31749,-31549,OK
78.778148,TraderOne,Tick,444,435,9,-9,147400,147600,9444,-34044,-35844,OK
79.042985,TraderOne,Tick,444,435,9,-9,147400,147600,9444,-34044,-35844,OK
79.297411,TraderOne,Tick,454,435,19,-19,147400,147600,9739,-32339,-36139,OK
79.532905,TraderOne,Tick,455,435,20,-20,147400,147600,9768,-32168,-36168,OK
79.776101,TraderOne,Tick,465,435,30,-30,147600,148500,10063,-30463,-36463,OK
79.980414,TraderOne,Tick,475,435,40,-40,147900,148400,10359,-24759,-32759,OK
80.299527,TraderOne,Tick,475,435,40,-40,147900,148400,10359,-24759,-32759,OK
80.513905,TraderOne,Tick,485,435,50,-50,147900,148400,10655,-21055,-31055,OK
80.707782,TraderOne,Tick,485,435,50,-50,147900,148400,10655,-21055,-31055,OK
81.000276,TraderOne,Tick,485,435,50,-50,147900,148400,10655,-21055,-31055,OK
81.276595,TraderOne,Tick,485,435,50,-50,147900,148200,10655,-21055,-31055,OK
81.474279,TraderOne,Tick,485,435,50,-50,147900,148400,10655,-21055,-31055,OK
81.788418,TraderOne,Tick,495,435,60,-60,148000,148400,10951,-14351,-26351,OK
81.979223,TraderOne,Tick,495,435,60,-60,148000,148400,10951,-14351,-26351,OK
82.248215,TraderOne,Tick,495,435,60,-60,148000,148400,10951,-14351,-26351,OK
82.522105,TraderOne,Tick,495,445,50,-50,148200,148800,10803,-22203,-32203,OK
82.750243,TraderOne,Tick,495,445,50,-50,148200,148800,10803,-22203,-32203,OK
83.049599,TraderOne,Tick,495,445,50,-50,148200,148800,10803,-22203,-32203,OK
83.287238,TraderOne,Tick,500,445,55,-55,148400,148800,10951,-19851,-30851,OK
83.517031,TraderOne,Tick,500,445,55,-55,148400,148800,10951,-19851,-30851,OK
83.716247,TraderOne,Tick,500,445,55,-55,148400,148800,10951,-19851,-30851,OK
84.021824,TraderOne,Tick,500,445,55,-55,148400,149000,10951,-19851,-30851,OK
84.22676,TraderOne,Tick,500,445,55,-55,148400,149000,10951,-19851,-30851,OK
84.548415,TraderOne,Tick,500,445,55,-55,148400,149000,10951,-19851,-30851,OK
84.713811,TraderOne,Tick,500,445,55,-55,148400,149200,10951,-19851,-30851,OK
84.976843,TraderOne,Tick,510,445,65,-65,148600,149200,11248,-14148,-27148,OK
85.227579,TraderOne,Tick,510,455,55,-55,148600,149200,11545,-20445,-31445,OK
85.482879,TraderOne,Tick,510,465,45,-45,148800,149200,11396,-25296,-34296,OK
85.782987,TraderOne,Tick,510,465,45,-45,148800,149200,11396,-25296,-34296,OK
86.019573,TraderOne,Tick,520,475,45,-45,149000,149600,11545,-27445,-36445,OK
86.27693,TraderOne,Tick,520,475,45,-45,149000,149600,11545,-27445,-36445,OK
86.502143,TraderOne,Tick,520,475,45,-45,149000,149600,11545,-27445,-36445,OK
86.740992,TraderOne,Tick,520,485,35,-35,149600,149600,11396,-30296,-30296,OK
86.954426,TraderOne,Tick,520,485,35,-35,149600,149600,11396,-30296,-30296,OK
87.254635,TraderOne,Tick,520,485,35,-35,149600,149600,11396,-30296,-30296,OK
87.54715,TraderOne,Tick,520,485,35,-35,149600,149700,11396,-30296,-33796,OK
87.763362,TraderOne,Tick,520,485,35,-35,149600,149600,11396,-30296,-30296,OK
87.963939,TraderOne,Tick,520,485,35,-35,149600,149500,11396,-30296,-26796,OK
88.291951,TraderOne,Tick,520,485,35,-35,149600,149500,11396,-30296,-26796,OK
88.491139,TraderOne,Tick,520,485,35,-35,149600,149500,11396,-30296,-26796,OK
88.743059,TraderOne,Tick,520,485,35,-35,149600,149200,11396,-30296,-23296,OK
88.985705,TraderOne,Tick,520,485,35,-35,149600,149100,11396,-30296,-23296,OK
89.211822,TraderOne,Tick,520,485,35,-35,149600,149100,11396,-30296,-23296,OK
89.454269,TraderOne,Tick,520,485,35,-35,149600,148900,11396,-30296,-23296,OK
89.741987,TraderOne,Tick,520,485,35,-35,149600,148900,11396,-30296,-23296,OK
89.999727,TraderOne,Tick,520,485,35,-35,149600,148900,11396,-30296,-23296,OK
90.284832,TraderOne,Tick,520,485,35,-35,149600,149100,11396,-30296,-23296,OK
90.543662,TraderOne,Tick,520,485,35,-35,149600,149100,11396,-30296,-23296,OK
90.776756,TraderOne,Tick,520,485,35,-35,149600,149100,11396,-30296,-23296,OK
91.007906,TraderOne,Tick,520,495,25,-25,148800,149100,11247,-33147,-38147,OK
91.277426,TraderOne,Tick,520,505,15,-15,149400,149100,11546,-30446,-27446,OK
91.465435,TraderOne,Tick,520,510,10,-10,149400,148900,11695,-28595,-26595,OK
91.750404,TraderOne,Tick,520,515,5,-5,149600,148900,11621,-29521,-28521,OK
92.034912,TraderOne,Tick,520,519,1,-1,149500,148900,11741,-28041,-27841,OK
92.215009,TraderOne,Tick,530,519,11,-11,148500,148900,11592,-27892,-30092,OK
92.459076,TraderOne,Tick,530,519,11,-11,148500,148900,11592,-27892,-30092,OK
92.750432,TraderOne,Tick,530,519,11,-11,148500,148900,11592,-27892,-30092,OK
92.984929,TraderOne,Tick,530,519,11,-11,148500,148900,11592,-27892,-30092,OK
93.203721,TraderOne,Tick,530,519,11,-11,148500,149200,11592,-27892,-30092,OK
93.466165,TraderOne,Tick,530,519,11,-11,148500,149200,11592,-27892,-30092,OK
93.705927,TraderOne,Tick,530,519,11,-11,148500,149200,11592,-27892,-30092,OK
93.954685,TraderOne,Tick,530,519,11,-11,148500,149200,11592,-27892,-30092,OK
94.262061,TraderOne,Tick,530,519,11,-11,148500,149200,11592,-27892,-30092,OK
94.461616,TraderOne,Tick,530,519,11,-11,148500,149200,11592,-27892,-30092,OK
94.788947,TraderOne,Tick,530,519,11,-11,148500,149200,11592,-27892,-30092,OK
94.993613,TraderOne,Tick,530,519,11,-11,148500,149200,11592,-27892,-30092,OK
95.280096,TraderOne,Tick,530,519,11,-11,148500,149200,11592,-27892,-30092,OK
95.505002,TraderOne,Tick,530,519,11,-11,148500,149200,11592,-27892,-30092,OK
95.766659,TraderOne,Tick,530,519,11,-11,148500,149200,11592,-27892,-30092,OK
96.005514,TraderOne,Tick,530,519,11,-11,148500,149200,11592,-27892,-30092,OK
96.280812,TraderOne,Tick,530,519,11,-11,148500,149200,11592,-27892,-30092,OK
96.50002,TraderOne,Tick,530,519,11,-11,148500,149200,11592,-27892,-30092,OK
96.799711,TraderOne,Tick,536,519,17,-17,149600,149200,11772,-27472,-24072,OK
97.043089,TraderOne,Tick,536,519,17,-17,149600,149200,11772,-27472,-24072,OK
97.211406,TraderOne,Tick,536,519,17,-17,149600,149200,11772,-27472,-24072,OK
97.46276,TraderOne,Tick,546,529,17,-17,149800,149600,11472,-27172,-23772,OK
97.757102,TraderOne,Tick,546,529,17,-17,149800,149800,11472,-27172,-27172,OK
98.021292,TraderOne,Tick,546,529,17,-17,149800,149800,11472,-27172,-27172,OK
98.286188,TraderOne,Tick,546,529,17,-17,149800,149800,11472,-27172,-27172,OK
98.525058,TraderOne,Tick,556,529,27,-27,149800,149800,11322,-26022,-26022,OK
98.770126,TraderOne,Tick,556,529,27,-27,149800,149800,11322,-26022,-26022,OK
98.975392,TraderOne,Tick,556,529,27,-27,149800,149900,11322,-26022,-28722,OK
99.287525,TraderOne,Tick,556,529,27,-27,149800,150100,11322,-26022,-34122,OK
99.482924,TraderOne,Tick,566,529,37,-37,149800,150100,11622,-24322,-35422,OK
99.771493,TraderOne,Tick,566,529,37,-37,149800,150000,11622,-24322,-31722,OK
99.99898,TraderOne,Tick,566,539,27,-27,149900,150000,11472,-27172,-29872,OK
100.284808,TraderOne,Tick,566,539,27,-27,149900,149900,11472,-27172,-27172,OK
100.471613,TraderOne,Tick,566,539,27,-27,149900,149900,11472,-27172,-27172,OK
100.725846,TraderOne,Tick,566,539,27,-27,149900,149900,11472,-27172,-27172,OK
100.978466,TraderOne,Tick,566,539,27,-27,149900,149900,11472,-27172,-27172,OK
101.233759,TraderOne,Tick,566,539,27,-27,149900,149900,11472,-27172,-27172,OK
101.535288,TraderOne,Tick,576,539,37,-37,149400,150100,11322,-25022,-36122,OK
101.776013,TraderOne,Tick,576,539,37,-37,149400,150100,11322,-25022,-36122,OK
101.951262,TraderOne,Tick,576,539,37,-37,149400,150100,11322,-25022,-36122,OK
102.256779,TraderOne,Tick,576,539,37,-37,149400,150100,11322,-25022,-36122,OK
102.478284,TraderOne,Tick,576,539,37,-37,149400,150100,11322,-25022,-36122,OK
102.777434,TraderOne,Tick,586,539,47,-47,149900,150300,11622,-22322,-36422,OK
102.996856,TraderOne,Tick,586,539,47,-47,149900,150300,11622,-22322,-36422,OK
103.30008,TraderOne,Tick,586,539,47,-47,149900,150300,11622,-22322,-36422,OK
103.529877,TraderOne,Tick,590,549,41,-41,149900,150300,11412,-25112,-37412,OK
103.75266,TraderOne,Tick,590,551,39,-39,150100,150300,11472,-25772,-33572,OK
103.980745,TraderOne,Tick,590,551,39,-39,150100,150400,11472,-25772,-37472,OK
104.224002,TraderOne,Tick,590,551,39,-39,150100,150400,11472,-25772,-37472,OK
104.521828,TraderOne,Tick,590,551,39,-39,150100,150200,11472,-25772,-29672,OK
104.767632,TraderOne,Tick,590,551,39,-39,150100,150200,11472,-25772,-29672,OK
105.028279,TraderOne,Tick,590,551,39,-39,150100,150200,11472,-25772,-29672,OK
105.262937,TraderOne,Tick,590,551,39,-39,150100,150200,11472,-25772,-29672,OK
105.47434,TraderOne,Tick,590,551,39,-39,150100,150200,11472,-25772,-29672,OK
105.783136,TraderOne,Tick,590,551,39,-39,150100,150200,11472,-25772,-29672,OK
105.957107,TraderOne,Tick,590,551,39,-39,150100,150300,11472,-25772,-33572,OK
106.293971,TraderOne,Tick,590,551,39,-39,150100,150500,11472,-25772,-37472,OK
106.464422,TraderOne,Tick,600,551,49,-49,150200,150500,11322,-21622,-36322,OK
106.72064,TraderOne,Tick,600,551,49,-49,150200,150400,11322,-21622,-31422,OK
107.013442,TraderOne,Tick,600,551,49,-49,150200,150300,11322,-21622,-26522,OK
107.225994,TraderOne,Tick,600,551,49,-49,150200,150300,11322,-21622,-26522,OK
107.535167,TraderOne,Tick,600,551,49,-49,150200,150400,11322,-21622,-31422,OK
107.709339,TraderOne,Tick,600,551,49,-49,150200,150400,11322,-21622,-31422,OK
108.003502,TraderOne,Tick,600,551,49,-49,150200,150400,11322,-21622,-31422,OK
108.245849,TraderOne,Tick,600,551,49,-49,150200,150300,11322,-21622,-26522,OK
108.488936,TraderOne,Tick,600,551,49,-49,150200,150100,11322,-21622,-16722,OK
108.796548,TraderOne,Tick,600,561,39,-39,149600,150100,11622,-25922,-37622,OK
109.047637,TraderOne,Tick,600,561,39,-39,149600,150100,11622,-25922,-37622,OK
109.283411,TraderOne,Tick,600,561,39,-39,149600,150100,11622,-25922,-37622,OK
109.51657,TraderOne,Tick,600,571,29,-29,150000,150100,11472,-27772,-30672,OK
109.719253,TraderOne,Tick,600,581,19,-19,150100,150100,11772,-29072,-29072,OK
110.034887,TraderOne,Tick,600,591,9,-9,150100,150100,12072,-29372,-29372,OK
110.2947,TraderOne,Tick,610,591,19,-19,150200,150500,12372,-27672,-33372,OK
110.501435,TraderOne,Tick,620,591,29,-29,150200,150500,12672,-25972,-34672,OK
110.753816,TraderOne,Tick,630,591,39,-39,150200,150700,12972,-23272,-34972,OK
110.971855,TraderOne,Tick,640,591,49,-49,150200,150600,13272,-19572,-34272,OK
111.29562,TraderOne,Tick,650,591,59,-59,150200,150600,13572,-15872,-33572,OK
111.471892,TraderOne,Tick,650,601,49,-49,150600,150600,13872,-21172,-21172,OK
111.755786,TraderOne,Tick,650,601,49,-49,150100,150600,13872,-21172,-35872,OK
112.048208,TraderOne,Tick,650,601,49,-49,150100,150600,13872,-21172,-35872,OK
112.241374,TraderOne,Tick,650,601,49,-49,150100,150500,13872,-21172,-35872,OK
112.472327,TraderOne,Tick,650,611,39,-39,150100,150400,14172,-25472,-37172,OK
112.753819,TraderOne,Tick,650,611,39,-39,150100,150500,14172,-25472,-37172,OK
113.025818,TraderOne,Tick,650,611,39,-39,150100,150700,14172,-25472,-37172,OK
113.296322,TraderOne,Tick,650,611,39,-39,150100,150600,14172,-25472,-37172,OK
113.504033,TraderOne,Tick,650,611,39,-39,150100,150500,14172,-25472,-37172,OK
113.768646,TraderOne,Tick,650,611,39,-39,150100,150500,14172,-25472,-37172,OK
113.993244,TraderOne,Tick,650,611,39,-39,150100,150500,14172,-25472,-37172,OK
114.290718,TraderOne,Tick,650,611,39,-39,150500,150600,14172,-25472,-29372,OK
114.460611,TraderOne,Tick,650,611,39,-39,150500,150500,14172,-25472,-25472,OK
114.709411,TraderOne,Tick,650,611,39,-39,150500,150500,14172,-25472,-25472,OK
115.030406,TraderOne,Tick,650,611,39,-39,150500,150900,14172,-25472,-37172,OK
115.229684,TraderOne,Tick,650,611,39,-39,150500,150500,14172,-25472,-25472,OK
115.513474,TraderOne,Tick,658,618,40,-40,150100,150500,14262,-26062,-38062,OK
115.723965,TraderOne,Tick,658,618,40,-40,150100,150500,14262,-26062,-38062,OK
116.03522,TraderOne,Tick,658,618,40,-40,150100,150400,14262,-26062,-38062,OK
116.229511,TraderOne,Tick,658,628,30,-30,150600,150500,14112,-30912,-27912,OK
116.49113,TraderOne,Tick,658,628,30,-30,150600,150800,14112,-30912,-36912,OK
116.717179,TraderOne,Tick,658,628,30,-30,150600,150800,14112,-30912,-36912,OK
116.981067,TraderOne,Tick,668,628,40,-40,150000,150500,13962,-28762,-40762,OK
117.279689,TraderOne,Tick,668,628,40,-40,150000,150300,13962,-28762,-40762,OK
117.523737,TraderOne,Tick,668,628,40,-40,150000,150300,13962,-28762,-40762,OK
117.734069,TraderOne,Tick,668,628,40,-40,150000,150300,13962,-28762,-40762,OK
117.966103,TraderOne,Tick,668,628,40,-40,150000,150300,13962,-28762,-40762,OK
118.293466,TraderOne,Tick,668,638,30,-30,150100,150500,13812,-32612,-41612,OK
118.470071,TraderOne,Tick,668,645,23,-23,150500,150500,14023,-32823,-32823,OK
118.756857,TraderOne,Tick,668,645,23,-23,150500,150300,14023,-32823,-28223,OK
119.046129,TraderOne,Tick,668,645,23,-23,150500,150300,14023,-32823,-28223,OK
119.248118,TraderOne,Tick,668,645,23,-23,150500,150300,14023,-32823,-28223,OK
119.532039,TraderOne,Tick,668,645,23,-23,150500,150300,14023,-32823,-28223,OK
119.779465,TraderOne,Tick,668,646,22,-22,150100,150100,14008,-33008,-33008,OK
119.964853,TraderOne,Tick,668,646,22,-22,150100,150100,14008,-33008,-33008,OK
120.292061,TraderOne,Tick,668,656,12,-12,150200,150600,13858,-40858,-44458,OK
120.465265,TraderOne,Tick,678,656,22,-22,150200,150600,14158,-38158,-44758,OK
120.71836,TraderOne,Tick,685,656,29,-29,150200,150600,14368,-36268,-44968,OK
120.992749,TraderOne,Tick,685,656,29,-29,150200,150600,14368,-36268,-44968,OK
121.298107,TraderOne,Tick,695,656,39,-39,150000,150600,14218,-34118,-45818,OK
121.539961,TraderOne,Tick,695,656,39,-39,150000,150600,14218,-34118,-45818,OK
121.751278,TraderOne,Tick,695,656,39,-39,150000,150600,14218,-34118,-45818,OK
122.018285,TraderOne,Tick,705,656,49,-49,150100,150600,14068,-31968,-46668,OK
122.241343,TraderOne,Tick,705,656,49,-49,150100,150600,14068,-31968,-46668,OK
122.515196,TraderOne,Tick,705,656,49,-49,150100,150500,14068,-31968,-46668,OK
122.785659,TraderOne,Tick,705,656,49,-49,150100,150500,14068,-31968,-46668,OK
123.000613,TraderOne,Tick,705,656,49,-49,150100,150500,14068,-31968,-46668,OK
123.288753,TraderOne,Tick,705,656,49,-49,150100,150400,14068,-31968,-46668,OK
123.466354,TraderOne,Tick,705,656,49,-49,150100,150400,14068,-31968,-46668,OK
123.774493,TraderOne,Tick,705,666,39,-39,150400,150400,13918,-35818,-35818,OK
123.964879,TraderOne,Tick,705,676,29,-29,150400,150400,13768,-38668,-38668,OK
124.222747,TraderOne,Tick,705,686,19,-19,150400,150400,14069,-39969,-39969,OK
124.47031,TraderOne,Tick,705,696,9,-9,150600,150400,14370,-41270,-39470,OK
124.747396,TraderOne,Tick,705,696,9,-9,150600,150400,14370,-41270,-39470,OK
125.011493,TraderOne,Tick,705,696,9,-9,150600,150400,14370,-41270,-39470,OK
125.246358,TraderOne,Tick,705,696,9,-9,150600,150400,14370,-41270,-39470,OK
125.517667,TraderOne,Tick,705,696,9,-9,150400,150400,14370,-41270,-41270,OK
125.777968,TraderOne,Tick,705,696,9,-9,150400,150400,14370,-41270,-41270,OK
126.016429,TraderOne,Tick,715,696,19,-19,150500,150700,14671,-40571,-44371,OK
126.201519,TraderOne,Tick,725,696,29,-29,150500,150900,14972,-39872,-48572,OK
126.514749,TraderOne,Tick,735,696,39,-39,150500,151200,15273,-36173,-47873,OK
126.717331,TraderOne,Tick,745,696,49,-49,150600,151000,15574,-32474,-47174,OK
127.032166,TraderOne,Tick,745,696,49,-49,150600,151000,15574,-32474,-47174,OK
127.272854,TraderOne,Tick,745,696,49,-49,150600,151000,15574,-32474,-47174,OK
127.52743,TraderOne,Tick,745,696,49,-49,150600,150700,15574,-32474,-37374,OK
127.780483,TraderOne,Tick,745,706,39,-39,150400,150400,15875,-34775,-34775,OK
127.959664,TraderOne,Tick,745,706,39,-39,150700,150300,15875,-34775,-23075,OK
128.262865,TraderOne,Tick,745,706,39,-39,150700,150300,15875,-34775,-23075,OK
128.462843,TraderOne,Tick,745,706,39,-39,150700,150200,15875,-34775,-23075,OK
128.76839,TraderOne,Tick,745,706,39,-39,150700,150200,15875,-34775,-23075,OK
128.994409,TraderOne,Tick,745,706,39,-39,150700,150200,15875,-34775,-23075,OK
129.246359,TraderOne,Tick,745,706,39,-39,150700,150200,15875,-34775,-23075,OK
129.518414,TraderOne,Tick,745,716,29,-29,151000,150400,15725,-37625,-28925,OK
129.791504,TraderOne,Tick,745,716,29,-29,151000,150400,15725,-37625,-28925,OK
130.006393,TraderOne,Tick,745,716,29,-29,151000,150400,15725,-37625,-28925,OK
130.283536,TraderOne,Tick,745,716,29,-29,151000,150400,15725,-37625,-28925,OK
130.524507,TraderOne,Tick,745,716,29,-29,151000,150400,15725,-37625,-28925,OK
130.727827,TraderOne,Tick,745,716,29,-29,151000,150400,15725,-37625,-28925,OK
130.971641,TraderOne,Tick,745,716,29,-29,151000,150400,15725,-37625,-28925,OK
131.23439,TraderOne,Tick,755,716,39,-39,149800,150100,15575,-36475,-48175,OK
131.473001,TraderOne,Tick,755,716,39,-39,149800,150100,15575,-36475,-48175,OK
131.786936,TraderOne,Tick,755,716,39,-39,149800,150100,15575,-36475,-48175,OK
132.010024,TraderOne,Tick,755,726,29,-29,150800,150100,15425,-39325,-30625,OK
132.284864,TraderOne,Tick,755,726,29,-29,150800,149800,15425,-39325,-30625,OK
132.535099,TraderOne,Tick,755,736,19,-19,149800,149800,15725,-39625,-39625,OK
132.738693,TraderOne,Tick,755,746,9,-9,149800,149600,16025,-37925,-36125,OK
133.038145,TraderOne,Tick,755,756,-1,1,149800,149600,16325,-36225,-36425,OK
133.231896,TraderOne,Tick,755,766,-11,11,150200,149600,16175,-35075,-37275,OK
133.462825,TraderOne,Tick,755,772,-17,17,149800,149600,16355,-34055,-37455,OK
133.763349,TraderOne,Tick,765,772,-7,7,149000,149500,16205,-35905,-34505,OK
133.998189,TraderOne,Tick,765,772,-7,7,149000,149600,16205,-35905,-34505,OK
134.234417,TraderOne,Tick,765,772,-7,7,149000,149600,16205,-35905,-34505,OK
134.465328,TraderOne,Tick,765,772,-7,7,149000,149700,16205,-35905,-34505,OK
134.716126,TraderOne,Tick,765,772,-7,7,149000,149700,16205,-35905,-34505,OK
134.964184,TraderOne,Tick,765,772,-7,7,149000,149800,16205,-35905,-33805,OK
135.254864,TraderOne,Tick,775,772,3,-3,149200,149800,16055,-37755,-38655,OK
135.51363,TraderOne,Tick,785,774,11,-11,149700,149900,15875,-36575,-38775,OK
135.793718,TraderOne,Tick,785,774,11,-11,149300,149900,15875,-36575,-39875,OK
135.993778,TraderOne,Tick,785,774,11,-11,149300,149900,15875,-36575,-39875,OK
136.235786,TraderOne,Tick,785,774,11,-11,149300,149900,15875,-36575,-39875,OK
136.517295,TraderOne,Tick,785,774,11,-11,149300,149900,15875,-36575,-39875,OK
136.706643,TraderOne,Tick,785,774,11,-11,149300,149800,15875,-36575,-39875,OK
136.966126,TraderOne,Tick,785,774,11,-11,149300,149600,15875,-36575,-38775,OK
137.29995,TraderOne,Tick,785,774,11,-11,149300,149600,15875,-36575,-38775,OK
137.543046,TraderOne,Tick,785,774,11,-11,149300,149600,15875,-36575,-38775,OK
137.765675,TraderOne,Tick,785,774,11,-11,149300,149300,15875,-36575,-36575,OK
138.032655,TraderOne,Tick,785,774,11,-11,149300,149300,15875,-36575,-36575,OK
138.256983,TraderOne,Tick,785,774,11,-11,149300,149300,15875,-36575,-36575,OK
138.467004,TraderOne,Tick,785,774,11,-11,149300,149300,15875,-36575,-36575,OK
138.800466,TraderOne,Tick,785,774,11,-11,149300,149100,15875,-36575,-34375,OK
139.017615,TraderOne,Tick,785,774,11,-11,149300,149100,15875,-36575,-34375,OK
139.231217,TraderOne,Tick,785,774,11,-11,149300,149100,15875,-36575,-34375,OK
139.48522,TraderOne,Tick,785,774,11,-11,149300,149300,15875,-36575,-36575,OK
139.72986,TraderOne,Tick,785,774,11,-11,149300,149300,15875,-36575,-36575,OK
139.955417,TraderOne,Tick,785,774,11,-11,149300,149300,15875,-36575,-36575,OK
140.293466,TraderOne,Tick,785,774,11,-11,149300,149300,15875,-36575,-36575,OK
140.479723,TraderOne,Tick,785,781,4,-4,149700,149300,15770,-37170,-36370,OK
140.709645,TraderOne,Tick,785,781,4,-4,149700,149300,15770,-37170,-36370,OK
141.027883,TraderOne,Tick,785,781,4,-4,149700,149300,15770,-37170,-36370,OK
141.232132,TraderOne,Tick,785,781,4,-4,149700,149300,15770,-37170,-36370,OK
141.450595,TraderOne,Tick,785,781,4,-4,149700,149300,15770,-37170,-36370,OK
141.74548,TraderOne,Tick,785,791,-6,6,150200,149500,15620,-37020,-38220,OK
142.016645,TraderOne,Tick,785,791,-6,6,150200,149500,15620,-37020,-38220,OK
142.287217,TraderOne,Tick,785,791,-6,6,150200,149500,15620,-37020,-38220,OK
142.538686,TraderOne,Tick,785,791,-6,6,150200,149500,15620,-37020,-38220,OK
142.770454,TraderOne,Tick,785,801,-16,16,150200,149500,15470,-35870,-39070,OK
143.028753,TraderOne,Tick,785,801,-16,16,150200,149500,15470,-35870,-39070,OK
143.289123,TraderOne,Tick,785,801,-16,16,150200,149500,15470,-35870,-39070,OK
143.522927,TraderOne,Tick,785,801,-16,16,150200,149700,15470,-35870,-39070,OK
143.726614,TraderOne,Tick,785,811,-26,26,150200,149700,15320,-33720,-38920,OK
143.98992,TraderOne,Tick,795,811,-16,16,149200,149700,15170,-36570,-33370,OK
144.233486,TraderOne,Tick,795,811,-16,16,149200,149700,15170,-36570,-33370,OK
144.504922,TraderOne,Tick,805,811,-6,6,149100,149700,15020,-38420,-37220,OK
144.770671,TraderOne,Tick,805,811,-6,6,149100,149700,15020,-38420,-37220,OK
144.951871,TraderOne,Tick,805,811,-6,6,149100,149700,15020,-38420,-37220,OK
145.266387,TraderOne,Tick,805,811,-6,6,149100,149700,15020,-38420,-37220,OK
145.517365,TraderOne,Tick,805,811,-6,6,149100,149700,15020,-38420,-37220,OK
145.74348,TraderOne,Tick,805,811,-6,6,149100,149700,15020,-38420,-37220,OK
146.023603,TraderOne,Tick,805,811,-6,6,149100,149700,15020,-38420,-37220,OK
146.289399,TraderOne,Tick,805,811,-6,6,149100,149500,15020,-38420,-37220,OK
146.506957,TraderOne,Tick,805,811,-6,6,149100,149500,15020,-38420,-37220,OK
146.746752,TraderOne,Tick,805,811,-6,6,149100,149700,15020,-38420,-37220,OK
146.968645,TraderOne,Tick,805,811,-6,6,149100,149700,15020,-38420,-37220,OK
147.209905,TraderOne,Tick,805,811,-6,6,149100,149700,15020,-38420,-37220,OK
147.525149,TraderOne,Tick,805,811,-6,6,149100,149600,15020,-38420,-37220,OK
147.721088,TraderOne,Tick,805,811,-6,6,149100,149600,15020,-38420,-37220,OK
148.036796,TraderOne,Tick,805,811,-6,6,149100,149600,15020,-38420,-37220,OK
148.258528,TraderOne,Tick,805,811,-6,6,149100,149600,15020,-38420,-37220,OK
148.491731,TraderOne,Tick,805,811,-6,6,149100,149600,15020,-38420,-37220,OK
148.793767,TraderOne,Tick,805,811,-6,6,149100,149600,15020,-38420,-37220,OK
149.042905,TraderOne,Tick,805,811,-6,6,149100,149600,15020,-38420,-37220,OK
149.214885,TraderOne,Tick,805,811,-6,6,149100,149600,15020,-38420,-37220,OK
149.525792,TraderOne,Tick,805,821,-16,16,150600,150100,14870,-35270,-40070,OK
149.735547,TraderOne,Tick,805,821,-16,16,150600,150100,14870,-35270,-40070,OK
149.96382,TraderOne,Tick,805,821,-16,16,150600,150100,14870,-35270,-40070,OK
150.216643,TraderOne,Tick,805,821,-16,16,150600,150100,14870,-35270,-40070,OK
150.53451,TraderOne,Tick,805,828,-23,23,150000,150100,15080,-34080,-31780,OK
150.77829,TraderOne,Tick,805,828,-23,23,150000,150100,15080,-34080,-31780,OK
150.966398,TraderOne,Tick,805,828,-23,23,150000,150100,15080,-34080,-31780,OK
151.277256,TraderOne,Tick,805,828,-23,23,150000,150100,15080,-34080,-31780,OK
151.508092,TraderOne,Tick,805,828,-23,23,150000,150100,15080,-34080,-31780,OK
151.784634,TraderOne,Tick,805,828,-23,23,150000,150100,15080,-34080,-31780,OK
151.973807,TraderOne,Tick,805,828,-23,23,150000,150100,15080,-34080,-31780,OK
152.233281,TraderOne,Tick,805,828,-23,23,150000,150100,15080,-34080,-31780,OK
152.500212,TraderOne,Tick,805,828,-23,23,150000,150100,15080,-34080,-31780,OK
152.751369,TraderOne,Tick,805,828,-23,23,150000,150100,15080,-34080,-31780,OK
152.953926,TraderOne,Tick,805,838,-33,33,150400,150100,14930,-30930,-40830,OK
153.234827,TraderOne,Tick,805,838,-33,33,150400,149800,14930,-30930,-40830,OK
153.497886,TraderOne,Tick,805,838,-33,33,150400,149800,14930,-30930,-40830,OK
153.781393,TraderOne,Tick,805,838,-33,33,150400,150100,14930,-30930,-40830,OK
154.035105,TraderOne,Tick,805,838,-33,33,150400,150100,14930,-30930,-40830,OK
154.266481,TraderOne,Tick,805,838,-33,33,150400,150100,14930,-30930,-40830,OK
154.451843,TraderOne,Tick,805,838,-33,33,150400,150100,14930,-30930,-40830,OK
154.770692,TraderOne,Tick,805,838,-33,33,150400,150100,14930,-30930,-40830,OK
155.010408,TraderOne,Tick,815,838,-23,23,150600,150100,15231,-34231,-41131,OK
155.237661,TraderOne,Tick,825,838,-13,13,150600,150100,15532,-37532,-41432,OK
155.4902,TraderOne,Tick,825,838,-13,13,150600,150300,15532,-37532,-41432,OK
155.741886,TraderOne,Tick,825,838,-13,13,150600,150300,15532,-37532,-41432,OK
156.002814,TraderOne,Tick,825,838,-13,13,150600,150300,15532,-37532,-41432,OK
156.279076,TraderOne,Tick,825,838,-13,13,150600,150300,15532,-37532,-41432,OK
156.482852,TraderOne,Tick,825,838,-13,13,150600,150300,15532,-37532,-41432,OK
156.779438,TraderOne,Tick,825,838,-13,13,150600,150300,15532,-37532,-41432,OK
156.969756,TraderOne,Tick,825,838,-13,13,150600,150300,15532,-37532,-41432,OK
157.25356,TraderOne,Tick,825,838,-13,13,150600,150300,15532,-37532,-41432,OK
157.504224,TraderOne,Tick,825,838,-13,13,150600,150300,15532,-37532,-41432,OK
157.758818,TraderOne,Tick,825,838,-13,13,150600,150300,15532,-37532,-41432,OK
157.992288,TraderOne,Tick,825,838,-13,13,150600,150300,15532,-37532,-41432,OK
158.254638,TraderOne,Tick,825,838,-13,13,150600,150300,15532,-37532,-41432,OK
158.522511,TraderOne,Tick,825,838,-13,13,150500,150300,15532,-37532,-40132,OK
158.73903,TraderOne,Tick,825,838,-13,13,150500,150300,15532,-37532,-40132,OK
158.961602,TraderOne,Tick,835,838,-3,3,150600,150400,15833,-39833,-40433,OK
159.237846,TraderOne,Tick,835,838,-3,3,150600,150400,15833,-39833,-40433,OK
159.50828,TraderOne,Tick,835,848,-13,13,150500,150400,16134,-39134,-40434,OK
159.732282,TraderOne,Tick,844,848,-4,4,150600,150400,16405,-41205,-42005,OK
160.02949,TraderOne,Tick,844,848,-4,4,150600,150400,16405,-41205,-42005,OK
160.228677,TraderOne,Tick,844,850,-6,6,150700,150400,16375,-40775,-42575,OK
160.455765,TraderOne,Tick,844,856,-12,12,150600,150400,16285,-39485,-41885,OK
160.717692,TraderOne,Tick,844,856,-12,12,150600,150200,16285,-39485,-43085,OK
161.016297,TraderOne,Tick,844,864,-20,20,150500,150200,16526,-38126,-44126,OK
161.28656,TraderOne,Tick,844,864,-20,20,150500,150200,16526,-38126,-44126,OK
161.467288,TraderOne,Tick,844,864,-20,20,150500,150200,16526,-38126,-44126,OK
161.717461,TraderOne,Tick,844,864,-20,20,150500,150200,16526,-38126,-44126,OK
162.001269,TraderOne,Tick,844,864,-20,20,150500,150200,16526,-38126,-44126,OK
162.254638,TraderOne,Tick,844,864,-20,20,150500,150800,16526,-38126,-32126,OK
162.536182,TraderOne,Tick,844,864,-20,20,150800,150800,16526,-38126,-38126,OK
162.767869,TraderOne,Tick,844,864,-20,20,150800,150700,16526,-38126,-40126,OK
163.015259,TraderOne,Tick,844,864,-20,20,150800,150700,16526,-38126,-40126,OK
163.201491,TraderOne,Tick,844,864,-20,20,150800,150600,16526,-38126,-42126,OK
163.522809,TraderOne,Tick,854,864,-10,10,150800,150800,16375,-39975,-39975,OK
163.727607,TraderOne,Tick,855,864,-9,9,150700,150800,16405,-40005,-39105,OK
163.965189,TraderOne,Tick,855,864,-9,9,150700,150800,16405,-40005,-39105,OK
164.250546,TraderOne,Tick,865,864,1,-1,151000,151000,16707,-41307,-41307,OK
164.549792,TraderOne,Tick,865,864,1,-1,151000,150900,16707,-41307,-41207,OK
164.790708,TraderOne,Tick,865,874,-9,9,151200,150900,16556,-40156,-42856,OK
165.022515,TraderOne,Tick,865,874,-9,9,151200,151000,16556,-40156,-41956,OK
165.260886,TraderOne,Tick,865,884,-19,19,151400,151000,16405,-38005,-43705,OK
165.500015,TraderOne,Tick,865,884,-19,19,151400,151000,16405,-38005,-43705,OK
165.79577,TraderOne,Tick,865,884,-19,19,151400,151000,16405,-38005,-43705,OK
166.009682,TraderOne,Tick,865,884,-19,19,151400,151000,16405,-38005,-43705,OK
166.207495,TraderOne,Tick,865,884,-19,19,151400,151100,16405,-38005,-43705,OK
166.463511,TraderOne,Tick,865,884,-19,19,151400,151100,16405,-38005,-43705,OK
166.759827,TraderOne,Tick,865,884,-19,19,151400,151100,16405,-38005,-43705,OK
166.989062,TraderOne,Tick,865,884,-19,19,151400,151100,16405,-38005,-43705,OK
167.229935,TraderOne,Tick,865,884,-19,19,151400,151100,16405,-38005,-43705,OK
167.489947,TraderOne,Tick,865,884,-19,19,151400,151100,16405,-38005,-43705,OK
167.701947,TraderOne,Tick,875,884,-9,9,151500,151100,16708,-40308,-43008,OK
167.981125,TraderOne,Tick,875,894,-19,19,151500,151100,16557,-39157,-44857,OK
168.276882,TraderOne,Tick,875,894,-19,19,151500,151100,16557,-39157,-44857,OK
168.533222,TraderOne,Tick,875,894,-19,19,151500,151100,16557,-39157,-44857,OK
168.759921,TraderOne,Tick,875,894,-19,19,151500,151100,16557,-39157,-44857,OK
168.996396,TraderOne,Tick,875,894,-19,19,151500,151100,16557,-39157,-44857,OK
169.247234,TraderOne,Tick,875,904,-29,29,151100,150500,16406,-37006,-45706,OK
169.461304,TraderOne,Tick,875,904,-29,29,151100,150500,16406,-37006,-45706,OK
169.747941,TraderOne,Tick,875,904,-29,29,151100,150800,16406,-37006,-45706,OK
169.977821,TraderOne,Tick,885,904,-19,19,151000,150700,16708,-40308,-46008,OK
170.299025,TraderOne,Tick,885,904,-19,19,151000,150700,16708,-40308,-46008,OK
170.471744,TraderOne,Tick,885,904,-19,19,151000,150700,16708,-40308,-46008,OK
170.793128,TraderOne,Tick,885,904,-19,19,151000,150500,16708,-40308,-46008,OK
171.012817,TraderOne,Tick,885,904,-19,19,151000,150500,16708,-40308,-46008,OK
171.246181,TraderOne,Tick,885,904,-19,19,151000,150500,16708,-40308,-46008,OK
171.481681,TraderOne,Tick,885,904,-19,19,151000,150500,16708,-40308,-46008,OK
171.713729,TraderOne,Tick,889,904,-15,15,150600,150500,16648,-40648,-42148,OK
172.040427,TraderOne,Tick,899,914,-15,15,151200,150500,16346,-40346,-44846,OK
172.26471,TraderOne,Tick,899,914,-15,15,151200,150500,16346,-40346,-44846,OK
172.529461,TraderOne,Tick,899,914,-15,15,151200,150500,16346,-40346,-44846,OK
172.703435,TraderOne,Tick,899,924,-25,25,151000,150500,16195,-38195,-45695,OK
173.030546,TraderOne,Tick,899,924,-25,25,151000,150500,16195,-38195,-45695,OK
173.215553,TraderOne,Tick,899,924,-25,25,151000,150500,16195,-38195,-45695,OK
173.530617,TraderOne,Tick,899,924,-25,25,151000,150500,16195,-38195,-45695,OK
173.76981,TraderOne,Tick,899,924,-25,25,151000,150500,16195,-38195,-45695,OK
174.030935,TraderOne,Tick,899,924,-25,25,151000,150500,16195,-38195,-45695,OK
174.244512,TraderOne,Tick,899,924,-25,25,151000,150500,16195,-38195,-45695,OK
174.541635,TraderOne,Tick,899,924,-25,25,151000,150500,16195,-38195,-45695,OK
174.776608,TraderOne,Tick,899,924,-25,25,151000,150600,16195,-38195,-45695,OK
174.977461,TraderOne,Tick,909,924,-15,15,150800,150600,16497,-40497,-43497,OK
175.273579,TraderOne,Tick,919,924,-5,5,150800,150600,16799,-42799,-43799,OK
175.489592,TraderOne,Tick,919,924,-5,5,150800,150600,16799,-42799,-43799,OK
175.749937,TraderOne,Tick,919,924,-5,5,150800,150600,16799,-42799,-43799,OK
175.968617,TraderOne,Tick,919,924,-5,5,150800,150600,16799,-42799,-43799,OK
176.256255,TraderOne,Tick,919,924,-5,5,150800,150600,16799,-42799,-43799,OK
176.526102,TraderOne,Tick,929,924,5,-5,150700,150600,16648,-43648,-43148,OK
176.718556,TraderOne,Tick,929,924,5,-5,150700,150600,16648,-43648,-43148,OK
177.016449,TraderOne,Tick,929,924,5,-5,150700,150600,16648,-43648,-43148,OK
177.295049,TraderOne,Tick,929,934,-5,5,151200,150600,16497,-43497,-44997,OK
177.531087,TraderOne,Tick,929,934,-5,5,151200,150600,16497,-43497,-44997,OK
177.711065,TraderOne,Tick,929,934,-5,5,151200,150300,16497,-43497,-44997,OK
177.964797,TraderOne,Tick,929,934,-5,5,151200,150300,16497,-43497,-44997,OK
178.260991,TraderOne,Tick,929,934,-5,5,151200,150300,16497,-43497,-44997,OK
178.535761,TraderOne,Tick,929,934,-5,5,151200,150200,16497,-43497,-44997,OK
178.732469,TraderOne,Tick,929,944,-15,15,150400,150200,16798,-40798,-43798,OK
179.017055,TraderOne,Tick,929,954,-25,25,150400,150200,17099,-39099,-44099,OK
179.257018,TraderOne,Tick,929,954,-25,25,150400,150200,17099,-39099,-44099,OK
179.535142,TraderOne,Tick,929,954,-25,25,150400,149900,17099,-39099,-46599,OK
179.762845,TraderOne,Tick,929,954,-25,25,150400,149900,17099,-39099,-46599,OK
179.992094,TraderOne,Tick,929,954,-25,25,150100,149900,17099,-39099,-44099,OK
180.284345,TraderOne,Tick,938,964,-26,26,150100,149800,16814,-39414,-47214,OK
180.45853,TraderOne,Tick,938,964,-26,26,150100,149800,16814,-39414,-47214,OK
180.793315,TraderOne,Tick,938,964,-26,26,150100,149900,16814,-39414,-44614,OK
181.02426,TraderOne,Tick,938,964,-26,26,150100,149900,16814,-39414,-44614,OK
181.263245,TraderOne,Tick,938,964,-26,26,150100,150000,16814,-39414,-42014,OK
181.499898,TraderOne,Tick,948,964,-16,16,149700,149900,16664,-42264,-39064,OK
181.771474,TraderOne,Tick,948,964,-16,16,149700,149900,16664,-42264,-39064,OK
182.031725,TraderOne,Tick,948,964,-16,16,149700,149900,16664,-42264,-39064,OK
182.233455,TraderOne,Tick,948,964,-16,16,149700,149900,16664,-42264,-39064,OK
182.499521,TraderOne,Tick,948,964,-16,16,149700,149900,16664,-42264,-39064,OK
182.7011,TraderOne,Tick,948,964,-16,16,149700,149900,16664,-42264,-39064,OK
182.961577,TraderOne,Tick,948,964,-16,16,149700,149900,16664,-42264,-39064,OK
183.219198,TraderOne,Tick,948,964,-16,16,149700,149900,16664,-42264,-39064,OK
183.519067,TraderOne,Tick,948,964,-16,16,149700,150000,16664,-42264,-37464,OK
183.726749,TraderOne,Tick,958,964,-6,6,150100,150000,16514,-44114,-44714,OK
184.019272,TraderOne,Tick,961,964,-3,3,150100,150000,16469,-44369,-44669,OK
184.228734,TraderOne,Tick,961,964,-3,3,150100,149700,16469,-44369,-44969,OK
184.461494,TraderOne,Tick,961,964,-3,3,150100,149700,16469,-44369,-44969,OK
184.728372,TraderOne,Tick,971,964,7,-7,149700,149700,16319,-45219,-45219,OK
185.042259,TraderOne,Tick,981,964,17,-17,149700,150000,16618,-44518,-49618,OK
185.26432,TraderOne,Tick,991,964,27,-27,149700,150000,16917,-44817,-52917,OK
185.505234,TraderOne,Tick,991,964,27,-27,149700,150000,16917,-44817,-52917,OK
185.775554,TraderOne,Tick,991,964,27,-27,149700,150000,16917,-44817,-52917,OK
186.047216,TraderOne,Tick,991,964,27,-27,149700,150000,16917,-44817,-52917,OK
186.220015,TraderOne,Tick,991,964,27,-27,149700,149800,16917,-44817,-47517,OK
186.47298,TraderOne,Tick,991,974,17,-17,149600,149800,17216,-47116,-50516,OK
186.7814,TraderOne,Tick,991,974,17,-17,149600,149800,17216,-47116,-50516,OK
186.956822,TraderOne,Tick,1001,974,27,-27,149700,149800,17515,-46415,-49115,OK
187.289882,TraderOne,Tick,1001,974,27,-27,149700,149800,17515,-46415,-49115,OK
187.465733,TraderOne,Tick,1001,974,27,-27,149700,149800,17515,-46415,-49115,OK
187.775054,TraderOne,Tick,1011,974,37,-37,149700,150000,17814,-44714,-55814,OK
187.958945,TraderOne,Tick,1021,974,47,-47,149700,150000,18113,-42013,-56113,OK
188.257697,TraderOne,Tick,1027,974,53,-53,149700,150100,18023,-38323,-54223,OK
188.546354,TraderOne,Tick,1035,974,61,-61,149700,150100,18263,-34563,-52863,OK
188.728377,TraderOne,Tick,1035,984,51,-51,149700,150100,18562,-40862,-56162,OK
188.960959,TraderOne,Tick,1035,984,51,-51,149700,150200,18562,-40862,-56162,OK
189.300913,TraderOne,Tick,1035,994,41,-41,149800,150200,18412,-47712,-60012,OK
189.549879,TraderOne,Tick,1045,994,51,-51,150000,150200,18262,-44562,-54762,OK
189.795343,TraderOne,Tick,1045,994,51,-51,150000,150200,18262,-44562,-54762,OK
190.04984,TraderOne,Tick,1045,994,51,-51,150000,150200,18262,-44562,-54762,OK
190.30001,TraderOne,Tick,1045,994,51,-51,150000,150300,18262,-44562,-59862,OK
190.532827,TraderOne,Tick,1045,994,51,-51,150000,150300,18262,-44562,-59862,OK
190.728271,TraderOne,Tick,1045,994,51,-51,150000,150300,18262,-44562,-59862,OK
191.009226,TraderOne,Tick,1045,994,51,-51,149500,150300,18262,-44562,-59862,OK
191.228897,TraderOne,Tick,1045,994,51,-51,149500,150400,18262,-44562,-59862,OK
191.466174,TraderOne,Tick,1055,994,61,-61,150000,150700,18562,-38862,-57162,OK
191.719061,TraderOne,Tick,1055,994,61,-61,150000,150800,18562,-38862,-57162,OK
192.001698,TraderOne,Tick,1055,1004,51,-51,150200,150800,18862,-45162,-60462,OK
192.232374,TraderOne,Tick,1055,1004,51,-51,150200,150700,18862,-45162,-60462,OK
192.537245,TraderOne,Tick,1055,1004,51,-51,150200,150700,18862,-45162,-60462,OK
192.774173,TraderOne,Tick,1055,1004,51,-51,150300,150700,18862,-45162,-60462,OK
193.038728,TraderOne,Tick,1065,1004,61,-61,150200,150500,18712,-42012,-60312,OK
193.215939,TraderOne,Tick,1065,1014,51,-51,150200,150500,19012,-47312,-62612,OK
193.483648,TraderOne,Tick,1065,1014,51,-51,150200,150500,19012,-47312,-62612,OK
193.742828,TraderOne,Tick,1065,1014,51,-51,150200,150500,19012,-47312,-62612,OK
193.988302,TraderOne,Tick,1065,1014,51,-51,150200,150500,19012,-47312,-62612,OK
194.269218,TraderOne,Tick,1065,1014,51,-51,150200,150500,19012,-47312,-62612,OK
194.461119,TraderOne,Tick,1065,1014,51,-51,150200,150500,19012,-47312,-62612,OK
194.768191,TraderOne,Tick,1065,1014,51,-51,150200,150500,19012,-47312,-62612,OK
194.964449,TraderOne,Tick,1065,1024,41,-41,150200,150600,19312,-52612,-64912,OK
195.241819,TraderOne,Tick,1065,1024,41,-41,150200,150600,19312,-52612,-64912,OK
195.49611,TraderOne,Tick,1065,1024,41,-41,150200,150600,19312,-52612,-64912,OK
195.731498,TraderOne,Tick,1065,1024,41,-41,150200,150600,19312,-52612,-64912,OK
196.008097,TraderOne,Tick,1065,1024,41,-41,150200,150600,19312,-52612,-64912,OK
196.265198,TraderOne,Tick,1065,1024,41,-41,150200,150600,19312,-52612,-64912,OK
196.513778,TraderOne,Tick,1075,1024,51,-51,149800,150600,19162,-48462,-63762,OK
196.781768,TraderOne,Tick,1075,1024,51,-51,149800,150100,19162,-48462,-63762,OK
196.978633,TraderOne,Tick,1075,1024,51,-51,149800,150000,19162,-48462,-58662,OK
197.202619,TraderOne,Tick,1075,1034,41,-41,149500,150000,19461,-53761,-66061,OK
197.549098,TraderOne,Tick,1075,1044,31,-31,149500,150000,19760,-58060,-67360,OK
197.709039,TraderOne,Tick,1075,1044,31,-31,149500,149800,19760,-58060,-67360,OK
197.962064,TraderOne,Tick,1075,1044,31,-31,149500,149600,19760,-58060,-61160,OK
198.229626,TraderOne,Tick,1075,1054,21,-21,149500,149700,20059,-60359,-64559,OK
198.51305,TraderOne,Tick,1075,1064,11,-11,149500,149500,20358,-62658,-62658,OK
198.77531,TraderOne,Tick,1075,1064,11,-11,149500,149500,20358,-62658,-62658,OK
199.040405,TraderOne,Tick,1075,1074,1,-1,149500,149500,20657,-63957,-63957,OK
199.246853,TraderOne,Tick,1075,1074,1,-1,149500,149500,20657,-63957,-63957,OK
199.522334,TraderOne,Tick,1075,1084,-9,9,149500,149500,20956,-66256,-66256,OK
199.779056,TraderOne,Tick,1075,1084,-9,9,149500,149500,20956,-66256,-66256,OK
200.000881,TraderOne,Tick,1075,1084,-9,9,149500,149500,20956,-66256,-66256,OK
200.292184,TraderOne,Tick,1075,1084,-9,9,149500,149600,20956,-66256,-65356,OK
200.532529,TraderOne,Tick,1075,1088,-13,13,149800,149600,20896,-65796,-68396,OK
200.769565,TraderOne,Tick,1075,1088,-13,13,149800,149600,20896,-65796,-68396,OK
201.041382,TraderOne,Tick,1075,1088,-13,13,149800,149600,20896,-65796,-68396,OK
201.276549,TraderOne,Tick,1085,1098,-13,13,150000,149600,21046,-65946,-68546,OK
201.536932,TraderOne,Tick,1085,1099,-14,14,150000,149800,21076,-65976,-68776,OK
201.763439,TraderOne,Tick,1095,1099,-4,4,149300,150000,20926,-65826,-64626,OK
201.964378,TraderOne,Tick,1095,1099,-4,4,149300,150000,20926,-65826,-64626,OK
202.206566,TraderOne,Tick,1095,1099,-4,4,149300,150200,20926,-65826,-64626,OK
202.509449,TraderOne,Tick,1105,1099,6,-6,150500,150200,21227,-67127,-65327,OK
202.702938,TraderOne,Tick,1115,1099,16,-16,150500,150600,21528,-67428,-69028,OK
203.046501,TraderOne,Tick,1117,1099,18,-18,150500,150600,21588,-67288,-69088,OK
203.267222,TraderOne,Tick,1117,1099,18,-18,150500,150600,21588,-67288,-69088,OK
203.543247,TraderOne,Tick,1117,1099,18,-18,150500,150600,21588,-67288,-69088,OK
203.722249,TraderOne,Tick,1117,1099,18,-18,150500,150600,21588,-67288,-69088,OK
204.045734,TraderOne,Tick,1127,1099,28,-28,150300,150600,21438,-66138,-74538,OK
204.288583,TraderOne,Tick,1127,1099,28,-28,150300,150600,21438,-66138,-74538,OK
204.464416,TraderOne,Tick,1127,1099,28,-28,150300,150600,21438,-66138,-74538,OK
204.714721,TraderOne,Tick,1127,1099,28,-28,150300,150600,21438,-66138,-74538,OK
205.031082,TraderOne,Tick,1136,1099,37,-37,150200,150100,21303,-67803,-64103,OK
205.248463,TraderOne,Tick,1136,1109,27,-27,149700,149700,21602,-70102,-70102,OK
205.550221,TraderOne,Tick,1136,1119,17,-17,150400,149700,21452,-70952,-67552,OK
205.750079,TraderOne,Tick,1136,1119,17,-17,150400,149700,21452,-70952,-67552,OK
205.958341,TraderOne,Tick,1136,1119,17,-17,150400,149800,21452,-70952,-65852,OK
206.261032,TraderOne,Tick,1136,1129,7,-7,150300,149800,21302,-71802,-69702,OK
206.538757,TraderOne,Tick,1136,1129,7,-7,150300,149800,21302,-71802,-69702,OK
206.730606,TraderOne,Tick,1136,1129,7,-7,150300,149800,21302,-71802,-69702,OK
206.957086,TraderOne,Tick,1136,1129,7,-7,150300,149800,21302,-71802,-69702,OK
207.238807,TraderOne,Tick,1136,1129,7,-7,150300,149800,21302,-71802,-69702,OK
207.481395,TraderOne,Tick,1136,1129,7,-7,150300,149800,21302,-71802,-69702,OK
207.727004,TraderOne,Tick,1136,1129,7,-7,150300,149800,21302,-71802,-69702,OK
208.032425,TraderOne,Tick,1136,1129,7,-7,150300,149800,21302,-71802,-69702,OK
208.214335,TraderOne,Tick,1146,1129,17,-17,149200,149800,21152,-72652,-77752,OK
208.494952,TraderOne,Tick,1146,1139,7,-7,149800,149800,21002,-73502,-73502,OK
208.760278,TraderOne,Tick,1146,1139,7,-7,149800,149800,21002,-73502,-73502,OK
209.005173,TraderOne,Tick,1146,1139,7,-7,149800,149800,21002,-73502,-73502,OK
209.250445,TraderOne,Tick,1146,1139,7,-7,149800,149800,21002,-73502,-73502,OK
209.530649,TraderOne,Tick,1146,1139,7,-7,149800,149800,21002,-73502,-73502,OK
209.775474,TraderOne,Tick,1146,1149,-3,3,150300,149800,20852,-73352,-74252,OK
209.971225,TraderOne,Tick,1146,1149,-3,3,150300,149800,20852,-73352,-74252,OK
210.223749,TraderOne,Tick,1146,1149,-3,3,150300,149800,20852,-73352,-74252,OK
210.483959,TraderOne,Tick,1146,1149,-3,3,150300,149800,20852,-73352,-74252,OK
210.738286,TraderOne,Tick,1146,1149,-3,3,150300,149800,20852,-73352,-74252,OK
211.012975,TraderOne,Tick,1146,1159,-13,13,150400,149900,20702,-72202,-76102,OK
211.273044,TraderOne,Tick,1146,1168,-22,22,150200,149900,20972,-69772,-76372,OK
211.536621,TraderOne,Tick,1146,1168,-22,22,150200,149900,20972,-69772,-76372,OK
211.739298,TraderOne,Tick,1156,1168,-12,12,149900,149600,20822,-74622,-77022,OK
211.987402,TraderOne,Tick,1166,1168,-2,2,149100,149600,20672,-76472,-76072,OK
212.251471,TraderOne,Tick,1166,1168,-2,2,149100,149700,20672,-76472,-76072,OK
212.506162,TraderOne,Tick,1166,1168,-2,2,149100,149700,20672,-76472,-76072,OK
212.800131,TraderOne,Tick,1166,1178,-12,12,150200,149700,20522,-75322,-77722,OK
213.02778,TraderOne,Tick,1166,1178,-12,12,150200,149700,20522,-75322,-77722,OK
213.275978,TraderOne,Tick,1166,1178,-12,12,150200,149300,20522,-75322,-77722,OK
213.50749,TraderOne,Tick,1166,1178,-12,12,150200,149300,20522,-75322,-77722,OK
213.778696,TraderOne,Tick,1166,1178,-12,12,150200,149300,20522,-75322,-77722,OK
213.965253,TraderOne,Tick,1166,1178,-12,12,150200,149300,20522,-75322,-77722,OK
214.222355,TraderOne,Tick,1166,1178,-12,12,150200,149300,20522,-75322,-77722,OK
214.484533,TraderOne,Tick,1166,1178,-12,12,150200,149300,20522,-75322,-77722,OK
214.712825,TraderOne,Tick,1166,1178,-12,12,150200,149600,20522,-75322,-77722,OK
215.030137,TraderOne,Tick,1166,1178,-12,12,150200,149600,20522,-75322,-77722,OK
215.219691,TraderOne,Tick,1166,1178,-12,12,150200,149600,20522,-75322,-77722,OK
215.459848,TraderOne,Tick,1166,1178,-12,12,150200,149600,20522,-75322,-77722,OK
215.753064,TraderOne,Tick,1166,1178,-12,12,150200,149600,20522,-75322,-77722,OK
215.981543,TraderOne,Tick,1172,1178,-6,6,149500,149600,20432,-76432,-75832,OK
216.238193,TraderOne,Tick,1172,1178,-6,6,149500,149600,20432,-76432,-75832,OK
216.526878,TraderOne,Tick,1172,1178,-6,6,149500,149400,20432,-76432,-77032,OK
216.775909,TraderOne,Tick,1172,1178,-6,6,149500,150000,20432,-76432,-74632,OK
217.033166,TraderOne,Tick,1182,1178,4,-4,149100,150000,20731,-74731,-75931,OK
217.291184,TraderOne,Tick,1192,1178,14,-14,149500,150000,21030,-71030,-75230,OK
217.52578,TraderOne,Tick,1202,1178,24,-24,149500,150100,21329,-67329,-74529,OK
217.749222,TraderOne,Tick,1205,1178,27,-27,149700,150100,21419,-66219,-74319,OK
217.971009,TraderOne,Tick,1205,1178,27,-27,149700,149900,21419,-66219,-71619,OK
218.221995,TraderOne,Tick,1205,1178,27,-27,149700,149900,21419,-66219,-71619,OK
218.502468,TraderOne,Tick,1205,1178,27,-27,149700,149900,21419,-66219,-71619,OK
218.756257,TraderOne,Tick,1205,1178,27,-27,149700,149900,21419,-66219,-71619,OK
218.968848,TraderOne,Tick,1205,1178,27,-27,149700,149900,21419,-66219,-71619,OK
219.228349,TraderOne,Tick,1205,1188,17,-17,150500,149900,21269,-68069,-62969,OK
219.516331,TraderOne,Tick,1205,1198,7,-7,150400,149900,21119,-69919,-67819,OK
219.775677,TraderOne,Tick,1205,1198,7,-7,150400,149900,21119,-69919,-67819,OK
220.001154,TraderOne,Tick,1205,1208,-3,3,150500,149900,20969,-69769,-70669,OK
220.260771,TraderOne,Tick,1205,1208,-3,3,150500,149900,20969,-69769,-70669,OK
220.471492,TraderOne,Tick,1205,1208,-3,3,150500,149900,20969,-69769,-70669,OK
220.760718,TraderOne,Tick,1205,1208,-3,3,150500,150000,20969,-69769,-70669,OK
220.98446,TraderOne,Tick,1205,1218,-13,13,150500,150000,20819,-68619,-72519,OK
221.282907,TraderOne,Tick,1205,1218,-13,13,150500,150000,20819,-68619,-72519,OK
221.473412,TraderOne,Tick,1205,1218,-13,13,150500,150100,20819,-68619,-72519,OK
221.732586,TraderOne,Tick,1205,1218,-13,13,150500,150100,20819,-68619,-72519,OK
221.99694,TraderOne,Tick,1205,1218,-13,13,150500,150100,20819,-68619,-72519,OK
222.28431,TraderOne,Tick,1205,1218,-13,13,150500,150100,20819,-68619,-72519,OK
222.471225,TraderOne,Tick,1205,1218,-13,13,150500,150100,20819,-68619,-72519,OK
222.725529,TraderOne,Tick,1215,1218,-3,3,149500,150100,20669,-70469,-69569,OK
222.968036,TraderOne,Tick,1215,1218,-3,3,149500,150000,20669,-70469,-69569,OK
223.276426,TraderOne,Tick,1215,1218,-3,3,149500,150000,20669,-70469,-69569,OK
223.457551,TraderOne,Tick,1215,1218,-3,3,149500,150000,20669,-70469,-69569,OK
223.723975,TraderOne,Tick,1215,1228,-13,13,150200,150000,20519,-70319,-72919,OK
224.020919,TraderOne,Tick,1215,1238,-23,23,150400,150000,20820,-68620,-75520,OK
224.210599,TraderOne,Tick,1215,1244,-29,29,150400,150000,21000,-66400,-75100,OK
224.472486,TraderOne,Tick,1215,1244,-29,29,150400,150000,21000,-66400,-75100,OK
224.757518,TraderOne,Tick,1215,1244,-29,29,150400,149800,21000,-66400,-75100,OK
224.986904,TraderOne,Tick,1215,1254,-39,39,150100,149400,21300,-62700,-70500,OK
225.213211,TraderOne,Tick,1215,1254,-39,39,150100,149500,21300,-62700,-70500,OK
225.504848,TraderOne,Tick,1215,1254,-39,39,150100,149500,21300,-62700,-70500,OK
225.704843,TraderOne,Tick,1215,1254,-39,39,150100,149500,21300,-62700,-70500,OK
225.986213,TraderOne,Tick,1215,1254,-39,39,150100,149500,21300,-62700,-70500,OK
226.284348,TraderOne,Tick,1225,1254,-29,29,149300,149500,21150,-66550,-60750,OK
226.49986,TraderOne,Tick,1225,1254,-29,29,149300,149500,21150,-66550,-60750,OK
226.764499,TraderOne,Tick,1225,1264,-39,39,150300,149500,21000,-64400,-72200,OK
227.009841,TraderOne,Tick,1225,1264,-39,39,150300,149500,21000,-64400,-72200,OK
227.265592,TraderOne,Tick,1225,1264,-39,39,150300,149500,21000,-64400,-72200,OK
227.537975,TraderOne,Tick,1225,1264,-39,39,150300,150200,21000,-64400,-68300,OK
227.77831,TraderOne,Tick,1235,1264,-29,29,150600,150600,21301,-68201,-68201,OK
228.018513,TraderOne,Tick,1245,1264,-19,19,150600,150800,21602,-67502,-63702,OK
228.264047,TraderOne,Tick,1255,1264,-9,9,150600,150600,21903,-66803,-66803,OK
228.53906,TraderOne,Tick,1265,1264,1,-1,150600,150600,22204,-66104,-66104,OK
228.71021,TraderOne,Tick,1275,1264,11,-11,150600,150600,22505,-66405,-66405,OK
229.01201,TraderOne,Tick,1279,1264,15,-15,150500,150600,22445,-65545,-67045,OK
229.268588,TraderOne,Tick,1289,1264,25,-25,150600,150600,22746,-64846,-64846,OK
229.521979,TraderOne,Tick,1289,1264,25,-25,150600,150600,22746,-64846,-64846,OK
229.722442,TraderOne,Tick,1289,1264,25,-25,150600,150600,22746,-64846,-64846,OK
229.977491,TraderOne,Tick,1289,1264,25,-25,150600,150600,22746,-64846,-64846,OK
230.29176,TraderOne,Tick,1289,1264,25,-25,150600,150700,22746,-64846,-67346,OK
230.492036,TraderOne,Tick,1289,1264,25,-25,150600,150700,22746,-64846,-67346,OK
230.703234,TraderOne,Tick,1289,1264,25,-25,150600,150700,22746,-64846,-67346,OK
230.978719,TraderOne,Tick,1289,1264,25,-25,150600,150700,22746,-64846,-67346,OK
231.26268,TraderOne,Tick,1289,1264,25,-25,150600,150700,22746,-64846,-67346,OK
231.520511,TraderOne,Tick,1289,1264,25,-25,150600,150700,22746,-64846,-67346,OK
231.787428,TraderOne,Tick,1289,1264,25,-25,150600,150700,22746,-64846,-67346,OK
231.967795,TraderOne,Tick,1289,1264,25,-25,150600,150700,22746,-64846,-67346,OK
232.220261,TraderOne,Tick,1289,1264,25,-25,150600,150700,22746,-64846,-67346,OK
232.483004,TraderOne,Tick,1289,1264,25,-25,150600,150700,22746,-64846,-67346,OK
232.791904,TraderOne,Tick,1289,1264,25,-25,150600,150700,22746,-64846,-67346,OK
233.018112,TraderOne,Tick,1289,1264,25,-25,150600,150700,22746,-64846,-67346,OK
233.212684,TraderOne,Tick,1299,1264,35,-35,150700,151100,23047,-62147,-72647,OK
233.523672,TraderOne,Tick,1309,1264,45,-45,150700,151100,23348,-59448,-72948,OK
233.705304,TraderOne,Tick,1309,1264,45,-45,150700,151100,23348,-59448,-72948,OK
233.99699,TraderOne,Tick,1309,1264,45,-45,150700,151100,23348,-59448,-72948,OK
234.229899,TraderOne,Tick,1309,1264,45,-45,150700,151100,23348,-59448,-72948,OK
234.478057,TraderOne,Tick,1309,1264,45,-45,150700,151200,23348,-59448,-72948,OK
234.706942,TraderOne,Tick,1309,1264,45,-45,150700,151200,23348,-59448,-72948,OK
234.959198,TraderOne,Tick,1319,1264,55,-55,150800,151200,23650,-55750,-72250,OK
235.219869,TraderOne,Tick,1319,1274,45,-45,150900,151500,23499,-64599,-78099,OK
235.479999,TraderOne,Tick,1320,1274,46,-46,151100,151500,23529,-64229,-78029,OK
235.746063,TraderOne,Tick,1320,1274,46,-46,151100,151600,23529,-64229,-78029,OK
235.998374,TraderOne,Tick,1330,1274,56,-56,151200,151600,23831,-59531,-76331,OK
236.281168,TraderOne,Tick,1330,1274,56,-56,151200,151600,23831,-59531,-76331,OK
236.531379,TraderOne,Tick,1330,1274,56,-56,151000,151600,23831,-59531,-76331,OK
236.705289,TraderOne,Tick,1330,1284,46,-46,151300,151600,23680,-64380,-78180,OK
236.957072,TraderOne,Tick,1340,1284,56,-56,151000,151600,23529,-60229,-77029,OK
237.237895,TraderOne,Tick,1340,1284,56,-56,151000,151600,23529,-60229,-77029,OK
237.469355,TraderOne,Tick,1340,1284,56,-56,151000,151700,23529,-60229,-77029,OK
237.777797,TraderOne,Tick,1340,1284,56,-56,151000,151700,23529,-60229,-77029,OK
237.98084,TraderOne,Tick,1340,1284,56,-56,151000,151700,23529,-60229,-77029,OK
238.263692,TraderOne,Tick,1340,1284,56,-56,151000,151700,23529,-60229,-77029,OK
238.499532,TraderOne,Tick,1340,1284,56,-56,151000,151700,23529,-60229,-77029,OK
238.715484,TraderOne,Tick,1340,1284,56,-56,151000,151700,23529,-60229,-77029,OK
238.954619,TraderOne,Tick,1340,1284,56,-56,151000,151700,23529,-60229,-77029,OK
239.283711,TraderOne,Tick,1340,1284,56,-56,151000,151500,23529,-60229,-77029,OK
239.514736,TraderOne,Tick,1340,1294,46,-46,151300,151500,23378,-65078,-74278,OK
239.739698,TraderOne,Tick,1340,1294,46,-46,151300,151600,23378,-65078,-78878,OK
240.017024,TraderOne,Tick,1340,1294,46,-46,151300,151500,23378,-65078,-74278,OK
240.244902,TraderOne,Tick,1340,1294,46,-46,151300,151400,23378,-65078,-69678,OK
240.482428,TraderOne,Tick,1340,1304,36,-36,151400,151400,23227,-69927,-69927,OK
240.780249,TraderOne,Tick,1340,1304,36,-36,151400,151500,23227,-69927,-73527,OK
240.986249,TraderOne,Tick,1340,1304,36,-36,151400,151500,23227,-69927,-73527,OK
241.224058,TraderOne,Tick,1340,1304,36,-36,151400,151500,23227,-69927,-73527,OK
241.484135,TraderOne,Tick,1340,1304,36,-36,151400,151500,23227,-69927,-73527,OK
241.703694,TraderOne,Tick,1340,1304,36,-36,151400,151500,23227,-69927,-73527,OK
242.018343,TraderOne,Tick,1350,1304,46,-46,150900,151500,23076,-66776,-80576,OK
242.271549,TraderOne,Tick,1350,1304,46,-46,150800,151300,23076,-66776,-80576,OK
242.523685,TraderOne,Tick,1350,1304,46,-46,150800,151300,23076,-66776,-80576,OK
242.7286,TraderOne,Tick,1350,1304,46,-46,150800,151300,23076,-66776,-80576,OK
242.965972,TraderOne,Tick,1350,1304,46,-46,150800,151300,23076,-66776,-80576,OK
243.218593,TraderOne,Tick,1350,1304,46,-46,150800,151300,23076,-66776,-80576,OK
243.468203,TraderOne,Tick,1360,1304,56,-56,150800,151300,22925,-62625,-79425,OK
243.795444,TraderOne,Tick,1360,1304,56,-56,150800,151300,22925,-62625,-79425,OK
243.988523,TraderOne,Tick,1360,1304,56,-56,150800,151500,22925,-62625,-79425,OK
244.21805,TraderOne,Tick,1360,1304,56,-56,150800,151500,22925,-62625,-79425,OK
244.536111,TraderOne,Tick,1360,1304,56,-56,150800,151500,22925,-62625,-79425,OK
244.791493,TraderOne,Tick,1360,1304,56,-56,150800,151500,22925,-62625,-79425,OK
244.966358,TraderOne,Tick,1360,1304,56,-56,150800,151500,22925,-62625,-79425,OK
245.291778,TraderOne,Tick,1360,1304,56,-56,150800,151400,22925,-62625,-79425,OK
245.490649,TraderOne,Tick,1360,1304,56,-56,150800,151600,22925,-62625,-79425,OK
245.748272,TraderOne,Tick,1360,1314,46,-46,151400,151800,22774,-68474,-82274,OK
245.971113,TraderOne,Tick,1360,1314,46,-46,151400,151800,22774,-68474,-82274,OK
246.226252,TraderOne,Tick,1360,1314,46,-46,151400,151800,22774,-68474,-82274,OK
246.538563,TraderOne,Tick,1360,1314,46,-46,151400,151800,22774,-68474,-82274,OK
246.792761,TraderOne,Tick,1360,1314,46,-46,151400,151800,22774,-68474,-82274,OK
247.04423,TraderOne,Tick,1370,1314,56,-56,151400,152100,23077,-64777,-81577,OK
247.288267,TraderOne,Tick,1380,1314,66,-66,151700,152100,23380,-59680,-79480,OK
247.485317,TraderOne,Tick,1380,1324,56,-56,151600,152100,23683,-65983,-82783,OK
247.732915,TraderOne,Tick,1380,1324,56,-56,151400,152100,23683,-65983,-82783,OK
248.037029,TraderOne,Tick,1380,1324,56,-56,151400,152100,23683,-65983,-82783,OK
248.288467,TraderOne,Tick,1380,1324,56,-56,151500,152100,23683,-65983,-82783,OK
248.529598,TraderOne,Tick,1380,1324,56,-56,151500,152100,23683,-65983,-82783,OK
248.740364,TraderOne,Tick,1380,1324,56,-56,151500,152100,23683,-65983,-82783,OK
249.047796,TraderOne,Tick,1380,1324,56,-56,151800,152300,23683,-65983,-82783,OK
249.22712,TraderOne,Tick,1390,1334,56,-56,152000,152500,23835,-68135,-84935,OK
249.509858,TraderOne,Tick,1400,1344,56,-56,152400,152900,23987,-70287,-87087,OK
249.781919,TraderOne,Tick,1400,1344,56,-56,152400,152600,23987,-70287,-81487,OK
249.966217,TraderOne,Tick,1400,1354,46,-46,152400,152700,24292,-73592,-87392,OK
250.28742,TraderOne,Tick,1400,1354,46,-46,152400,152700,24292,-73592,-87392,OK
250.529656,TraderOne,Tick,1400,1364,36,-36,152600,152700,24140,-77440,-81040,OK
250.752249,TraderOne,Tick,1400,1364,36,-36,152600,152700,24140,-77440,-81040,OK
250.953278,TraderOne,Tick,1400,1364,36,-36,152600,152700,24140,-77440,-81040,OK
251.231267,TraderOne,Tick,1410,1364,46,-46,152000,152500,23988,-74288,-88088,OK
251.535021,TraderOne,Tick,1410,1364,46,-46,152000,152600,23988,-74288,-88088,OK
251.773594,TraderOne,Tick,1410,1364,46,-46,152000,152500,23988,-74288,-88088,OK
252.015828,TraderOne,Tick,1410,1364,46,-46,152000,152500,23988,-74288,-88088,OK
252.287726,TraderOne,Tick,1410,1364,46,-46,152000,152500,23988,-74288,-88088,OK
252.532997,TraderOne,Tick,1410,1364,46,-46,152000,152500,23988,-74288,-88088,OK
252.781084,TraderOne,Tick,1410,1374,36,-36,152600,152500,23836,-78136,-74536,OK
253.038828,TraderOne,Tick,1410,1374,36,-36,152600,152500,23836,-78136,-74536,OK
253.273609,TraderOne,Tick,1410,1374,36,-36,152600,152500,23836,-78136,-74536,OK
253.54431,TraderOne,Tick,1410,1374,36,-36,152600,152500,23836,-78136,-74536,OK
253.777281,TraderOne,Tick,1410,1374,36,-36,152600,152500,23836,-78136,-74536,OK
253.98747,TraderOne,Tick,1410,1374,36,-36,152600,152500,23836,-78136,-74536,OK
254.235687,TraderOne,Tick,1410,1374,36,-36,152600,152500,23836,-78136,-74536,OK
254.483402,TraderOne,Tick,1410,1374,36,-36,152200,152500,23836,-78136,-88936,OK
254.765652,TraderOne,Tick,1410,1374,36,-36,152200,152500,23836,-78136,-88936,OK
254.968958,TraderOne,Tick,1410,1374,36,-36,152200,152500,23836,-78136,-88936,OK
255.204162,TraderOne,Tick,1410,1374,36,-36,152200,152500,23836,-78136,-88936,OK
255.455619,TraderOne,Tick,1410,1374,36,-36,152200,152500,23836,-78136,-88936,OK
255.785779,TraderOne,Tick,1410,1374,36,-36,152200,152200,23836,-78136,-78136,OK
255.975029,TraderOne,Tick,1410,1374,36,-36,152200,152200,23836,-78136,-78136,OK
256.283525,TraderOne,Tick,1410,1374,36,-36,152200,152000,23836,-78136,-70936,OK
256.546777,TraderOne,Tick,1410,1374,36,-36,152200,152000,23836,-78136,-70936,OK
256.724174,TraderOne,Tick,1410,1374,36,-36,152200,152000,23836,-78136,-70936,OK
257.013072,TraderOne,Tick,1410,1374,36,-36,152200,152000,23836,-78136,-70936,OK
257.283659,TraderOne,Tick,1420,1374,46,-46,151400,152000,23684,-74984,-88784,OK
257.521406,TraderOne,Tick,1420,1374,46,-46,151400,152000,23684,-74984,-88784,OK
257.79806,TraderOne,Tick,1420,1374,46,-46,151400,152000,23684,-74984,-88784,OK
257.977478,TraderOne,Tick,1420,1374,46,-46,151400,152000,23684,-74984,-88784,OK
258.217222,TraderOne,Tick,1420,1384,36,-36,151700,151900,23532,-78832,-86032,OK
258.495452,TraderOne,Tick,1420,1384,36,-36,151700,151800,23532,-78832,-82432,OK
258.74457,TraderOne,Tick,1420,1384,36,-36,151700,151700,23532,-78832,-78832,OK
259.000753,TraderOne,Tick,1420,1394,26,-26,151700,151700,23380,-81680,-81680,OK
259.276387,TraderOne,Tick,1420,1394,26,-26,151700,151600,23380,-81680,-79080,OK
259.523137,TraderOne,Tick,1420,1394,26,-26,151700,151600,23380,-81680,-79080,OK
259.701536,TraderOne,Tick,1420,1394,26,-26,151700,151600,23380,-81680,-79080,OK
259.954198,TraderOne,Tick,1420,1394,26,-26,151700,151600,23380,-81680,-79080,OK
260.238008,TraderOne,Tick,1430,1394,36,-36,151300,151600,23229,-79529,-90329,OK
260.460987,TraderOne,Tick,1430,1394,36,-36,151300,151600,23229,-79529,-90329,OK
260.795346,TraderOne,Tick,1430,1404,26,-26,151300,151800,23532,-82832,-90632,OK
261.029197,TraderOne,Tick,1430,1404,26,-26,151300,151800,23532,-82832,-90632,OK
261.246545,TraderOne,Tick,1430,1404,26,-26,151300,151800,23532,-82832,-90632,OK
261.509534,TraderOne,Tick,1430,1404,26,-26,151300,151800,23532,-82832,-90632,OK
261.713699,TraderOne,Tick,1430,1414,16,-16,152000,151800,23380,-84680,-81480,OK
262.038626,TraderOne,Tick,1440,1414,26,-26,151700,151800,23228,-85528,-88128,OK
262.204785,TraderOne,Tick,1450,1414,36,-36,151600,151800,23531,-83831,-91031,OK
262.53902,TraderOne,Tick,1450,1414,36,-36,151600,151800,23531,-83831,-91031,OK
262.71585,TraderOne,Tick,1450,1414,36,-36,151600,151800,23531,-83831,-91031,OK
263.036537,TraderOne,Tick,1450,1414,36,-36,151600,151800,23531,-83831,-91031,OK
263.209237,TraderOne,Tick,1460,1414,46,-46,151600,152200,23834,-80134,-93934,OK
263.515219,TraderOne,Tick,1469,1414,55,-55,151600,152200,24107,-75907,-92407,OK
263.739197,TraderOne,Tick,1469,1424,45,-45,151500,152200,24410,-81210,-94710,OK
264.012618,TraderOne,Tick,1469,1424,45,-45,151500,152200,24410,-81210,-94710,OK
264.27615,TraderOne,Tick,1469,1424,45,-45,151500,152200,24410,-81210,-94710,OK
264.463844,TraderOne,Tick,1469,1424,45,-45,151500,152200,24410,-81210,-94710,OK
264.713798,TraderOne,Tick,1469,1424,45,-45,151500,151800,24410,-81210,-94710,OK
264.973269,TraderOne,Tick,1469,1424,45,-45,151500,151800,24410,-81210,-94710,OK
265.299453,TraderOne,Tick,1469,1424,45,-45,151500,151800,24410,-81210,-94710,OK
265.508042,TraderOne,Tick,1469,1424,45,-45,151500,151800,24410,-81210,-94710,OK
265.753162,TraderOne,Tick,1469,1424,45,-45,151500,151800,24410,-81210,-94710,OK
265.962792,TraderOne,Tick,1469,1434,35,-35,152100,151800,24258,-86058,-75558,OK
266.273316,TraderOne,Tick,1469,1434,35,-35,152100,151800,24258,-86058,-75558,OK
266.499471,TraderOne,Tick,1469,1440,29,-29,151800,151800,24167,-87767,-87767,OK
266.709507,TraderOne,Tick,1469,1440,29,-29,151800,151800,24167,-87767,-87767,OK
267.030156,TraderOne,Tick,1469,1440,29,-29,151800,152200,24167,-87767,-96467,OK
267.289357,TraderOne,Tick,1469,1440,29,-29,151800,152200,24167,-87767,-96467,OK
267.46926,TraderOne,Tick,1469,1440,29,-29,152100,152200,24167,-87767,-90667,OK
267.74073,TraderOne,Tick,1469,1440,29,-29,152100,152200,24167,-87767,-90667,OK
267.989702,TraderOne,Tick,1469,1440,29,-29,152100,152200,24167,-87767,-90667,OK
268.250444,TraderOne,Tick,1479,1440,39,-39,152300,152200,24471,-85771,-81871,OK
268.475815,TraderOne,Tick,1479,1440,39,-39,152300,152200,24471,-85771,-81871,OK
268.759112,TraderOne,Tick,1479,1440,39,-39,152300,152600,24471,-85771,-97471,OK
269.028915,TraderOne,Tick,1479,1440,39,-39,152300,152600,24471,-85771,-97471,OK
269.249876,TraderOne,Tick,1479,1440,39,-39,152300,152600,24471,-85771,-97471,OK
269.480826,TraderOne,Tick,1479,1440,39,-39,152300,153000,24471,-85771,-97471,OK
269.792818,TraderOne,Tick,1487,1440,47,-47,152300,153000,24715,-83615,-97715,OK
270.041723,TraderOne,Tick,1497,1440,57,-57,152100,153000,24563,-79463,-96563,OK
270.278851,TraderOne,Tick,1497,1440,57,-57,152100,153000,24563,-79463,-96563,OK
270.470747,TraderOne,Tick,1497,1440,57,-57,152100,152900,24563,-79463,-96563,OK
270.754695,TraderOne,Tick,1497,1440,57,-57,152100,152900,24563,-79463,-96563,OK
270.999532,TraderOne,Tick,1497,1440,57,-57,152100,153000,24563,-79463,-96563,OK
271.269143,TraderOne,Tick,1497,1440,57,-57,152100,153300,24563,-79463,-96563,OK
271.535136,TraderOne,Tick,1507,1440,67,-67,152700,153300,24868,-72768,-92868,OK
271.730001,TraderOne,Tick,1517,1450,67,-67,153000,153700,25021,-75921,-96021,OK
271.951072,TraderOne,Tick,1517,1450,67,-67,153000,153600,25021,-75921,-96021,OK
272.291761,TraderOne,Tick,1517,1460,57,-57,153100,153600,24868,-81768,-98868,OK
272.523036,TraderOne,Tick,1517,1470,47,-47,153600,153600,25174,-86074,-86074,OK
272.763259,TraderOne,Tick,1527,1470,57,-57,152800,153600,25021,-82921,-100021,OK
272.958677,TraderOne,Tick,1527,1470,57,-57,152800,153600,25021,-82921,-100021,OK
273.288362,TraderOne,Tick,1527,1470,57,-57,152800,153600,25021,-82921,-100021,OK
273.54735,TraderOne,Tick,1537,1470,67,-67,152600,153600,24868,-77768,-97868,OK
273.708272,TraderOne,Tick,1537,1480,57,-57,152700,153600,25173,-84073,-101173,OK
274.027939,TraderOne,Tick,1537,1490,47,-47,153800,153600,25020,-87920,-78520,OK
274.222782,TraderOne,Tick,1537,1490,47,-47,153800,153600,25020,-87920,-78520,OK
274.476248,TraderOne,Tick,1537,1490,47,-47,153800,152900,25020,-87920,-73820,OK
274.740459,TraderOne,Tick,1537,1490,47,-47,153800,152900,25020,-87920,-73820,OK
275.002883,TraderOne,Tick,1537,1500,37,-37,152500,152900,25325,-92225,-103325,OK
275.29367,TraderOne,Tick,1547,1510,37,-37,152300,152700,25478,-91378,-102478,OK
275.544767,TraderOne,Tick,1547,1519,28,-28,152600,152700,25341,-94841,-97641,OK
275.741542,TraderOne,Tick,1547,1519,28,-28,152600,152700,25341,-94841,-97641,OK
276.013379,TraderOne,Tick,1547,1519,28,-28,152600,152700,25341,-94841,-97641,OK
276.218457,TraderOne,Tick,1547,1519,28,-28,152600,153000,25341,-94841,-103241,OK
276.478876,TraderOne,Tick,1547,1519,28,-28,152600,153100,25341,-94841,-103241,OK
276.787596,TraderOne,Tick,1547,1519,28,-28,152600,153100,25341,-94841,-103241,OK
276.973248,TraderOne,Tick,1557,1519,38,-38,152400,153100,25188,-94688,-106088,OK
277.230929,TraderOne,Tick,1557,1519,38,-38,152400,153100,25188,-94688,-106088,OK
277.484125,TraderOne,Tick,1557,1519,38,-38,152400,153100,25188,-94688,-106088,OK
277.766857,TraderOne,Tick,1557,1519,38,-38,152400,152900,25188,-94688,-106088,OK
278.042765,TraderOne,Tick,1557,1519,38,-38,152400,152900,25188,-94688,-106088,OK
278.259955,TraderOne,Tick,1557,1519,38,-38,152400,152900,25188,-94688,-106088,OK
278.462068,TraderOne,Tick,1557,1519,38,-38,152400,153000,25188,-94688,-106088,OK
278.725172,TraderOne,Tick,1557,1529,28,-28,152800,153200,25035,-100535,-108935,OK
279.021257,TraderOne,Tick,1557,1529,28,-28,152800,153200,25035,-100535,-108935,OK
279.258246,TraderOne,Tick,1557,1529,28,-28,152800,153200,25035,-100535,-108935,OK
279.510937,TraderOne,Tick,1557,1529,28,-28,152800,153200,25035,-100535,-108935,OK
279.716454,TraderOne,Tick,1557,1529,28,-28,152800,153200,25035,-100535,-108935,OK
279.951442,TraderOne,Tick,1557,1529,28,-28,152800,153200,25035,-100535,-108935,OK
280.231077,TraderOne,Tick,1557,1529,28,-28,152800,153000,25035,-100535,-106135,OK
280.504771,TraderOne,Tick,1557,1539,18,-18,152800,152800,25341,-102841,-102841,OK
280.749285,TraderOne,Tick,1557,1549,8,-8,152800,152800,25647,-103147,-103147,OK
281.041405,TraderOne,Tick,1557,1549,8,-8,152800,152600,25647,-103147,-101547,OK
281.227791,TraderOne,Tick,1557,1559,-2,2,152800,152600,25953,-102453,-102853,OK
281.544035,TraderOne,Tick,1557,1569,-12,12,152800,152700,26259,-102759,-103959,OK
281.72203,TraderOne,Tick,1557,1569,-12,12,152800,152700,26259,-102759,-103959,OK
281.964722,TraderOne,Tick,1557,1569,-12,12,152800,152700,26259,-102759,-103959,OK
282.299852,TraderOne,Tick,1567,1569,-2,2,152300,152700,26106,-104606,-104006,OK
282.471427,TraderOne,Tick,1567,1569,-2,2,152300,152700,26106,-104606,-104006,OK
282.731403,TraderOne,Tick,1567,1569,-2,2,152300,152800,26106,-104606,-104006,OK
282.972456,TraderOne,Tick,1567,1569,-2,2,152300,152800,26106,-104606,-104006,OK
283.298707,TraderOne,Tick,1567,1569,-2,2,152300,152800,26106,-104606,-104006,OK
283.49133,TraderOne,Tick,1567,1569,-2,2,152300,152800,26106,-104606,-104006,OK
283.799988,TraderOne,Tick,1577,1569,8,-8,152300,152800,25953,-105453,-107853,OK
284.006041,TraderOne,Tick,1577,1569,8,-8,152300,152800,25953,-105453,-107853,OK
284.266304,TraderOne,Tick,1577,1579,-2,2,153400,152800,25800,-105300,-105900,OK
284.489065,TraderOne,Tick,1577,1579,-2,2,153400,152800,25800,-105300,-105900,OK
284.703488,TraderOne,Tick,1587,1579,8,-8,152400,152800,25647,-106147,-108547,OK
284.979973,TraderOne,Tick,1587,1579,8,-8,152400,153100,25647,-106147,-108547,OK
285.221107,TraderOne,Tick,1596,1579,17,-17,153100,153500,25509,-103309,-108409,OK
285.465966,TraderOne,Tick,1600,1589,11,-11,153900,153500,25478,-103878,-100578,OK
285.710134,TraderOne,Tick,1600,1589,11,-11,153900,153500,25478,-103878,-100578,OK
286.047497,TraderOne,Tick,1600,1589,11,-11,153900,153800,25478,-103878,-102778,OK
286.215532,TraderOne,Tick,1600,1589,11,-11,153900,153600,25478,-103878,-100578,OK
286.462169,TraderOne,Tick,1600,1589,11,-11,153900,153600,25478,-103878,-100578,OK
286.759144,TraderOne,Tick,1600,1589,11,-11,153900,153600,25478,-103878,-100578,OK
287.048094,TraderOne,Tick,1600,1599,1,-1,153900,153500,25325,-104725,-104425,OK
287.201031,TraderOne,Tick,1600,1599,1,-1,153900,153500,25325,-104725,-104425,OK
287.507065,TraderOne,Tick,1605,1599,6,-6,153500,153600,25248,-104648,-105248,OK
287.739963,TraderOne,Tick,1605,1599,6,-6,153500,153600,25248,-104648,-105248,OK
288.028101,TraderOne,Tick,1605,1599,6,-6,153500,153600,25248,-104648,-105248,OK
288.252117,TraderOne,Tick,1605,1599,6,-6,153500,153400,25248,-104648,-104048,OK
288.5144,TraderOne,Tick,1605,1599,6,-6,153500,153400,25248,-104648,-104048,OK
288.757024,TraderOne,Tick,1605,1599,6,-6,153500,153400,25248,-104648,-104048,OK
289.027285,TraderOne,Tick,1605,1599,6,-6,153500,153400,25248,-104648,-104048,OK
289.284751,TraderOne,Tick,1605,1599,6,-6,153500,153400,25248,-104648,-104048,OK
289.494041,TraderOne,Tick,1605,1599,6,-6,153500,153400,25248,-104648,-104048,OK
289.783927,TraderOne,Tick,1605,1599,6,-6,153500,153400,25248,-104648,-104048,OK
290.004974,TraderOne,Tick,1605,1599,6,-6,153500,153400,25248,-104648,-104048,OK
290.294562,TraderOne,Tick,1605,1599,6,-6,153400,153500,25248,-104648,-105248,OK
290.548121,TraderOne,Tick,1605,1599,6,-6,153400,153500,25248,-104648,-105248,OK
290.795995,TraderOne,Tick,1611,1599,12,-12,153500,153500,25156,-105156,-105156,OK
290.966016,TraderOne,Tick,1613,1609,4,-4,153300,153500,24971,-104771,-105571,OK
291.267632,TraderOne,Tick,1613,1609,4,-4,153300,153500,24971,-104771,-105571,OK
291.514399,TraderOne,Tick,1613,1619,-6,6,153900,153500,24817,-104617,-106417,OK
291.701651,TraderOne,Tick,1613,1619,-6,6,153900,153500,24817,-104617,-106417,OK
292.045216,TraderOne,Tick,1613,1619,-6,6,153900,153500,24817,-104617,-106417,OK
292.214867,TraderOne,Tick,1613,1619,-6,6,153900,153500,24817,-104617,-106417,OK
292.504266,TraderOne,Tick,1613,1629,-16,16,153900,153500,24663,-103463,-108263,OK
292.717179,TraderOne,Tick,1613,1639,-26,26,153900,153600,24971,-100771,-108571,OK
292.982461,TraderOne,Tick,1613,1639,-26,26,153900,153600,24971,-100771,-108571,OK
293.244807,TraderOne,Tick,1613,1639,-26,26,153900,153600,24971,-100771,-108571,OK
293.502056,TraderOne,Tick,1613,1649,-36,36,153900,153400,25279,-98079,-108879,OK
293.716546,TraderOne,Tick,1613,1649,-36,36,153900,153400,25279,-98079,-108879,OK
293.987755,TraderOne,Tick,1613,1659,-46,46,153900,153400,25587,-94387,-108187,OK
294.227591,TraderOne,Tick,1613,1659,-46,46,153900,153400,25587,-94387,-108187,OK
294.529402,TraderOne,Tick,1613,1659,-46,46,153900,153400,25587,-94387,-108187,OK
294.794079,TraderOne,Tick,1613,1659,-46,46,154000,153400,25587,-94387,-108187,OK
294.962748,TraderOne,Tick,1613,1659,-46,46,154000,153500,25587,-94387,-108187,OK
295.274036,TraderOne,Tick,1623,1659,-36,36,154000,153500,25895,-99695,-110495,OK
295.533842,TraderOne,Tick,1633,1659,-26,26,153800,153500,25741,-103541,-111341,OK
295.788886,TraderOne,Tick,1633,1659,-26,26,153800,153500,25741,-103541,-111341,OK
296.03517,TraderOne,Tick,1633,1659,-26,26,153800,153500,25741,-103541,-111341,OK
296.264611,TraderOne,Tick,1633,1659,-26,26,153800,153500,25741,-103541,-111341,OK
296.472195,TraderOne,Tick,1633,1659,-26,26,153800,153500,25741,-103541,-111341,OK
296.793086,TraderOne,Tick,1633,1669,-36,36,153800,153400,26049,-100849,-111649,OK
297.011616,TraderOne,Tick,1633,1669,-36,36,153800,153400,26049,-100849,-111649,OK
297.254367,TraderOne,Tick,1633,1679,-46,46,153800,153200,26357,-97157,-110957,OK
297.501741,TraderOne,Tick,1633,1679,-46,46,153800,153300,26357,-97157,-110957,OK
297.734652,TraderOne,Tick,1633,1679,-46,46,153800,153300,26357,-97157,-110957,OK
297.994387,TraderOne,Tick,1643,1679,-36,36,153800,153500,26665,-101465,-112265,OK
298.298672,TraderOne,Tick,1653,1679,-26,26,153100,153600,26511,-104311,-96511,OK
298.550366,TraderOne,Tick,1663,1679,-16,16,153100,153600,26817,-99617,-94817,OK
298.708159,TraderOne,Tick,1673,1679,-6,6,153100,153600,27123,-94923,-93123,OK
298.953835,TraderOne,Tick,1676,1679,-3,3,153100,153600,27215,-93815,-92915,OK
299.243787,TraderOne,Tick,1676,1679,-3,3,153100,153400,27215,-93815,-92915,OK
299.524585,TraderOne,Tick,1676,1679,-3,3,153100,153400,27215,-93815,-92915,OK
299.72415,TraderOne,Tick,1676,1679,-3,3,153100,153500,27215,-93815,-92915,OK
300.02674,TraderOne,Tick,1676,1679,-3,3,153100,153700,27215,-93815,-92915,OK
300.227283,TraderOne,Tick,1676,1679,-3,3,153100,153700,27215,-93815,-92915,OK
300.495203,TraderOne,Tick,1676,1679,-3,3,153100,153600,27215,-93815,-92915,OK
300.704629,TraderOne,Tick,1676,1679,-3,3,153100,153600,27215,-93815,-92915,OK
301.034475,TraderOne,Tick,1676,1679,-3,3,153100,153600,27215,-93815,-92915,OK
301.210989,TraderOne,Tick,1676,1679,-3,3,153100,153700,27215,-93815,-92915,OK
301.523786,TraderOne,Tick,1676,1679,-3,3,153100,153600,27215,-93815,-92915,OK
301.747339,TraderOne,Tick,1676,1679,-3,3,153100,153600,27215,-93815,-92915,OK
302.011526,TraderOne,Tick,1676,1679,-3,3,153100,153600,27215,-93815,-92915,OK
302.296705,TraderOne,Tick,1676,1679,-3,3,153100,153600,27215,-93815,-92915,OK
302.515792,TraderOne,Tick,1676,1679,-3,3,153100,153600,27215,-93815,-92915,OK
302.766316,TraderOne,Tick,1686,1679,7,-7,153300,153600,27061,-94661,-96761,OK
302.960775,TraderOne,Tick,1686,1689,-3,3,153700,153500,27368,-94968,-95568,OK
303.285003,TraderOne,Tick,1696,1699,-3,3,153000,153300,27521,-97121,-96221,OK
303.517136,TraderOne,Tick,1696,1699,-3,3,153000,153300,27521,-97121,-96221,OK
303.792717,TraderOne,Tick,1696,1699,-3,3,153000,153400,27521,-97121,-96221,OK
304.013185,TraderOne,Tick,1696,1699,-3,3,153000,153400,27521,-97121,-96221,OK
304.270603,TraderOne,Tick,1696,1709,-13,13,154000,153200,27367,-93967,-97867,OK
304.530972,TraderOne,Tick,1696,1709,-13,13,154000,153100,27367,-93967,-97867,OK
304.774352,TraderOne,Tick,1696,1709,-13,13,154000,153100,27367,-93967,-97867,OK
305.029101,TraderOne,Tick,1706,1719,-13,13,152500,152900,27061,-92661,-88761,OK
305.225083,TraderOne,Tick,1706,1719,-13,13,152500,152900,27061,-92661,-88761,OK
305.46384,TraderOne,Tick,1706,1719,-13,13,152500,152900,27061,-92661,-88761,OK
305.718876,TraderOne,Tick,1706,1719,-13,13,152500,152800,27061,-92661,-88761,OK
305.952247,TraderOne,Tick,1706,1719,-13,13,152500,152800,27061,-92661,-88761,OK
306.252878,TraderOne,Tick,1706,1719,-13,13,152500,152800,27061,-92661,-88761,OK
306.462236,TraderOne,Tick,1716,1719,-3,3,152500,152600,26908,-95508,-95208,OK
306.759046,TraderOne,Tick,1716,1719,-3,3,152500,152600,26908,-95508,-95208,OK
306.985323,TraderOne,Tick,1716,1719,-3,3,152500,152600,26908,-95508,-95208,OK
307.273611,TraderOne,Tick,1716,1719,-3,3,152500,152900,26908,-95508,-94608,OK
307.488092,TraderOne,Tick,1716,1719,-3,3,152500,152900,26908,-95508,-94608,OK
307.711833,TraderOne,Tick,1716,1719,-3,3,152500,152900,26908,-95508,-94608,OK
307.99264,TraderOne,Tick,1716,1719,-3,3,152500,152900,26908,-95508,-94608,OK
308.231347,TraderOne,Tick,1716,1719,-3,3,152500,152900,26908,-95508,-94608,OK
308.485132,TraderOne,Tick,1716,1719,-3,3,152500,152900,26908,-95508,-94608,OK
308.740963,TraderOne,Tick,1716,1719,-3,3,152500,152900,26908,-95508,-94608,OK
309.032872,TraderOne,Tick,1716,1719,-3,3,152500,152900,26908,-95508,-94608,OK
309.239903,TraderOne,Tick,1726,1719,7,-7,153300,152900,26755,-97355,-95255,OK
309.489941,TraderOne,Tick,1736,1729,7,-7,152600,153200,26449,-96049,-98149,OK
309.749952,TraderOne,Tick,1736,1729,7,-7,152600,153200,26449,-96049,-98149,OK
309.987719,TraderOne,Tick,1736,1729,7,-7,152600,153400,26449,-96049,-98149,OK
310.234629,TraderOne,Tick,1736,1736,0,0,153500,153800,26342,-99442,-99442,OK
310.501479,TraderOne,Tick,1746,1736,10,-10,153800,154200,26650,-97750,-100750,OK
310.757953,TraderOne,Tick,1756,1736,20,-20,153800,154200,26958,-96058,-102058,OK
310.960357,TraderOne,Tick,1766,1746,20,-20,154100,154200,27112,-96212,-98212,OK
311.255778,TraderOne,Tick,1766,1746,20,-20,154100,154200,27112,-96212,-98212,OK
311.534868,TraderOne,Tick,1766,1756,10,-10,154100,154200,26958,-98058,-99058,OK
311.70803,TraderOne,Tick,1766,1756,10,-10,154100,154200,26958,-98058,-99058,OK
312.000318,TraderOne,Tick,1766,1756,10,-10,154100,154200,26958,-98058,-99058,OK
312.277648,TraderOne,Tick,1766,1756,10,-10,154100,154200,26958,-98058,-99058,OK
312.503256,TraderOne,Tick,1766,1756,10,-10,154100,154200,26958,-98058,-99058,OK
312.767824,TraderOne,Tick,1776,1756,20,-20,153600,154200,27266,-97366,-103366,OK
313.022037,TraderOne,Tick,1776,1756,20,-20,153600,154200,27266,-97366,-103366,OK
313.295022,TraderOne,Tick,1776,1756,20,-20,153600,154300,27266,-97366,-103366,OK
313.505233,TraderOne,Tick,1776,1766,10,-10,154300,154300,27112,-98212,-98212,OK
313.724665,TraderOne,Tick,1776,1766,10,-10,154300,154300,27112,-98212,-98212,OK
313.973626,TraderOne,Tick,1776,1766,10,-10,154300,154300,27112,-98212,-98212,OK
314.20385,TraderOne,Tick,1776,1766,10,-10,154300,154300,27112,-98212,-98212,OK
314.489378,TraderOne,Tick,1776,1766,10,-10,154300,154300,27112,-98212,-98212,OK
314.759527,TraderOne,Tick,1776,1776,0,0,154500,154300,26958,-99058,-99058,OK
315.0207,TraderOne,Tick,1776,1776,0,0,154500,154300,26958,-99058,-99058,OK
315.214295,TraderOne,Tick,1776,1776,0,0,154500,154300,26958,-99058,-99058,OK
315.513259,TraderOne,Tick,1776,1776,0,0,154500,154300,26958,-99058,-99058,OK
315.770278,TraderOne,Tick,1776,1776,0,0,154500,154300,26958,-99058,-99058,OK
316.004651,TraderOne,Tick,1776,1776,0,0,154500,154300,26958,-99058,-99058,OK
316.259171,TraderOne,Tick,1776,1776,0,0,154500,154300,26958,-99058,-99058,OK
316.528506,TraderOne,Tick,1776,1776,0,0,154500,154300,26958,-99058,-99058,OK
316.783882,TraderOne,Tick,1776,1776,0,0,154500,154300,26958,-99058,-99058,OK
317.024641,TraderOne,Tick,1788,1776,12,-12,154300,154200,26773,-98073,-96873,OK
317.231985,TraderOne,Tick,1788,1786,2,-2,154300,154200,27082,-98382,-98182,OK
317.531689,TraderOne,Tick,1788,1796,-8,8,154500,154200,27391,-97691,-100091,OK
317.799011,TraderOne,Tick,1788,1806,-18,18,154300,154200,27700,-96000,-97800,OK
318.035741,TraderOne,Tick,1788,1816,-28,28,154300,154200,28009,-93309,-96109,OK
318.23078,TraderOne,Tick,1788,1816,-28,28,154300,154200,28009,-93309,-96109,OK
318.529903,TraderOne,Tick,1788,1826,-38,38,154300,153800,28318,-90618,-102018,OK
318.765204,TraderOne,Tick,1788,1836,-48,48,154300,153800,28627,-86927,-101327,OK
319.016517,TraderOne,Tick,1788,1836,-48,48,154300,153800,28627,-86927,-101327,OK
319.268562,TraderOne,Tick,1788,1836,-48,48,154300,153800,28627,-86927,-101327,OK
319.499263,TraderOne,Tick,1788,1836,-48,48,154300,153800,28627,-86927,-101327,OK
319.795294,TraderOne,Tick,1788,1836,-48,48,154300,153700,28627,-86927,-101327,OK
319.960969,TraderOne,Tick,1788,1846,-58,58,154400,153700,28612,-81912,-99312,OK
320.283043,TraderOne,Tick,1788,1846,-58,58,154400,153700,28612,-81912,-99312,OK
320.528279,TraderOne,Tick,1788,1846,-58,58,154400,153900,28612,-81912,-99312,OK
320.751461,TraderOne,Tick,1798,1846,-48,48,154400,153900,28921,-88221,-102621,OK
321.023157,TraderOne,Tick,1798,1846,-48,48,154400,153900,28921,-88221,-102621,OK
321.216066,TraderOne,Tick,1798,1846,-48,48,154400,153900,28921,-88221,-102621,OK
321.455121,TraderOne,Tick,1798,1849,-51,51,154400,153900,28875,-86675,-101975,OK
321.717969,TraderOne,Tick,1808,1849,-41,41,154400,153800,29184,-91984,-104284,OK
322.006879,TraderOne,Tick,1808,1859,-51,51,154200,153800,29492,-87292,-102592,OK
322.237537,TraderOne,Tick,1818,1859,-41,41,154300,153800,29801,-93601,-105901,OK
322.531606,TraderOne,Tick,1818,1869,-51,51,154200,153800,30109,-89909,-105209,OK
322.740459,TraderOne,Tick,1828,1869,-41,41,154200,153800,30417,-96217,-108517,OK
322.958896,TraderOne,Tick,1828,1869,-41,41,154200,153800,30417,-96217,-108517,OK
323.22974,TraderOne,Tick,1828,1869,-41,41,154200,153800,30417,-96217,-108517,OK
323.502526,TraderOne,Tick,1828,1879,-51,51,154400,153800,30263,-91063,-106363,OK
323.744916,TraderOne,Tick,1838,1879,-41,41,154400,153800,30109,-97909,-110209,OK
324.014625,TraderOne,Tick,1838,1879,-41,41,154400,153800,30109,-97909,-110209,OK
324.206886,TraderOne,Tick,1838,1879,-41,41,154400,153800,30109,-97909,-110209,OK
324.515919,TraderOne,Tick,1848,1879,-31,31,153900,153800,29955,-102755,-105855,OK
324.718305,TraderOne,Tick,1848,1879,-31,31,153900,153800,29955,-102755,-105855,OK
324.999179,TraderOne,Tick,1848,1879,-31,31,153900,153800,29955,-102755,-105855,OK
325.264877,TraderOne,Tick,1848,1879,-31,31,153900,153600,29955,-102755,-112055,OK
325.527749,TraderOne,Tick,1848,1879,-31,31,153900,153600,29955,-102755,-112055,OK
325.704813,TraderOne,Tick,1848,1879,-31,31,153900,153600,29955,-102755,-112055,OK
325.959861,TraderOne,Tick,1858,1879,-21,21,153000,153600,29801,-106601,-100301,OK
326.293508,TraderOne,Tick,1858,1879,-21,21,153000,153600,29801,-106601,-100301,OK
326.500499,TraderOne,Tick,1858,1879,-21,21,153000,153500,29801,-106601,-100301,OK
326.711427,TraderOne,Tick,1858,1879,-21,21,153000,153500,29801,-106601,-100301,OK
327.009502,TraderOne,Tick,1858,1879,-21,21,153000,153400,29801,-106601,-100301,OK
327.282307,TraderOne,Tick,1858,1879,-21,21,153000,153400,29801,-106601,-100301,OK
327.52961,TraderOne,Tick,1858,1888,-30,30,153900,153400,29662,-102862,-111862,OK
327.757675,TraderOne,Tick,1858,1898,-40,40,154000,153400,29508,-98708,-110708,OK
328.044621,TraderOne,Tick,1858,1908,-50,50,154000,153400,29354,-94554,-109554,OK
328.224055,TraderOne,Tick,1868,1908,-40,40,152900,153400,29200,-98400,-86400,OK
328.541066,TraderOne,Tick,1868,1908,-40,40,152900,153400,29200,-98400,-86400,OK
328.773024,TraderOne,Tick,1868,1908,-40,40,152900,153400,29200,-98400,-86400,OK
328.966636,TraderOne,Tick,1868,1908,-40,40,152900,153400,29200,-98400,-86400,OK
329.259687,TraderOne,Tick,1868,1908,-40,40,152900,153400,29200,-98400,-86400,OK
329.473835,TraderOne,Tick,1868,1908,-40,40,152900,153400,29200,-98400,-86400,OK
329.719238,TraderOne,Tick,1868,1908,-40,40,152900,153400,29200,-98400,-86400,OK
330.011376,TraderOne,Tick,1868,1908,-40,40,152900,153400,29200,-98400,-86400,OK
330.229181,TraderOne,Tick,1868,1908,-40,40,152900,153400,29200,-98400,-86400,OK
330.516731,TraderOne,Tick,1868,1918,-50,50,154000,153500,29046,-95246,-110246,OK
330.715005,TraderOne,Tick,1868,1918,-50,50,154000,153500,29046,-95246,-110246,OK
330.950169,TraderOne,Tick,1868,1918,-50,50,154000,153500,29046,-95246,-110246,OK
331.288448,TraderOne,Tick,1868,1918,-50,50,154000,153400,29046,-95246,-110246,OK
331.544535,TraderOne,Tick,1868,1918,-50,50,154000,153400,29046,-95246,-110246,OK
331.709574,TraderOne,Tick,1878,1918,-40,40,152900,153400,28892,-99092,-87092,OK
332.0218,TraderOne,Tick,1878,1918,-40,40,152900,153400,28892,-99092,-87092,OK
332.263103,TraderOne,Tick,1878,1918,-40,40,152900,153400,28892,-99092,-87092,OK
332.527447,TraderOne,Tick,1878,1928,-50,50,154000,153400,28738,-94938,-109938,OK
332.797507,TraderOne,Tick,1878,1928,-50,50,154000,153400,28738,-94938,-109938,OK
332.986634,TraderOne,Tick,1878,1928,-50,50,154000,153400,28738,-94938,-109938,OK
333.261091,TraderOne,Tick,1878,1928,-50,50,154000,153400,28738,-94938,-109938,OK
333.483613,TraderOne,Tick,1878,1928,-50,50,154000,153400,28738,-94938,-109938,OK
333.797279,TraderOne,Tick,1878,1928,-50,50,154000,153400,28738,-94938,-109938,OK
333.975175,TraderOne,Tick,1878,1928,-50,50,154000,153300,28738,-94938,-109938,OK
334.276973,TraderOne,Tick,1878,1928,-50,50,154000,153200,28738,-94938,-109938,OK
334.458461,TraderOne,Tick,1878,1928,-50,50,154000,153200,28738,-94938,-109938,OK
334.790541,TraderOne,Tick,1878,1928,-50,50,154000,153200,28738,-94938,-109938,OK
334.988389,TraderOne,Tick,1878,1928,-50,50,154000,153200,28738,-94938,-109938,OK
335.289048,TraderOne,Tick,1878,1928,-50,50,154000,153200,28738,-94938,-109938,OK
335.491887,TraderOne,Tick,1878,1938,-60,60,154000,153200,28584,-89784,-107784,OK
335.785597,TraderOne,Tick,1888,1938,-50,50,152800,153200,28430,-96630,-81630,OK
335.988363,TraderOne,Tick,1888,1938,-50,50,152800,153200,28430,-96630,-81630,OK
336.290166,TraderOne,Tick,1888,1938,-50,50,152800,153200,28430,-96630,-81630,OK
336.504688,TraderOne,Tick,1888,1938,-50,50,153800,153300,28430,-96630,-111630,OK
336.756254,TraderOne,Tick,1888,1938,-50,50,153800,153300,28430,-96630,-111630,OK
337.022043,TraderOne,Tick,1888,1938,-50,50,153800,153300,28430,-96630,-111630,OK
337.218821,TraderOne,Tick,1888,1938,-50,50,153800,153300,28430,-96630,-111630,OK
337.451663,TraderOne,Tick,1888,1938,-50,50,153800,153300,28430,-96630,-111630,OK
337.760487,TraderOne,Tick,1888,1938,-50,50,153800,153300,28430,-96630,-111630,OK
338.005366,TraderOne,Tick,1888,1938,-50,50,153800,153300,28430,-96630,-111630,OK
338.29973,TraderOne,Tick,1888,1938,-50,50,153800,153300,28430,-96630,-111630,OK
338.456829,TraderOne,Tick,1888,1938,-50,50,153800,153300,28430,-96630,-111630,OK
338.798934,TraderOne,Tick,1888,1938,-50,50,153800,153300,28430,-96630,-111630,OK
338.993296,TraderOne,Tick,1888,1938,-50,50,153800,153300,28430,-96630,-111630,OK
339.201902,TraderOne,Tick,1888,1948,-60,60,154000,153300,28276,-91476,-109476,OK
339.524372,TraderOne,Tick,1898,1948,-50,50,154000,153500,28584,-97784,-112784,OK
339.712816,TraderOne,Tick,1908,1948,-40,40,153800,153500,28892,-102092,-114092,OK
339.991181,TraderOne,Tick,1917,1948,-31,31,153800,153500,29169,-105969,-115269,OK
340.27973,TraderOne,Tick,1917,1948,-31,31,153800,153500,29169,-105969,-115269,OK
340.469523,TraderOne,Tick,1917,1948,-31,31,153800,153500,29169,-105969,-115269,OK
340.743103,TraderOne,Tick,1917,1948,-31,31,153800,153300,29169,-105969,-115269,OK
341.027633,TraderOne,Tick,1917,1948,-31,31,153800,153300,29169,-105969,-115269,OK
341.251768,TraderOne,Tick,1917,1948,-31,31,153800,153300,29169,-105969,-115269,OK
341.502279,TraderOne,Tick,1917,1948,-31,31,153800,153300,29169,-105969,-115269,OK
341.78614,TraderOne,Tick,1917,1958,-41,41,154100,153300,29015,-101815,-114115,OK
341.961795,TraderOne,Tick,1917,1958,-41,41,154100,153300,29015,-101815,-114115,OK
342.282746,TraderOne,Tick,1917,1958,-41,41,154100,153300,29015,-101815,-114115,OK
342.54878,TraderOne,Tick,1927,1958,-31,31,154000,153300,28861,-107661,-116961,OK
342.701609,TraderOne,Tick,1927,1958,-31,31,154000,153300,28861,-107661,-116961,OK
343.040619,TraderOne,Tick,1927,1958,-31,31,154000,153300,28861,-107661,-116961,OK
343.217235,TraderOne,Tick,1927,1958,-31,31,154000,153300,28861,-107661,-116961,OK
343.542277,TraderOne,Tick,1927,1968,-41,41,153800,153300,29169,-102969,-115269,OK
343.78942,TraderOne,Tick,1927,1978,-51,51,153700,153300,29476,-97876,-113176,OK
343.975501,TraderOne,Tick,1937,1978,-41,41,152800,153300,29322,-102722,-90422,OK
344.238323,TraderOne,Tick,1947,1978,-31,31,153700,153000,29629,-108029,-117329,OK
344.490078,TraderOne,Tick,1947,1978,-31,31,153700,153000,29629,-108029,-117329,OK
344.769871,TraderOne,Tick,1957,1978,-21,21,152500,152900,29476,-111876,-105576,OK
345.001844,TraderOne,Tick,1957,1978,-21,21,152500,152900,29476,-111876,-105576,OK
345.245296,TraderOne,Tick,1957,1978,-21,21,152500,152900,29476,-111876,-105576,OK
345.45438,TraderOne,Tick,1957,1978,-21,21,152500,152900,29476,-111876,-105576,OK
345.727802,TraderOne,Tick,1957,1978,-21,21,152500,152700,29476,-111876,-107676,OK
346.002761,TraderOne,Tick,1957,1981,-24,24,153000,152700,29430,-110930,-118130,OK
346.221682,TraderOne,Tick,1957,1981,-24,24,153000,152700,29430,-110930,-118130,OK
346.474504,TraderOne,Tick,1957,1981,-24,24,153000,152600,29430,-110930,-118130,OK
346.781162,TraderOne,Tick,1957,1981,-24,24,153000,152800,29430,-110930,-115730,OK
346.960025,TraderOne,Tick,1957,1981,-24,24,153000,152700,29430,-110930,-118130,OK
347.24987,TraderOne,Tick,1957,1981,-24,24,153000,152700,29430,-110930,-118130,OK
347.549638,TraderOne,Tick,1957,1981,-24,24,153000,152700,29430,-110930,-118130,OK
347.719256,TraderOne,Tick,1967,1981,-14,14,152500,152700,29277,-113777,-110977,OK
348.048794,TraderOne,Tick,1977,1981,-4,4,152800,152700,29583,-116083,-116483,OK
348.217428,TraderOne,Tick,1987,1981,6,-6,152000,152700,29430,-115930,-117730,OK
348.488069,TraderOne,Tick,1987,1981,6,-6,152000,152700,29430,-115930,-117730,OK
348.71463,TraderOne,Tick,1987,1981,6,-6,152000,152600,29430,-115930,-117730,OK
348.985429,TraderOne,Tick,1987,1981,6,-6,152000,152600,29430,-115930,-117730,OK
349.26294,TraderOne,Tick,1987,1981,6,-6,152000,152600,29430,-115930,-117730,OK
349.523378,TraderOne,Tick,1987,1981,6,-6,152000,152600,29430,-115930,-117730,OK
349.7564,TraderOne,Tick,1987,1981,6,-6,152000,152600,29430,-115930,-117730,OK
350.006194,TraderOne,Tick,1987,1981,6,-6,152000,152600,29430,-115930,-117730,OK
350.265461,TraderOne,Tick,1987,1981,6,-6,152000,152600,29430,-115930,-117730,OK
350.538967,TraderOne,Tick,1987,1981,6,-6,152000,152600,29430,-115930,-117730,OK
350.767492,TraderOne,Tick,1987,1981,6,-6,152000,152600,29430,-115930,-117730,OK
351.003072,TraderOne,Tick,1987,1981,6,-6,152000,152600,29430,-115930,-117730,OK
351.254115,TraderOne,Tick,1987,1981,6,-6,152000,152600,29430,-115930,-117730,OK
351.479025,TraderOne,Tick,1987,1981,6,-6,152000,152500,29430,-115930,-117730,OK
351.782157,TraderOne,Tick,1987,1991,-4,4,152700,152500,29278,-115778,-116578,OK
351.989968,TraderOne,Tick,1987,2001,-14,14,152700,152300,29583,-114083,-118283,OK
352.264576,TraderOne,Tick,1987,2011,-24,24,152700,152300,29888,-111388,-118588,OK
352.481198,TraderOne,Tick,1987,2011,-24,24,152700,152300,29888,-111388,-118588,OK
352.735552,TraderOne,Tick,1987,2011,-24,24,152700,152300,29888,-111388,-118588,OK
352.952339,TraderOne,Tick,1987,2021,-34,34,152700,152300,30193,-107693,-117893,OK
353.205243,TraderOne,Tick,1987,2031,-44,44,152700,152300,30498,-103998,-117198,OK
353.465472,TraderOne,Tick,1992,2031,-39,39,152600,152100,30422,-106422,-118122,OK
353.785948,TraderOne,Tick,1992,2031,-39,39,152600,152100,30422,-106422,-118122,OK
354.013974,TraderOne,Tick,1992,2031,-39,39,152600,152100,30422,-106422,-118122,OK
354.22623,TraderOne,Tick,1992,2031,-39,39,152600,152100,30422,-106422,-118122,OK
354.53727,TraderOne,Tick,1992,2031,-39,39,152600,152100,30422,-106422,-118122,OK
354.7234,TraderOne,Tick,1992,2031,-39,39,152600,152100,30422,-106422,-118122,OK
354.983413,TraderOne,Tick,2002,2031,-29,29,152800,152100,30728,-110728,-119428,OK
355.22968,TraderOne,Tick,2002,2031,-29,29,152800,152100,30728,-110728,-119428,OK
355.485067,TraderOne,Tick,2002,2041,-39,39,152900,152100,30575,-107575,-119275,OK
355.723787,TraderOne,Tick,2002,2041,-39,39,152900,152500,30575,-107575,-119275,OK
356.001888,TraderOne,Tick,2002,2041,-39,39,152900,152500,30575,-107575,-119275,OK
356.287298,TraderOne,Tick,2002,2041,-39,39,152900,152500,30575,-107575,-119275,OK
356.495289,TraderOne,Tick,2002,2041,-39,39,152900,152400,30575,-107575,-119275,OK
356.741184,TraderOne,Tick,2002,2041,-39,39,152900,152400,30575,-107575,-119275,OK
356.978788,TraderOne,Tick,2002,2041,-39,39,152900,152400,30575,-107575,-119275,OK
357.251252,TraderOne,Tick,2002,2041,-39,39,152900,152400,30575,-107575,-119275,OK
357.507735,TraderOne,Tick,2002,2051,-49,49,153000,152400,30422,-104422,-119122,OK
357.726694,TraderOne,Tick,2002,2051,-49,49,153000,152400,30422,-104422,-119122,OK
357.958672,TraderOne,Tick,2002,2051,-49,49,153000,152400,30422,-104422,-119122,OK
358.266506,TraderOne,Tick,2012,2051,-39,39,152800,152400,30269,-109269,-120969,OK
358.518844,TraderOne,Tick,2022,2051,-29,29,152600,152100,30574,-112574,-121274,OK
358.720002,TraderOne,Tick,2022,2051,-29,29,152600,152100,30574,-112574,-121274,OK
358.953228,TraderOne,Tick,2022,2061,-39,39,152800,152100,30422,-108422,-120122,OK
359.21896,TraderOne,Tick,2022,2061,-39,39,152800,152100,30422,-108422,-120122,OK
359.541279,TraderOne,Tick,2022,2061,-39,39,152800,152100,30422,-108422,-120122,OK
359.763294,TraderOne,Tick,2022,2061,-39,39,152800,151400,30422,-108422,-120122,OK
360.031052,TraderOne,Tick,2022,2071,-49,49,152100,151400,30727,-101727,-116427,OK
360.215677,TraderOne,Tick,2032,2071,-39,39,152000,151400,31031,-107031,-118731,OK
360.524153,TraderOne,Tick,2032,2071,-39,39,152000,151800,31031,-107031,-114831,OK
360.714197,TraderOne,Tick,2032,2081,-49,49,152400,152000,30879,-101879,-116579,OK
360.994758,TraderOne,Tick,2042,2081,-39,39,152400,152300,31184,-107184,-111084,OK
361.215125,TraderOne,Tick,2042,2081,-39,39,152400,152300,31184,-107184,-111084,OK
361.529348,TraderOne,Tick,2042,2081,-39,39,152400,152300,31184,-107184,-111084,OK
361.765426,TraderOne,Tick,2042,2081,-39,39,152400,152300,31184,-107184,-111084,OK
361.992,TraderOne,Tick,2042,2081,-39,39,152400,152300,31184,-107184,-111084,OK
362.205331,TraderOne,Tick,2042,2100,-58,58,152400,152300,30895,-98295,-104095,OK
362.467173,TraderOne,Tick,2052,2100,-48,48,152500,152300,30743,-101143,-110743,OK
362.734866,TraderOne,Tick,2052,2100,-48,48,152500,152100,30743,-101143,-115543,OK
362.983575,TraderOne,Tick,2062,2100,-38,38,152500,152100,30591,-107991,-119391,OK
363.206989,TraderOne,Tick,2062,2100,-38,38,152500,152100,30591,-107991,-119391,OK
363.48987,TraderOne,Tick,2062,2100,-38,38,152500,152100,30591,-107991,-119391,OK
363.702246,TraderOne,Tick,2062,2100,-38,38,152500,152100,30591,-107991,-119391,OK
363.981077,TraderOne,Tick,2062,2100,-38,38,152500,152100,30591,-107991,-119391,OK
364.250598,TraderOne,Tick,2062,2110,-48,48,152200,152100,30439,-103839,-108639,OK
364.501438,TraderOne,Tick,2062,2110,-48,48,152200,152100,30439,-103839,-108639,OK
364.734761,TraderOne,Tick,2072,2110,-38,38,151900,152100,30287,-109687,-102087,OK
365.020433,TraderOne,Tick,2072,2120,-48,48,151800,152100,30591,-105991,-91591,OK
365.224603,TraderOne,Tick,2072,2120,-48,48,151800,152100,30591,-105991,-91591,OK
365.47782,TraderOne,Tick,2072,2120,-48,48,151800,152100,30591,-105991,-91591,OK
365.740514,TraderOne,Tick,2072,2120,-48,48,151800,152100,30591,-105991,-91591,OK
365.981583,TraderOne,Tick,2072,2130,-58,58,152200,152100,30439,-99839,-105639,OK
366.297908,TraderOne,Tick,2082,2130,-48,48,151900,152100,30287,-105687,-96087,OK
366.521301,TraderOne,Tick,2092,2130,-38,38,152000,151500,30591,-110991,-122391,OK
366.782849,TraderOne,Tick,2092,2130,-38,38,152000,151500,30591,-110991,-122391,OK
366.964107,TraderOne,Tick,2092,2130,-38,38,152000,151500,30591,-110991,-122391,OK
367.26676,TraderOne,Tick,2102,2140,-38,38,152100,151500,30287,-111687,-123087,OK
367.52236,TraderOne,Tick,2102,2140,-38,38,152100,151600,30287,-111687,-123087,OK
367.727147,TraderOne,Tick,2102,2140,-38,38,152100,151800,30287,-111687,-123087,OK
367.984686,TraderOne,Tick,2102,2140,-38,38,152100,151800,30287,-111687,-123087,OK
368.220877,TraderOne,Tick,2102,2140,-38,38,152100,151800,30287,-111687,-123087,OK
368.470311,TraderOne,Tick,2102,2140,-38,38,152100,151800,30287,-111687,-123087,OK
368.738157,TraderOne,Tick,2102,2140,-38,38,152100,151800,30287,-111687,-123087,OK
368.986516,TraderOne,Tick,2102,2140,-38,38,152100,151700,30287,-111687,-123087,OK
369.247429,TraderOne,Tick,2102,2140,-38,38,152100,151700,30287,-111687,-123087,OK
369.45931,TraderOne,Tick,2102,2140,-38,38,152100,151700,30287,-111687,-123087,OK
369.797231,TraderOne,Tick,2102,2140,-38,38,152100,151700,30287,-111687,-123087,OK
370.039151,TraderOne,Tick,2102,2140,-38,38,152100,152000,30287,-111687,-115487,OK
370.222621,TraderOne,Tick,2112,2140,-28,28,152400,152000,30592,-115992,-124392,OK
370.463782,TraderOne,Tick,2112,2140,-28,28,152400,152000,30592,-115992,-124392,OK
370.770202,TraderOne,Tick,2112,2140,-28,28,152400,152000,30592,-115992,-124392,OK
371.018969,TraderOne,Tick,2122,2140,-18,18,152400,152000,30897,-119297,-124697,OK
371.20787,TraderOne,Tick,2122,2140,-18,18,152400,152000,30897,-119297,-124697,OK
371.484657,TraderOne,Tick,2122,2140,-18,18,152400,152000,30897,-119297,-124697,OK
371.713995,TraderOne,Tick,2122,2140,-18,18,152400,152000,30897,-119297,-124697,OK
371.956034,TraderOne,Tick,2122,2140,-18,18,152400,152000,30897,-119297,-124697,OK
372.218274,TraderOne,Tick,2132,2140,-8,8,152100,152000,30745,-121145,-121945,OK
372.539172,TraderOne,Tick,2142,2140,2,-2,151900,152000,31049,-120449,-120649,OK
372.722581,TraderOne,Tick,2152,2140,12,-12,151900,152000,31353,-119753,-120953,OK
372.963378,TraderOne,Tick,2162,2140,22,-22,151900,152000,31657,-119057,-121257,OK
373.280914,TraderOne,Tick,2162,2140,22,-22,151900,152000,31657,-119057,-121257,OK
373.508564,TraderOne,Tick,2162,2158,4,-4,152300,152000,31749,-114949,-113749,OK
373.714061,TraderOne,Tick,2162,2158,4,-4,152300,152000,31749,-114949,-113749,OK
373.998694,TraderOne,Tick,2162,2158,4,-4,152300,152000,31749,-114949,-113749,OK
374.206592,TraderOne,Tick,2162,2158,4,-4,152300,152000,31749,-114949,-113749,OK
374.519123,TraderOne,Tick,2162,2158,4,-4,152300,152000,31749,-114949,-113749,OK
374.796727,TraderOne,Tick,2172,2158,14,-14,152400,152000,32054,-115254,-111054,OK
374.957105,TraderOne,Tick,2172,2158,14,-14,152400,152000,32054,-115254,-111054,OK
375.293437,TraderOne,Tick,2172,2158,14,-14,152400,152000,32054,-115254,-111054,OK
375.511313,TraderOne,Tick,2172,2168,4,-4,152400,152000,31902,-115102,-113902,OK
375.739621,TraderOne,Tick,2172,2168,4,-4,152400,152000,31902,-115102,-113902,OK
376.039762,TraderOne,Tick,2172,2168,4,-4,152400,152000,31902,-115102,-113902,OK
376.203795,TraderOne,Tick,2172,2168,4,-4,152400,152000,31902,-115102,-113902,OK
376.505623,TraderOne,Tick,2172,2168,4,-4,152400,152000,31902,-115102,-113902,OK
376.779257,TraderOne,Tick,2172,2168,4,-4,152400,152000,31902,-115102,-113902,OK
376.970358,TraderOne,Tick,2172,2168,4,-4,152400,152000,31902,-115102,-113902,OK
377.235935,TraderOne,Tick,2182,2168,14,-14,151900,152000,31750,-115950,-117350,OK
377.513651,TraderOne,Tick,2182,2168,14,-14,151900,152300,31750,-115950,-120150,OK
377.715784,TraderOne,Tick,2182,2168,14,-14,151900,152300,31750,-115950,-120150,OK
377.979982,TraderOne,Tick,2182,2168,14,-14,151900,152300,31750,-115950,-120150,OK
378.204273,TraderOne,Tick,2182,2178,4,-4,152600,152300,31598,-116798,-115598,OK
378.473466,TraderOne,Tick,2192,2178,14,-14,151800,152300,31446,-116646,-120846,OK
378.782402,TraderOne,Tick,2192,2188,4,-4,152200,152300,31294,-117494,-117894,OK
378.992215,TraderOne,Tick,2202,2198,4,-4,151800,152300,31447,-113647,-114847,OK
379.235088,TraderOne,Tick,2202,2198,4,-4,151800,152300,31447,-113647,-114847,OK
379.520341,TraderOne,Tick,2202,2198,4,-4,151800,152300,31447,-113647,-114847,OK
379.796357,TraderOne,Tick,2202,2198,4,-4,151800,152300,31447,-113647,-114847,OK
379.968598,TraderOne,Tick,2202,2198,4,-4,151800,152300,31447,-113647,-114847,OK
380.22674,TraderOne,Tick,2210,2198,12,-12,152100,152300,31325,-113525,-115925,OK
380.476449,TraderOne,Tick,2210,2198,12,-12,152100,152300,31325,-113525,-115925,OK
380.710779,TraderOne,Tick,2220,2198,22,-22,151800,152300,31173,-112373,-118973,OK
381.014732,TraderOne,Tick,2220,2198,22,-22,151800,152300,31173,-112373,-118973,OK
381.217842,TraderOne,Tick,2220,2198,22,-22,151800,152300,31173,-112373,-118973,OK
381.461369,TraderOne,Tick,2220,2198,22,-22,151800,152300,31173,-112373,-118973,OK
381.760483,TraderOne,Tick,2220,2208,12,-12,152900,152300,31021,-114221,-110621,OK
381.970921,TraderOne,Tick,2227,2208,19,-19,152300,152500,30914,-113414,-117214,OK
382.23979,TraderOne,Tick,2227,2208,19,-19,152300,152500,30914,-113414,-117214,OK
382.548702,TraderOne,Tick,2227,2208,19,-19,152300,152500,30914,-113414,-117214,OK
382.770346,TraderOne,Tick,2227,2208,19,-19,152300,152500,30914,-113414,-117214,OK
383.047162,TraderOne,Tick,2227,2208,19,-19,152300,152500,30914,-113414,-117214,OK
383.291187,TraderOne,Tick,2227,2208,19,-19,152300,152500,30914,-113414,-117214,OK
383.47985,TraderOne,Tick,2227,2218,9,-9,152900,152500,30762,-115262,-112562,OK
383.706939,TraderOne,Tick,2227,2228,-1,1,152900,152500,31068,-112568,-112868,OK
384.036473,TraderOne,Tick,2227,2235,-8,8,152900,152500,31282,-111382,-113782,OK
384.205981,TraderOne,Tick,2227,2235,-8,8,152900,152500,31282,-111382,-113782,OK
384.531714,TraderOne,Tick,2227,2235,-8,8,152900,152500,31282,-111382,-113782,OK
384.719394,TraderOne,Tick,2227,2235,-8,8,152900,152500,31282,-111382,-113782,OK
385.045104,TraderOne,Tick,2227,2235,-8,8,152900,152500,31282,-111382,-113782,OK
385.222236,TraderOne,Tick,2227,2235,-8,8,152900,152500,31282,-111382,-113782,OK
385.519223,TraderOne,Tick,2237,2235,2,-2,152200,152500,31129,-113229,-113829,OK
385.711045,TraderOne,Tick,2237,2235,2,-2,152200,152500,31129,-113229,-113829,OK
386.004429,TraderOne,Tick,2237,2235,2,-2,152200,152500,31129,-113229,-113829,OK
386.23154,TraderOne,Tick,2237,2235,2,-2,152200,152500,31129,-113229,-113829,OK
386.506898,TraderOne,Tick,2247,2235,12,-12,151800,152500,30977,-114077,-117677,OK
386.736359,TraderOne,Tick,2247,2235,12,-12,151800,152500,30977,-114077,-117677,OK
386.989845,TraderOne,Tick,2247,2235,12,-12,151800,152300,30977,-114077,-117677,OK
387.24955,TraderOne,Tick,2247,2235,12,-12,151800,152300,30977,-114077,-117677,OK
387.527361,TraderOne,Tick,2247,2245,2,-2,152900,152300,30825,-114925,-114325,OK
387.784342,TraderOne,Tick,2247,2245,2,-2,152900,152300,30825,-114925,-114325,OK
388.013067,TraderOne,Tick,2247,2245,2,-2,152900,152300,30825,-114925,-114325,OK
388.278436,TraderOne,Tick,2247,2245,2,-2,152900,152300,30825,-114925,-114325,OK
388.521089,TraderOne,Tick,2257,2245,12,-12,151700,152200,30673,-113773,-117373,OK
388.748471,TraderOne,Tick,2257,2245,12,-12,151700,152200,30673,-113773,-117373,OK
389.002514,TraderOne,Tick,2257,2245,12,-12,151700,152200,30673,-113773,-117373,OK
389.212244,TraderOne,Tick,2257,2255,2,-2,152900,152400,30521,-115621,-115021,OK
389.452428,TraderOne,Tick,2257,2255,2,-2,152900,152400,30521,-115621,-115021,OK
389.764421,TraderOne,Tick,2257,2255,2,-2,152900,152400,30521,-115621,-115021,OK
390.010332,TraderOne,Tick,2257,2255,2,-2,152900,152200,30521,-115621,-115021,OK
390.255328,TraderOne,Tick,2257,2255,2,-2,152900,152200,30521,-115621,-115021,OK
390.536636,TraderOne,Tick,2257,2255,2,-2,152900,152200,30521,-115621,-115021,OK
390.786827,TraderOne,Tick,2257,2255,2,-2,152900,152100,30521,-115621,-115021,OK
390.968026,TraderOne,Tick,2257,2255,2,-2,152900,152100,30521,-115621,-115021,OK
391.253364,TraderOne,Tick,2257,2255,2,-2,152900,152100,30521,-115621,-115021,OK
391.495036,TraderOne,Tick,2257,2255,2,-2,152900,152100,30521,-115621,-115021,OK
391.707966,TraderOne,Tick,2257,2255,2,-2,152900,152100,30521,-115621,-115021,OK
392.039642,TraderOne,Tick,2257,2255,2,-2,152900,152100,30521,-115621,-115021,OK
392.296914,TraderOne,Tick,2257,2255,2,-2,152900,152100,30521,-115621,-115021,OK
392.496348,TraderOne,Tick,2257,2255,2,-2,152900,152100,30521,-115621,-115021,OK
392.704333,TraderOne,Tick,2257,2255,2,-2,152900,152100,30521,-115621,-115021,OK
392.951177,TraderOne,Tick,2257,2265,-8,8,152300,152100,30369,-115469,-117069,OK
393.204405,TraderOne,Tick,2257,2275,-18,18,152700,152200,30674,-111774,-117174,OK
393.466241,TraderOne,Tick,2257,2285,-28,28,152700,152200,30979,-109079,-117479,OK
393.798616,TraderOne,Tick,2257,2285,-28,28,152700,152500,30979,-109079,-114679,OK
393.952906,TraderOne,Tick,2257,2285,-28,28,152700,152500,30979,-109079,-114679,OK
394.222424,TraderOne,Tick,2257,2285,-28,28,152700,152400,30979,-109079,-117479,OK
394.522049,TraderOne,Tick,2257,2295,-38,38,152700,152400,31284,-106384,-117784,OK
394.798479,TraderOne,Tick,2257,2295,-38,38,152700,152400,31284,-106384,-117784,OK
395.019239,TraderOne,Tick,2267,2305,-38,38,152900,152400,30979,-105079,-116479,OK
395.255869,TraderOne,Tick,2267,2305,-38,38,152900,152400,30979,-105079,-116479,OK
395.516375,TraderOne,Tick,2267,2305,-38,38,152900,152400,30979,-105079,-116479,OK
395.722484,TraderOne,Tick,2277,2305,-28,28,152600,152300,30826,-108926,-117326,OK
395.983167,TraderOne,Tick,2287,2305,-18,18,151900,152300,31130,-106230,-100830,OK
396.262045,TraderOne,Tick,2287,2305,-18,18,151900,152300,31130,-106230,-100830,OK
396.548339,TraderOne,Tick,2287,2305,-18,18,151900,152300,31130,-106230,-100830,OK
396.774043,TraderOne,Tick,2287,2305,-18,18,151900,152300,31130,-106230,-100830,OK
397.01284,TraderOne,Tick,2287,2305,-18,18,151900,151700,31130,-106230,-109830,OK
397.230587,TraderOne,Tick,2287,2305,-18,18,151900,151400,31130,-106230,-111630,OK
397.509197,TraderOne,Tick,2287,2315,-28,28,151900,151400,31434,-101534,-109934,OK
397.781561,TraderOne,Tick,2287,2325,-38,38,151800,151400,31738,-97838,-109238,OK
398.004178,TraderOne,Tick,2287,2325,-38,38,151800,151400,31738,-97838,-109238,OK
398.201399,TraderOne,Tick,2287,2335,-48,48,151600,151400,32041,-94141,-103741,OK
398.501347,TraderOne,Tick,2297,2335,-38,38,151600,151100,31889,-99989,-111389,OK
398.775473,TraderOne,Tick,2297,2335,-38,38,151600,151100,31889,-99989,-111389,OK
398.962892,TraderOne,Tick,2297,2335,-38,38,151600,151100,31889,-99989,-111389,OK
399.288994,TraderOne,Tick,2297,2335,-38,38,151600,151200,31889,-99989,-111389,OK
399.485008,TraderOne,Tick,2297,2335,-38,38,151600,151200,31889,-99989,-111389,OK
399.753299,TraderOne,Tick,2297,2335,-38,38,151400,151200,31889,-99989,-107589,OK
399.953287,TraderOne,Tick,2307,2335,-28,28,151400,151200,31737,-103837,-109437,OK
400.202268,TraderOne,Tick,2307,2335,-28,28,151400,151200,31737,-103837,-109437,OK
400.477902,TraderOne,Tick,2307,2335,-28,28,151400,151200,31737,-103837,-109437,OK
400.727098,TraderOne,Tick,2307,2335,-28,28,151400,151000,31737,-103837,-112237,OK
400.978932,TraderOne,Tick,2307,2345,-38,38,151400,151000,32040,-100140,-111540,OK
401.277298,TraderOne,Tick,2307,2345,-38,38,151300,151000,32040,-100140,-111540,OK
401.515843,TraderOne,Tick,2307,2345,-38,38,151300,151000,32040,-100140,-111540,OK
401.732939,TraderOne,Tick,2307,2345,-38,38,151300,151000,32040,-100140,-111540,OK
401.988684,TraderOne,Tick,2307,2345,-38,38,151300,151000,32040,-100140,-111540,OK
402.213124,TraderOne,Tick,2307,2345,-38,38,151300,150900,32040,-100140,-111540,OK
402.483789,TraderOne,Tick,2307,2345,-38,38,151400,150900,32040,-100140,-111540,OK
402.734261,TraderOne,Tick,2307,2355,-48,48,151300,150900,32343,-96443,-110843,OK
403.027752,TraderOne,Tick,2307,2355,-48,48,151300,150900,32343,-96443,-110843,OK
403.280261,TraderOne,Tick,2307,2355,-48,48,151400,150900,32343,-96443,-110843,OK
403.475328,TraderOne,Tick,2307,2355,-48,48,151400,150900,32343,-96443,-110843,OK
403.779546,TraderOne,Tick,2307,2355,-48,48,151400,150900,32343,-96443,-110843,OK
404.015349,TraderOne,Tick,2307,2355,-48,48,151400,150900,32343,-96443,-110843,OK
404.254126,TraderOne,Tick,2307,2355,-48,48,151400,150900,32343,-96443,-110843,OK
404.472152,TraderOne,Tick,2307,2355,-48,48,151400,150900,32343,-96443,-110843,OK
404.800271,TraderOne,Tick,2307,2355,-48,48,151400,150900,32343,-96443,-110843,OK
405.049545,TraderOne,Tick,2307,2355,-48,48,151400,150900,32343,-96443,-110843,OK
405.258548,TraderOne,Tick,2307,2355,-48,48,151400,150900,32343,-96443,-110843,OK
405.505029,TraderOne,Tick,2307,2355,-48,48,151300,151000,32343,-96443,-110843,OK
405.770114,TraderOne,Tick,2307,2355,-48,48,151300,151000,32343,-96443,-110843,OK
405.959303,TraderOne,Tick,2307,2355,-48,48,151300,151000,32343,-96443,-110843,OK
406.216814,TraderOne,Tick,2307,2355,-48,48,151300,151000,32343,-96443,-110843,OK
406.544914,TraderOne,Tick,2307,2355,-48,48,151300,151000,32343,-96443,-110843,OK
406.723922,TraderOne,Tick,2307,2365,-58,58,151400,151000,32646,-92746,-110146,OK
406.982382,TraderOne,Tick,2307,2365,-58,58,151400,151000,32646,-92746,-110146,OK
407.242758,TraderOne,Tick,2307,2365,-58,58,151400,151000,32646,-92746,-110146,OK
407.472395,TraderOne,Tick,2317,2365,-48,48,151200,151000,32495,-100595,-110195,OK
407.792692,TraderOne,Tick,2317,2375,-58,58,151200,150500,32797,-95897,-113297,OK
407.987223,TraderOne,Tick,2317,2375,-58,58,151100,150500,32797,-95897,-113297,OK
408.210426,TraderOne,Tick,2317,2385,-68,68,151100,150500,33099,-89199,-109599,OK
408.467078,TraderOne,Tick,2317,2385,-68,68,151000,150500,33099,-89199,-109599,OK
408.795185,TraderOne,Tick,2327,2385,-58,58,150900,150500,32948,-96048,-113448,OK
408.969272,TraderOne,Tick,2327,2395,-68,68,150700,150500,33250,-90350,-103950,OK
409.226894,TraderOne,Tick,2337,2395,-58,58,150700,150500,33551,-96651,-108251,OK
409.465352,TraderOne,Tick,2337,2395,-58,58,150700,150500,33551,-96651,-108251,OK
409.799869,TraderOne,Tick,2347,2395,-48,48,150600,150000,33400,-103500,-117900,OK
410.041494,TraderOne,Tick,2347,2395,-48,48,150600,150000,33400,-103500,-117900,OK
410.248228,TraderOne,Tick,2347,2395,-48,48,150600,150000,33400,-103500,-117900,OK
410.488126,TraderOne,Tick,2347,2395,-48,48,150600,150000,33400,-103500,-117900,OK
410.72436,TraderOne,Tick,2347,2405,-58,58,150500,150000,33701,-98801,-116201,OK
411.028678,TraderOne,Tick,2347,2405,-58,58,150500,149900,33701,-98801,-116201,OK
411.21576,TraderOne,Tick,2347,2405,-58,58,150600,149900,33701,-98801,-116201,OK
411.533776,TraderOne,Tick,2347,2405,-58,58,150600,150000,33701,-98801,-116201,OK
411.752084,TraderOne,Tick,2357,2405,-48,48,150200,150100,33551,-104651,-109451,OK
411.957406,TraderOne,Tick,2357,2405,-48,48,150200,150100,33551,-104651,-109451,OK
412.259202,TraderOne,Tick,2367,2405,-38,38,150100,150100,33401,-109501,-109501,OK
412.519057,TraderOne,Tick,2377,2415,-38,38,150500,150100,33101,-109201,-120601,OK
412.795368,TraderOne,Tick,2377,2415,-38,38,150500,150000,33101,-109201,-120601,OK
413.024646,TraderOne,Tick,2377,2415,-38,38,150500,150000,33101,-109201,-120601,OK
413.280088,TraderOne,Tick,2377,2415,-38,38,150500,150000,33101,-109201,-120601,OK
413.478325,TraderOne,Tick,2377,2425,-48,48,150500,150000,32951,-105051,-119451,OK
413.757273,TraderOne,Tick,2377,2425,-48,48,150500,150000,32951,-105051,-119451,OK
414.01147,TraderOne,Tick,2377,2425,-48,48,150500,150000,32951,-105051,-119451,OK
414.216044,TraderOne,Tick,2377,2425,-48,48,150500,150000,32951,-105051,-119451,OK
414.506076,TraderOne,Tick,2387,2425,-38,38,150500,150000,32801,-111901,-123301,OK
414.772265,TraderOne,Tick,2387,2425,-38,38,150500,150000,32801,-111901,-123301,OK
415.023625,TraderOne,Tick,2397,2425,-28,28,150000,150000,32651,-115751,-115751,OK
415.247238,TraderOne,Tick,2407,2425,-18,18,150200,150000,32951,-119051,-122651,OK
415.538813,TraderOne,Tick,2407,2425,-18,18,150200,150000,32951,-119051,-122651,OK
415.732322,TraderOne,Tick,2407,2425,-18,18,150200,150000,32951,-119051,-122651,OK
415.95577,TraderOne,Tick,2407,2425,-18,18,150200,150000,32951,-119051,-122651,OK
416.262191,TraderOne,Tick,2407,2425,-18,18,150200,150000,32951,-119051,-122651,OK
416.530061,TraderOne,Tick,2407,2425,-18,18,150200,150000,32951,-119051,-122651,OK
416.708119,TraderOne,Tick,2407,2425,-18,18,150200,150000,32951,-119051,-122651,OK
416.975283,TraderOne,Tick,2417,2425,-8,8,150200,150000,33251,-121351,-122951,OK
417.238657,TraderOne,Tick,2417,2435,-18,18,150700,150000,33101,-119201,-124601,OK
417.465881,TraderOne,Tick,2417,2435,-18,18,150700,150000,33101,-119201,-124601,OK
417.706181,TraderOne,Tick,2417,2435,-18,18,150700,150000,33101,-119201,-124601,OK
417.984905,TraderOne,Tick,2417,2435,-18,18,150700,150000,33101,-119201,-124601,OK
418.20259,TraderOne,Tick,2417,2435,-18,18,150700,150000,33101,-119201,-124601,OK
418.492986,TraderOne,Tick,2417,2435,-18,18,150700,150200,33101,-119201,-124601,OK
418.721699,TraderOne,Tick,2417,2435,-18,18,150700,150300,33101,-119201,-124601,OK
418.994498,TraderOne,Tick,2417,2435,-18,18,150700,150300,33101,-119201,-124601,OK
419.292441,TraderOne,Tick,2417,2435,-18,18,150700,150300,33101,-119201,-124601,OK
419.453723,TraderOne,Tick,2417,2435,-18,18,150700,150300,33101,-119201,-124601,OK
419.769151,TraderOne,Tick,2417,2435,-18,18,150700,150300,33101,-119201,-124601,OK
419.969571,TraderOne,Tick,2417,2435,-18,18,150700,150300,33101,-119201,-124601,OK
420.219803,TraderOne,Tick,2417,2435,-18,18,150700,150300,33101,-119201,-124601,OK
420.538081,TraderOne,Tick,2417,2435,-18,18,150700,150300,33101,-119201,-124601,OK
420.773948,TraderOne,Tick,2417,2435,-18,18,150700,150300,33101,-119201,-124601,OK
420.962773,TraderOne,Tick,2417,2435,-18,18,150700,150300,33101,-119201,-124601,OK
421.282007,TraderOne,Tick,2417,2435,-18,18,150700,150300,33101,-119201,-124601,OK
421.455506,TraderOne,Tick,2417,2435,-18,18,150700,150000,33101,-119201,-124601,OK
421.791574,TraderOne,Tick,2417,2435,-18,18,150700,149900,33101,-119201,-124601,OK
421.992577,TraderOne,Tick,2417,2435,-18,18,150000,149900,33101,-119201,-121001,OK
422.245053,TraderOne,Tick,2417,2435,-18,18,150000,149900,33101,-119201,-121001,OK
422.51256,TraderOne,Tick,2417,2435,-18,18,150000,149900,33101,-119201,-121001,OK
422.728928,TraderOne,Tick,2417,2435,-18,18,150000,149900,33101,-119201,-121001,OK
422.965454,TraderOne,Tick,2417,2435,-18,18,150000,149900,33101,-119201,-121001,OK
423.241735,TraderOne,Tick,2417,2435,-18,18,150000,149900,33101,-119201,-121001,OK
423.538683,TraderOne,Tick,2417,2435,-18,18,150000,149900,33101,-119201,-121001,OK
423.715793,TraderOne,Tick,2417,2435,-18,18,150000,149900,33101,-119201,-121001,OK
424.017722,TraderOne,Tick,2417,2445,-28,28,150500,149900,32951,-117051,-125451,OK
424.223786,TraderOne,Tick,2417,2445,-28,28,150500,149900,32951,-117051,-125451,OK
424.508423,TraderOne,Tick,2417,2445,-28,28,149900,149900,32951,-117051,-117051,OK
424.734899,TraderOne,Tick,2417,2445,-28,28,149900,149900,32951,-117051,-117051,OK
424.969642,TraderOne,Tick,2417,2445,-28,28,149900,149500,32951,-117051,-122651,OK
425.259837,TraderOne,Tick,2417,2455,-38,38,149900,149500,33251,-113351,-120951,OK
425.486504,TraderOne,Tick,2417,2455,-38,38,149900,149500,33251,-113351,-120951,OK
425.730471,TraderOne,Tick,2417,2455,-38,38,149900,149700,33251,-113351,-120951,OK
425.980868,TraderOne,Tick,2427,2455,-28,28,150100,149700,33551,-117651,-123251,OK
426.217721,TraderOne,Tick,2427,2455,-28,28,150100,149800,33551,-117651,-126051,OK
426.50045,TraderOne,Tick,2427,2455,-28,28,150100,149800,33551,-117651,-126051,OK
426.769255,TraderOne,Tick,2433,2455,-22,22,150000,149800,33461,-118761,-123161,OK
426.987592,TraderOne,Tick,2437,2457,-20,20,150300,149800,33551,-119251,-125251,OK
427.27655,TraderOne,Tick,2437,2457,-20,20,150300,149800,33551,-119251,-125251,OK
427.494506,TraderOne,Tick,2437,2457,-20,20,150300,149800,33551,-119251,-125251,OK
427.737597,TraderOne,Tick,2437,2457,-20,20,150300,149800,33551,-119251,-125251,OK
428.050599,TraderOne,Tick,2437,2457,-20,20,150300,149800,33551,-119251,-125251,OK
428.214505,TraderOne,Tick,2437,2467,-30,30,150400,149800,33401,-117101,-126101,OK
428.478314,TraderOne,Tick,2437,2467,-30,30,150400,149800,33401,-117101,-126101,OK
428.771893,TraderOne,Tick,2447,2467,-20,20,149800,149800,33251,-120951,-120951,OK
428.992446,TraderOne,Tick,2447,2467,-20,20,149800,149800,33251,-120951,-120951,OK
429.206494,TraderOne,Tick,2447,2467,-20,20,149800,149800,33251,-120951,-120951,OK
429.538239,TraderOne,Tick,2447,2467,-20,20,149800,149800,33251,-120951,-120951,OK
429.76446,TraderOne,Tick,2447,2467,-20,20,149800,149800,33251,-120951,-120951,OK
429.984477,TraderOne,Tick,2447,2467,-20,20,149800,149800,33251,-120951,-120951,OK
430.247297,TraderOne,Tick,2447,2477,-30,30,150200,149600,33101,-117801,-123801,OK
430.531568,TraderOne,Tick,2447,2477,-30,30,149800,149600,33101,-117801,-123801,OK
430.777378,TraderOne,Tick,2447,2477,-30,30,149800,149600,33101,-117801,-123801,OK
431.025572,TraderOne,Tick,2447,2477,-30,30,149800,149600,33101,-117801,-123801,OK
431.275603,TraderOne,Tick,2447,2477,-30,30,149800,149600,33101,-117801,-123801,OK
431.506591,TraderOne,Tick,2447,2477,-30,30,149800,149600,33101,-117801,-123801,OK
431.702234,TraderOne,Tick,2447,2477,-30,30,149800,149700,33101,-117801,-120801,OK
431.996253,TraderOne,Tick,2447,2477,-30,30,149800,149700,33101,-117801,-120801,OK
432.266056,TraderOne,Tick,2450,2477,-27,27,149900,149700,33056,-118656,-124056,OK
432.548224,TraderOne,Tick,2450,2477,-27,27,149900,149700,33056,-118656,-124056,OK
432.793951,TraderOne,Tick,2450,2487,-37,37,149800,149700,33356,-114956,-118656,OK
432.96357,TraderOne,Tick,2450,2497,-47,47,149800,149500,33656,-113256,-122656,OK
433.264627,TraderOne,Tick,2450,2497,-47,47,149800,149500,33656,-113256,-122656,OK
433.493407,TraderOne,Tick,2450,2497,-47,47,149800,149500,33656,-113256,-122656,OK
433.702926,TraderOne,Tick,2450,2497,-47,47,149800,149500,33656,-113256,-122656,OK
434.029993,TraderOne,Tick,2450,2497,-47,47,150000,149300,33656,-113256,-122656,OK
434.235622,TraderOne,Tick,2460,2497,-37,37,149600,149300,33506,-121106,-128506,OK
434.535073,TraderOne,Tick,2460,2507,-47,47,149600,149000,33805,-117405,-126805,OK
434.705289,TraderOne,Tick,2460,2507,-47,47,149600,149000,33805,-117405,-126805,OK
435.016242,TraderOne,Tick,2460,2507,-47,47,149600,149000,33805,-117405,-126805,OK
435.300658,TraderOne,Tick,2460,2507,-47,47,149600,149300,33805,-117405,-126805,OK
435.533585,TraderOne,Tick,2460,2507,-47,47,149600,149300,33805,-117405,-126805,OK
435.767175,TraderOne,Tick,2460,2507,-47,47,149600,149300,33805,-117405,-126805,OK
435.959755,TraderOne,Tick,2460,2507,-47,47,149600,149300,33805,-117405,-126805,OK
436.298817,TraderOne,Tick,2460,2507,-47,47,149600,149300,33805,-117405,-126805,OK
436.45112,TraderOne,Tick,2460,2507,-47,47,149600,149300,33805,-117405,-126805,OK
436.712329,TraderOne,Tick,2460,2507,-47,47,149600,149300,33805,-117405,-126805,OK
436.973133,TraderOne,Tick,2460,2507,-47,47,149600,149300,33805,-117405,-126805,OK
437.210693,TraderOne,Tick,2460,2507,-47,47,149600,149300,33805,-117405,-126805,OK
437.54488,TraderOne,Tick,2460,2507,-47,47,149600,149300,33805,-117405,-126805,OK
437.72257,TraderOne,Tick,2460,2507,-47,47,149600,149300,33805,-117405,-126805,OK
437.964652,TraderOne,Tick,2460,2507,-47,47,149600,149300,33805,-117405,-126805,OK
438.210336,TraderOne,Tick,2460,2507,-47,47,149600,149300,33805,-117405,-126805,OK
438.486085,TraderOne,Tick,2470,2507,-37,37,149400,149300,33655,-122255,-125955,OK
438.776441,TraderOne,Tick,2470,2507,-37,37,149400,149300,33655,-122255,-125955,OK
438.955557,TraderOne,Tick,2470,2507,-37,37,149400,149300,33655,-122255,-125955,OK
439.287738,TraderOne,Tick,2480,2507,-27,27,149700,149500,33505,-125105,-130505,OK
439.489447,TraderOne,Tick,2490,2507,-17,17,149700,149500,33804,-128404,-131804,OK
439.775786,TraderOne,Tick,2490,2507,-17,17,149700,149500,33804,-128404,-131804,OK
439.964588,TraderOne,Tick,2490,2507,-17,17,149700,149300,33804,-128404,-131804,OK
440.241481,TraderOne,Tick,2490,2507,-17,17,149700,149300,33804,-128404,-131804,OK
440.538338,TraderOne,Tick,2490,2507,-17,17,149700,149300,33804,-128404,-131804,OK
440.719413,TraderOne,Tick,2490,2507,-17,17,149700,149300,33804,-128404,-131804,OK
440.988587,TraderOne,Tick,2500,2507,-7,7,149700,149700,34103,-130703,-130703,OK
441.261643,TraderOne,Tick,2500,2507,-7,7,149700,149700,34103,-130703,-130703,OK
441.527034,TraderOne,Tick,2500,2507,-7,7,149700,149700,34103,-130703,-130703,OK
441.767025,TraderOne,Tick,2500,2507,-7,7,149700,149700,34103,-130703,-130703,OK
441.971829,TraderOne,Tick,2500,2507,-7,7,149700,149700,34103,-130703,-130703,OK
442.257105,TraderOne,Tick,2500,2507,-7,7,149700,149700,34103,-130703,-130703,OK
442.482116,TraderOne,Tick,2500,2507,-7,7,149700,149700,34103,-130703,-130703,OK
442.709786,TraderOne,Tick,2500,2507,-7,7,149700,149700,34103,-130703,-130703,OK
443.046374,TraderOne,Tick,2500,2507,-7,7,149700,149700,34103,-130703,-130703,OK
443.233912,TraderOne,Tick,2500,2507,-7,7,149700,149700,34103,-130703,-130703,OK
443.53926,TraderOne,Tick,2500,2507,-7,7,149700,149700,34103,-130703,-130703,OK
443.709646,TraderOne,Tick,2500,2517,-17,17,149400,149700,34402,-130002,-126602,OK
444.040492,TraderOne,Tick,2500,2527,-27,27,149300,149700,34701,-128301,-122901,OK
444.231449,TraderOne,Tick,2500,2527,-27,27,149300,149700,34701,-128301,-122901,OK
444.493364,TraderOne,Tick,2500,2527,-27,27,149300,149200,34701,-128301,-131001,OK
444.753759,TraderOne,Tick,2500,2527,-27,27,149300,149200,34701,-128301,-131001,OK
445.023515,TraderOne,Tick,2500,2527,-27,27,149300,149200,34701,-128301,-131001,OK
445.25881,TraderOne,Tick,2500,2527,-27,27,149300,149300,34701,-128301,-128301,OK
445.482243,TraderOne,Tick,2500,2527,-27,27,149300,149300,34701,-128301,-128301,OK
445.715266,TraderOne,Tick,2500,2527,-27,27,149300,149300,34701,-128301,-128301,OK
445.99651,TraderOne,Tick,2500,2527,-27,27,149300,149300,34701,-128301,-128301,OK
446.277182,TraderOne,Tick,2500,2527,-27,27,149300,149300,34701,-128301,-128301,OK
446.450984,TraderOne,Tick,2500,2527,-27,27,149300,149300,34701,-128301,-128301,OK
446.776762,TraderOne,Tick,2500,2537,-37,37,149300,148900,35000,-124600,-132000,OK
447.023632,TraderOne,Tick,2500,2537,-37,37,149300,148900,35000,-124600,-132000,OK
447.293429,TraderOne,Tick,2500,2537,-37,37,149300,148900,35000,-124600,-132000,OK
447.451882,TraderOne,Tick,2500,2537,-37,37,149300,148900,35000,-124600,-132000,OK
447.728424,TraderOne,Tick,2500,2537,-37,37,149300,148900,35000,-124600,-132000,OK
448.028507,TraderOne,Tick,2500,2537,-37,37,149300,148900,35000,-124600,-132000,OK
448.284141,TraderOne,Tick,2500,2537,-37,37,149300,148900,35000,-124600,-132000,OK
448.467042,TraderOne,Tick,2500,2547,-47,47,149300,148900,35299,-120899,-130299,OK
448.789421,TraderOne,Tick,2500,2547,-47,47,149300,148900,35299,-120899,-130299,OK
449.005442,TraderOne,Tick,2500,2547,-47,47,149300,149000,35299,-120899,-130299,OK
449.277956,TraderOne,Tick,2500,2547,-47,47,149300,149000,35299,-120899,-130299,OK
449.475217,TraderOne,Tick,2500,2547,-47,47,149300,149000,35299,-120899,-130299,OK
449.769968,TraderOne,Tick,2510,2547,-37,37,149600,149000,35598,-127198,-134598,OK
450.012265,TraderOne,Tick,2510,2547,-37,37,149600,149000,35598,-127198,-134598,OK
450.236539,TraderOne,Tick,2510,2547,-37,37,149600,149000,35598,-127198,-134598,OK
450.533036,TraderOne,Tick,2514,2547,-33,33,149500,149000,35538,-128738,-135338,OK
450.701044,TraderOne,Tick,2514,2557,-43,43,149600,149000,35388,-124588,-133188,OK
450.954036,TraderOne,Tick,2514,2557,-43,43,149600,149000,35388,-124588,-133188,OK
451.248653,TraderOne,Tick,2514,2557,-43,43,149600,149000,35388,-124588,-133188,OK
451.454671,TraderOne,Tick,2514,2557,-43,43,149700,149000,35388,-124588,-133188,OK
451.735083,TraderOne,Tick,2524,2557,-33,33,149100,149200,35238,-129438,-126138,OK
452.050388,TraderOne,Tick,2534,2557,-23,23,149700,149200,35537,-133737,-138337,OK
452.265358,TraderOne,Tick,2534,2557,-23,23,149700,149200,35537,-133737,-138337,OK
452.462337,TraderOne,Tick,2534,2557,-23,23,149700,149200,35537,-133737,-138337,OK
452.711676,TraderOne,Tick,2534,2557,-23,23,149700,149300,35537,-133737,-138337,OK
452.965347,TraderOne,Tick,2534,2567,-33,33,149800,149300,35387,-130587,-137187,OK
453.269249,TraderOne,Tick,2534,2567,-33,33,149800,149300,35387,-130587,-137187,OK
453.489153,TraderOne,Tick,2534,2567,-33,33,149800,149300,35387,-130587,-137187,OK
453.792869,TraderOne,Tick,2534,2567,-33,33,149800,149300,35387,-130587,-137187,OK
453.969162,TraderOne,Tick,2534,2567,-33,33,149800,149300,35387,-130587,-137187,OK
454.270361,TraderOne,Tick,2534,2567,-33,33,149800,149300,35387,-130587,-137187,OK
454.46222,TraderOne,Tick,2544,2567,-23,23,149100,149200,35237,-134437,-132137,OK
454.791495,TraderOne,Tick,2544,2567,-23,23,149100,149000,35237,-134437,-136737,OK
455.049561,TraderOne,Tick,2544,2567,-23,23,149100,149000,35237,-134437,-136737,OK
455.213184,TraderOne,Tick,2544,2567,-23,23,149100,149000,35237,-134437,-136737,OK
455.522915,TraderOne,Tick,2544,2567,-23,23,149100,149100,35237,-134437,-134437,OK
455.732904,TraderOne,Tick,2544,2567,-23,23,149100,149100,35237,-134437,-134437,OK
455.969597,TraderOne,Tick,2544,2567,-23,23,149100,149100,35237,-134437,-134437,OK
456.279341,TraderOne,Tick,2544,2567,-23,23,149100,149100,35237,-134437,-134437,OK
456.467589,TraderOne,Tick,2544,2567,-23,23,149100,149100,35237,-134437,-134437,OK
456.772066,TraderOne,Tick,2544,2567,-23,23,149100,149200,35237,-134437,-132137,OK
456.963766,TraderOne,Tick,2544,2567,-23,23,149100,149200,35237,-134437,-132137,OK
457.270696,TraderOne,Tick,2544,2567,-23,23,149100,149300,35237,-134437,-129837,OK
457.468688,TraderOne,Tick,2544,2567,-23,23,149100,149300,35237,-134437,-129837,OK
457.738727,TraderOne,Tick,2544,2567,-23,23,149100,149300,35237,-134437,-129837,OK
457.991102,TraderOne,Tick,2544,2567,-23,23,149100,149300,35237,-134437,-129837,OK
458.23734,TraderOne,Tick,2544,2567,-23,23,149100,149300,35237,-134437,-129837,OK
458.463123,TraderOne,Tick,2544,2567,-23,23,149100,149300,35237,-134437,-129837,OK
458.776449,TraderOne,Tick,2544,2567,-23,23,149100,149500,35237,-134437,-129837,OK
458.995976,TraderOne,Tick,2544,2567,-23,23,149100,149500,35237,-134437,-129837,OK
459.28291,TraderOne,Tick,2544,2567,-23,23,149100,149500,35237,-134437,-129837,OK
459.517837,TraderOne,Tick,2544,2567,-23,23,149100,149500,35237,-134437,-129837,OK
459.73011,TraderOne,Tick,2544,2567,-23,23,149100,149500,35237,-134437,-129837,OK
459.989564,TraderOne,Tick,2544,2567,-23,23,149100,149500,35237,-134437,-129837,OK
460.228599,TraderOne,Tick,2544,2567,-23,23,149100,149500,35237,-134437,-129837,OK
460.530795,TraderOne,Tick,2544,2567,-23,23,149100,149500,35237,-134437,-129837,OK
460.740374,TraderOne,Tick,2544,2567,-23,23,149100,149500,35237,-134437,-129837,OK
461.036157,TraderOne,Tick,2544,2567,-23,23,149100,149500,35237,-134437,-129837,OK
461.292829,TraderOne,Tick,2544,2567,-23,23,149100,149500,35237,-134437,-129837,OK
461.50847,TraderOne,Tick,2544,2567,-23,23,149100,149500,35237,-134437,-129837,OK
461.774898,TraderOne,Tick,2544,2567,-23,23,149100,149500,35237,-134437,-129837,OK
462.038824,TraderOne,Tick,2544,2567,-23,23,149100,149500,35237,-134437,-129837,OK
462.277416,TraderOne,Tick,2554,2567,-13,13,149100,149500,35087,-138287,-135687,OK
462.541314,TraderOne,Tick,2554,2567,-13,13,149100,149500,35087,-138287,-135687,OK
462.741086,TraderOne,Tick,2554,2567,-13,13,149100,149500,35087,-138287,-135687,OK
463.035155,TraderOne,Tick,2554,2567,-13,13,149100,149500,35087,-138287,-135687,OK
463.242661,TraderOne,Tick,2564,2567,-3,3,149100,149200,34938,-141138,-140838,OK
463.462842,TraderOne,Tick,2564,2567,-3,3,149100,148900,34938,-141138,-141738,OK
463.720273,TraderOne,Tick,2564,2577,-13,13,149100,149000,35236,-140436,-141736,OK
463.976114,TraderOne,Tick,2574,2577,-3,3,149100,149000,35087,-142287,-142587,OK
464.29546,TraderOne,Tick,2574,2577,-3,3,149100,149000,35087,-142287,-142587,OK
464.527418,TraderOne,Tick,2574,2577,-3,3,149100,149000,35087,-142287,-142587,OK
464.762735,TraderOne,Tick,2574,2577,-3,3,149100,149000,35087,-142287,-142587,OK
465.001774,TraderOne,Tick,2574,2577,-3,3,149100,149000,35087,-142287,-142587,OK
465.254621,TraderOne,Tick,2574,2577,-3,3,149100,149000,35087,-142287,-142587,OK
465.45889,TraderOne,Tick,2574,2577,-3,3,149100,149100,35087,-142287,-142287,OK
465.772617,TraderOne,Tick,2574,2577,-3,3,149100,149100,35087,-142287,-142287,OK
466.036573,TraderOne,Tick,2584,2577,7,-7,149300,149100,35386,-142586,-141186,OK
466.205961,TraderOne,Tick,2584,2577,7,-7,149300,149100,35386,-142586,-141186,OK
466.517945,TraderOne,Tick,2594,2577,17,-17,149000,149100,35237,-142437,-144137,OK
466.749918,TraderOne,Tick,2594,2577,17,-17,149000,149100,35237,-142437,-144137,OK
466.965642,TraderOne,Tick,2594,2577,17,-17,149000,149100,35237,-142437,-144137,OK
467.247804,TraderOne,Tick,2594,2577,17,-17,149000,149100,35237,-142437,-144137,OK
467.506914,TraderOne,Tick,2594,2577,17,-17,149000,149100,35237,-142437,-144137,OK
467.787078,TraderOne,Tick,2594,2577,17,-17,149000,149100,35237,-142437,-144137,OK
467.987271,TraderOne,Tick,2604,2577,27,-27,149000,149100,35088,-142288,-144988,OK
468.213429,TraderOne,Tick,2604,2587,17,-17,149000,149100,35386,-143586,-145286,OK
468.50608,TraderOne,Tick,2604,2597,7,-7,149000,149100,35684,-144884,-145584,OK
468.702073,TraderOne,Tick,2604,2597,7,-7,149000,149100,35684,-144884,-145584,OK
469.006106,TraderOne,Tick,2604,2604,0,0,149200,149100,35580,-144780,-144780,OK
469.271964,TraderOne,Tick,2604,2604,0,0,149200,149100,35580,-144780,-144780,OK
469.484156,TraderOne,Tick,2604,2604,0,0,149200,149100,35580,-144780,-144780,OK
469.735545,TraderOne,Tick,2613,2604,9,-9,149000,149100,35446,-144646,-145546,OK
469.995501,TraderOne,Tick,2613,2604,9,-9,149000,149100,35446,-144646,-145546,OK
470.219083,TraderOne,Tick,2613,2604,9,-9,149000,149100,35446,-144646,-145546,OK
470.465996,TraderOne,Tick,2614,2614,0,0,148900,149100,35282,-144482,-144482,OK
470.751461,TraderOne,Tick,2614,2614,0,0,148900,149000,35282,-144482,-144482,OK
471.02297,TraderOne,Tick,2614,2614,0,0,148900,149000,35282,-144482,-144482,OK
471.284146,TraderOne,Tick,2624,2614,10,-10,148900,149400,35133,-142333,-144333,OK
471.524288,TraderOne,Tick,2624,2614,10,-10,148900,149400,35133,-142333,-144333,OK
471.731323,TraderOne,Tick,2624,2614,10,-10,148900,149400,35133,-142333,-144333,OK
471.995391,TraderOne,Tick,2634,2614,20,-20,148900,149400,34984,-141184,-145184,OK
472.276566,TraderOne,Tick,2634,2624,10,-10,149900,149400,34835,-143035,-141035,OK
472.497191,TraderOne,Tick,2634,2634,0,0,149300,149400,34686,-144886,-144886,OK
472.77887,TraderOne,Tick,2634,2634,0,0,149300,149400,34686,-144886,-144886,OK
473.002279,TraderOne,Tick,2634,2634,0,0,149300,149400,34686,-144886,-144886,OK
473.238852,TraderOne,Tick,2634,2634,0,0,149300,149400,34686,-144886,-144886,OK
473.494312,TraderOne,Tick,2634,2634,0,0,149300,149400,34686,-144886,-144886,OK
473.716367,TraderOne,Tick,2634,2644,-10,10,149900,149400,34536,-145736,-147736,OK
473.956362,TraderOne,Tick,2634,2644,-10,10,149900,149400,34536,-145736,-147736,OK
474.227253,TraderOne,Tick,2634,2644,-10,10,149900,149400,34536,-145736,-147736,OK
474.545113,TraderOne,Tick,2634,2644,-10,10,149900,149400,34536,-145736,-147736,OK
474.757899,TraderOne,Tick,2644,2644,0,0,148900,149400,34386,-146586,-146586,OK
474.97487,TraderOne,Tick,2644,2644,0,0,148900,149400,34386,-146586,-146586,OK
475.273752,TraderOne,Tick,2644,2644,0,0,148900,149400,34386,-146586,-146586,OK
475.488705,TraderOne,Tick,2654,2644,10,-10,149400,149400,34237,-148437,-148437,OK
475.768948,TraderOne,Tick,2654,2644,10,-10,149400,149400,34237,-148437,-148437,OK
476.048264,TraderOne,Tick,2654,2644,10,-10,149400,149400,34237,-148437,-148437,OK
476.248432,TraderOne,Tick,2664,2644,20,-20,149300,149400,34536,-147736,-149736,OK
476.52122,TraderOne,Tick,2664,2644,20,-20,149300,149400,34536,-147736,-149736,OK
476.786769,TraderOne,Tick,2664,2644,20,-20,149300,149400,34536,-147736,-149736,OK
476.985267,TraderOne,Tick,2664,2644,20,-20,149300,149600,34536,-147736,-151736,OK
477.281775,TraderOne,Tick,2669,2644,25,-25,149300,149600,34685,-146385,-151385,OK
477.495901,TraderOne,Tick,2669,2644,25,-25,149300,149700,34685,-146385,-151385,OK
477.732881,TraderOne,Tick,2674,2644,30,-30,149000,149700,34610,-145310,-151310,OK
478.019898,TraderOne,Tick,2674,2644,30,-30,149000,149700,34610,-145310,-151310,OK
478.267756,TraderOne,Tick,2674,2644,30,-30,149000,149700,34610,-145310,-151310,OK
478.476484,TraderOne,Tick,2674,2644,30,-30,149000,149600,34610,-145310,-151310,OK
478.743573,TraderOne,Tick,2674,2644,30,-30,149000,149600,34610,-145310,-151310,OK
479.007902,TraderOne,Tick,2674,2644,30,-30,149000,149600,34610,-145310,-151310,OK
479.282082,TraderOne,Tick,2674,2644,30,-30,149000,149600,34610,-145310,-151310,OK
479.4693,TraderOne,Tick,2674,2644,30,-30,149000,149500,34610,-145310,-151310,OK
479.716559,TraderOne,Tick,2674,2644,30,-30,149000,149500,34610,-145310,-151310,OK
480.008845,TraderOne,Tick,2674,2644,30,-30,149000,149500,34610,-145310,-151310,OK
480.213499,TraderOne,Tick,2674,2644,30,-30,149000,149400,34610,-145310,-151310,OK
480.545964,TraderOne,Tick,2674,2644,30,-30,149000,149400,34610,-145310,-151310,OK
480.715072,TraderOne,Tick,2674,2644,30,-30,149000,149400,34610,-145310,-151310,OK
481.007412,TraderOne,Tick,2674,2644,30,-30,149000,149800,34610,-145310,-154310,OK
481.238932,TraderOne,Tick,2674,2644,30,-30,149000,149800,34610,-145310,-154310,OK
481.481077,TraderOne,Tick,2674,2644,30,-30,149000,150000,34610,-145310,-154310,OK
481.736684,TraderOne,Tick,2674,2654,20,-20,149900,150000,34460,-147160,-149160,OK
481.994152,TraderOne,Tick,2674,2654,20,-20,149900,150000,34460,-147160,-149160,OK
482.285379,TraderOne,Tick,2674,2654,20,-20,149900,150000,34460,-147160,-149160,OK
482.463266,TraderOne,Tick,2674,2654,20,-20,149900,150000,34460,-147160,-149160,OK
482.709924,TraderOne,Tick,2674,2654,20,-20,149900,150000,34460,-147160,-149160,OK
482.994529,TraderOne,Tick,2674,2654,20,-20,149900,150000,34460,-147160,-149160,OK
483.245513,TraderOne,Tick,2674,2654,20,-20,149900,150000,34460,-147160,-149160,OK
483.525161,TraderOne,Tick,2674,2654,20,-20,149900,150000,34460,-147160,-149160,OK
483.738681,TraderOne,Tick,2674,2654,20,-20,149900,150000,34460,-147160,-149160,OK
483.994454,TraderOne,Tick,2674,2654,20,-20,149900,150000,34460,-147160,-149160,OK
484.295179,TraderOne,Tick,2674,2654,20,-20,149900,150000,34460,-147160,-149160,OK
484.455377,TraderOne,Tick,2684,2654,30,-30,149900,150000,34760,-145460,-148460,OK
484.719816,TraderOne,Tick,2684,2654,30,-30,149900,150000,34760,-145460,-148460,OK
485.037082,TraderOne,Tick,2684,2654,30,-30,149900,150000,34760,-145460,-148460,OK
485.249869,TraderOne,Tick,2694,2654,40,-40,149500,150000,34610,-143310,-155310,OK
485.526405,TraderOne,Tick,2694,2654,40,-40,149500,150000,34610,-143310,-155310,OK
485.723419,TraderOne,Tick,2694,2664,30,-30,150000,150500,34460,-149160,-158160,OK
486.021229,TraderOne,Tick,2694,2664,30,-30,150000,150700,34460,-149160,-158160,OK
486.240495,TraderOne,Tick,2704,2664,40,-40,150300,150700,34760,-142460,-154460,OK
486.45976,TraderOne,Tick,2714,2664,50,-50,150400,151000,35061,-137761,-152761,OK
486.73609,TraderOne,Tick,2724,2664,60,-60,150500,150900,35362,-133062,-151062,OK
487.023642,TraderOne,Tick,2724,2674,50,-50,150400,150800,35663,-140363,-155363,OK
487.27619,TraderOne,Tick,2724,2674,50,-50,150400,151000,35663,-140363,-155363,OK
487.530773,TraderOne,Tick,2724,2674,50,-50,150400,150900,35663,-140363,-155363,OK
487.703497,TraderOne,Tick,2724,2674,50,-50,150400,150800,35663,-140363,-155363,OK
487.984962,TraderOne,Tick,2724,2674,50,-50,150400,150800,35663,-140363,-155363,OK
488.276641,TraderOne,Tick,2724,2674,50,-50,150400,150800,35663,-140363,-155363,OK
488.52549,TraderOne,Tick,2724,2674,50,-50,150400,150800,35663,-140363,-155363,OK
488.718964,TraderOne,Tick,2724,2684,40,-40,150500,150800,35513,-146213,-158213,OK
489.037979,TraderOne,Tick,2724,2684,40,-40,150500,150800,35513,-146213,-158213,OK
489.264521,TraderOne,Tick,2734,2684,50,-50,150500,150800,35814,-142514,-157514,OK
489.518115,TraderOne,Tick,2734,2684,50,-50,150400,151000,35814,-142514,-157514,OK
489.716868,TraderOne,Tick,2734,2684,50,-50,150600,151000,35814,-142514,-157514,OK
490.029854,TraderOne,Tick,2734,2694,40,-40,150800,151000,35663,-147363,-155363,OK
490.282933,TraderOne,Tick,2734,2694,40,-40,150800,151000,35663,-147363,-155363,OK
490.543276,TraderOne,Tick,2734,2694,40,-40,150800,151000,35663,-147363,-155363,OK
490.766858,TraderOne,Tick,2734,2694,40,-40,150800,151000,35663,-147363,-155363,OK
491.000786,TraderOne,Tick,2734,2694,40,-40,150800,151000,35663,-147363,-155363,OK
491.283114,TraderOne,Tick,2734,2694,40,-40,150800,150800,35663,-147363,-147363,OK
491.482201,TraderOne,Tick,2734,2694,40,-40,150800,150800,35663,-147363,-147363,OK
491.740633,TraderOne,Tick,2734,2694,40,-40,150800,150800,35663,-147363,-147363,OK
492.034529,TraderOne,Tick,2734,2694,40,-40,150800,150800,35663,-147363,-147363,OK
492.247938,TraderOne,Tick,2734,2694,40,-40,150800,150500,35663,-147363,-135363,OK
492.533423,TraderOne,Tick,2734,2701,33,-33,150300,150500,35873,-149673,-156273,OK
492.792532,TraderOne,Tick,2734,2711,23,-23,150800,150500,35723,-151523,-144623,OK
493.019029,TraderOne,Tick,2734,2711,23,-23,150800,150500,35723,-151523,-144623,OK
493.222057,TraderOne,Tick,2734,2711,23,-23,150800,150500,35723,-151523,-144623,OK
493.492514,TraderOne,Tick,2734,2711,23,-23,150800,150500,35723,-151523,-144623,OK
493.772086,TraderOne,Tick,2734,2711,23,-23,150800,150200,35723,-151523,-144623,OK
494.033089,TraderOne,Tick,2734,2711,23,-23,150800,150200,35723,-151523,-144623,OK
494.285786,TraderOne,Tick,2735,2711,24,-24,149900,150200,35708,-151308,-158508,OK
494.499239,TraderOne,Tick,2735,2711,24,-24,149900,150200,35708,-151308,-158508,OK
494.772967,TraderOne,Tick,2735,2711,24,-24,149900,150200,35708,-151308,-158508,OK
494.995308,TraderOne,Tick,2735,2711,24,-24,149900,150200,35708,-151308,-158508,OK
495.222579,TraderOne,Tick,2735,2711,24,-24,149900,150000,35708,-151308,-153708,OK
495.454551,TraderOne,Tick,2735,2711,24,-24,149900,150000,35708,-151308,-153708,OK
495.796929,TraderOne,Tick,2735,2721,14,-14,149600,149800,36007,-153607,-156407,OK
495.96322,TraderOne,Tick,2735,2721,14,-14,149600,149800,36007,-153607,-156407,OK
496.204432,TraderOne,Tick,2735,2721,14,-14,149600,149800,36007,-153607,-156407,OK
496.548976,TraderOne,Tick,2735,2721,14,-14,149600,149900,36007,-153607,-157807,OK
496.737471,TraderOne,Tick,2735,2721,14,-14,149600,149900,36007,-153607,-157807,OK
496.953246,TraderOne,Tick,2745,2721,24,-24,149500,149900,35857,-153457,-160657,OK
497.271292,TraderOne,Tick,2745,2721,24,-24,149500,149900,35857,-153457,-160657,OK
497.483785,TraderOne,Tick,2745,2721,24,-24,149500,149900,35857,-153457,-160657,OK
497.770248,TraderOne,Tick,2745,2721,24,-24,149500,149900,35857,-153457,-160657,OK
498.010581,TraderOne,Tick,2745,2721,24,-24,149500,149900,35857,-153457,-160657,OK
498.291276,TraderOne,Tick,2745,2721,24,-24,149500,149900,35857,-153457,-160657,OK
498.528699,TraderOne,Tick,2745,2721,24,-24,149500,149900,35857,-153457,-160657,OK
498.70809,TraderOne,Tick,2745,2721,24,-24,149500,149900,35857,-153457,-160657,OK
498.991174,TraderOne,Tick,2745,2721,24,-24,149500,149900,35857,-153457,-160657,OK
499.299027,TraderOne,Tick,2745,2721,24,-24,149500,149900,35857,-153457,-160657,OK
499.526824,TraderOne,Tick,2755,2721,34,-34,149400,149900,35707,-151307,-161507,OK
499.790304,TraderOne,Tick,2755,2721,34,-34,149400,149900,35707,-151307,-161507,OK
499.98521,TraderOne,Tick,2755,2721,34,-34,149400,149900,35707,-151307,-161507,OK
500.204483,TraderOne,Tick,2755,2721,34,-34,149400,149900,35707,-151307,-161507,OK
500.548663,TraderOne,Tick,2755,2721,34,-34,149400,149900,35707,-151307,-161507,OK
500.752249,TraderOne,Tick,2755,2721,34,-34,149400,149900,35707,-151307,-161507,OK
501.034163,TraderOne,Tick,2755,2731,24,-24,150400,149900,35557,-154157,-146957,OK
501.254025,TraderOne,Tick,2755,2731,24,-24,150400,149900,35557,-154157,-146957,OK
501.512629,TraderOne,Tick,2755,2731,24,-24,150400,149900,35557,-154157,-146957,OK
501.799263,TraderOne,Tick,2755,2731,24,-24,150400,149900,35557,-154157,-146957,OK
501.964514,TraderOne,Tick,2755,2731,24,-24,150400,149900,35557,-154157,-146957,OK
502.238373,TraderOne,Tick,2755,2731,24,-24,150400,149900,35557,-154157,-146957,OK
502.539766,TraderOne,Tick,2755,2736,19,-19,149700,149900,35482,-156082,-159882,OK
502.704582,TraderOne,Tick,2765,2736,29,-29,149600,150200,35782,-154382,-163082,OK
503.031361,TraderOne,Tick,2775,2736,39,-39,149600,150200,36082,-152682,-164382,OK
503.230461,TraderOne,Tick,2775,2736,39,-39,149600,150200,36082,-152682,-164382,OK
503.481452,TraderOne,Tick,2775,2746,29,-29,150600,150200,35932,-155532,-146832,OK
503.76665,TraderOne,Tick,2783,2746,37,-37,150000,150200,35812,-153812,-161212,OK
503.953596,TraderOne,Tick,2783,2746,37,-37,150000,150200,35812,-153812,-161212,OK
504.2896,TraderOne,Tick,2783,2746,37,-37,150000,150200,35812,-153812,-161212,OK
504.520845,TraderOne,Tick,2783,2746,37,-37,150000,150200,35812,-153812,-161212,OK
504.783086,TraderOne,Tick,2783,2746,37,-37,150000,150200,35812,-153812,-161212,OK
505.007045,TraderOne,Tick,2793,2756,37,-37,149400,150200,35512,-152512,-163612,OK
505.282644,TraderOne,Tick,2793,2756,37,-37,149400,150200,35512,-152512,-163612,OK
505.51281,TraderOne,Tick,2793,2756,37,-37,149400,150200,35512,-152512,-163612,OK
505.77644,TraderOne,Tick,2793,2756,37,-37,149400,150200,35512,-152512,-163612,OK
506.027089,TraderOne,Tick,2793,2756,37,-37,149400,150200,35512,-152512,-163612,OK
506.253732,TraderOne,Tick,2803,2766,37,-37,150600,150200,35663,-159663,-148563,OK
506.485462,TraderOne,Tick,2813,2766,47,-47,150600,150200,35964,-155964,-141864,OK
506.764042,TraderOne,Tick,2813,2766,47,-47,150600,150200,35964,-155964,-141864,OK
507.025175,TraderOne,Tick,2813,2766,47,-47,150600,150200,35964,-155964,-141864,OK
507.260672,TraderOne,Tick,2813,2776,37,-37,150400,150200,35813,-158813,-151413,OK
507.546738,TraderOne,Tick,2823,2776,47,-47,150400,150200,35663,-155663,-146263,OK
507.753768,TraderOne,Tick,2823,2776,47,-47,150400,150200,35663,-155663,-146263,OK
507.953858,TraderOne,Tick,2823,2776,47,-47,150400,150900,35663,-155663,-169763,OK
508.225335,TraderOne,Tick,2833,2776,57,-57,150400,151000,35964,-150964,-168064,OK
508.466695,TraderOne,Tick,2833,2776,57,-57,150400,151000,35964,-150964,-168064,OK
508.74874,TraderOne,Tick,2833,2776,57,-57,150400,151000,35964,-150964,-168064,OK
508.962816,TraderOne,Tick,2833,2776,57,-57,150400,151000,35964,-150964,-168064,OK
509.288607,TraderOne,Tick,2833,2786,47,-47,150400,151000,36265,-155265,-169365,OK
509.517911,TraderOne,Tick,2833,2786,47,-47,150400,151000,36265,-155265,-169365,OK
509.796358,TraderOne,Tick,2833,2786,47,-47,150400,151000,36265,-155265,-169365,OK
509.9542,TraderOne,Tick,2833,2786,47,-47,150400,151000,36265,-155265,-169365,OK
510.2262,TraderOne,Tick,2833,2786,47,-47,150400,151000,36265,-155265,-169365,OK
510.455296,TraderOne,Tick,2833,2786,47,-47,150400,151000,36265,-155265,-169365,OK
510.707531,TraderOne,Tick,2833,2796,37,-37,150300,151000,36115,-159115,-170215,OK
511.007068,TraderOne,Tick,2833,2806,27,-27,150600,151000,36416,-161416,-169516,OK
511.2399,TraderOne,Tick,2833,2806,27,-27,150600,151000,36416,-161416,-169516,OK
511.452037,TraderOne,Tick,2833,2806,27,-27,150600,151000,36416,-161416,-169516,OK
511.701626,TraderOne,Tick,2833,2806,27,-27,150800,151000,36416,-161416,-166816,OK
512.019069,TraderOne,Tick,2833,2806,27,-27,150600,151000,36416,-161416,-169516,OK
512.276777,TraderOne,Tick,2833,2806,27,-27,150600,151000,36416,-161416,-169516,OK
512.504806,TraderOne,Tick,2833,2806,27,-27,150600,151000,36416,-161416,-169516,OK
512.717857,TraderOne,Tick,2843,2806,37,-37,150400,151000,36265,-159265,-170365,OK
513.038327,TraderOne,Tick,2843,2813,30,-30,150700,151000,36160,-161260,-170260,OK
513.260305,TraderOne,Tick,2843,2813,30,-30,150700,151000,36160,-161260,-170260,OK
513.503135,TraderOne,Tick,2843,2813,30,-30,150700,150900,36160,-161260,-167260,OK
513.705546,TraderOne,Tick,2843,2813,30,-30,150700,150900,36160,-161260,-167260,OK
514.01192,TraderOne,Tick,2853,2813,40,-40,150500,151400,36009,-158109,-170109,OK
514.219296,TraderOne,Tick,2863,2813,50,-50,150800,151400,36311,-154411,-169411,OK
514.519345,TraderOne,Tick,2863,2813,50,-50,150800,151300,36311,-154411,-169411,OK
514.73741,TraderOne,Tick,2863,2813,50,-50,151000,151300,36311,-154411,-169411,OK
515.002233,TraderOne,Tick,2863,2813,50,-50,151000,151300,36311,-154411,-169411,OK
515.254954,TraderOne,Tick,2863,2813,50,-50,151000,151300,36311,-154411,-169411,OK
515.459425,TraderOne,Tick,2863,2823,40,-40,150700,151300,36160,-161260,-173260,OK
515.798795,TraderOne,Tick,2863,2823,40,-40,150700,151200,36160,-161260,-173260,OK
516.030654,TraderOne,Tick,2863,2823,40,-40,150700,151200,36160,-161260,-173260,OK
516.284733,TraderOne,Tick,2863,2823,40,-40,150700,151000,36160,-161260,-173260,OK
516.473353,TraderOne,Tick,2863,2833,30,-30,151000,151000,36009,-165109,-165109,OK
516.714544,TraderOne,Tick,2863,2833,30,-30,151000,151000,36009,-165109,-165109,OK
516.983819,TraderOne,Tick,2863,2833,30,-30,151000,151000,36009,-165109,-165109,OK
517.249994,TraderOne,Tick,2863,2833,30,-30,151000,151000,36009,-165109,-165109,OK
517.46218,TraderOne,Tick,2863,2833,30,-30,151000,151000,36009,-165109,-165109,OK
517.744457,TraderOne,Tick,2863,2833,30,-30,151000,151000,36009,-165109,-165109,OK
518.002993,TraderOne,Tick,2873,2833,40,-40,151000,151400,36311,-162411,-174411,OK
518.205947,TraderOne,Tick,2882,2833,49,-49,151000,151400,36583,-159083,-173783,OK
518.468823,TraderOne,Tick,2882,2843,39,-39,151100,151500,36432,-165932,-177632,OK
518.759199,TraderOne,Tick,2892,2843,49,-49,151200,151500,36734,-162234,-176934,OK
519.043267,TraderOne,Tick,2892,2843,49,-49,151200,151500,36734,-162234,-176934,OK
519.262587,TraderOne,Tick,2892,2843,49,-49,151200,151500,36734,-162234,-176934,OK
519.507375,TraderOne,Tick,2892,2853,39,-39,151100,151500,37036,-166536,-178236,OK
519.741364,TraderOne,Tick,2892,2853,39,-39,151100,151500,37036,-166536,-178236,OK
520.045995,TraderOne,Tick,2892,2853,39,-39,151100,151500,37036,-166536,-178236,OK
520.239714,TraderOne,Tick,2902,2853,49,-49,151200,151500,37338,-163838,-178538,OK
520.490372,TraderOne,Tick,2902,2853,49,-49,151200,151500,37338,-163838,-178538,OK
520.707205,TraderOne,Tick,2902,2853,49,-49,151200,151500,37338,-163838,-178538,OK
521.006506,TraderOne,Tick,2902,2853,49,-49,151200,151600,37338,-163838,-178538,OK
521.273893,TraderOne,Tick,2902,2853,49,-49,151200,151600,37338,-163838,-178538,OK
521.464956,TraderOne,Tick,2902,2853,49,-49,151200,151600,37338,-163838,-178538,OK
521.748821,TraderOne,Tick,2912,2853,59,-59,151100,151700,37187,-158687,-176387,OK
522.020927,TraderOne,Tick,2922,2853,69,-69,151100,151700,37489,-153989,-174689,OK
522.204002,TraderOne,Tick,2922,2863,59,-59,151100,151700,37791,-160291,-177991,OK
522.453614,TraderOne,Tick,2922,2873,49,-49,151100,151700,38093,-165593,-180293,OK
522.747136,TraderOne,Tick,2922,2873,49,-49,151100,151500,38093,-165593,-180293,OK
522.956732,TraderOne,Tick,2932,2873,59,-59,151000,151500,37942,-161442,-179142,OK
523.207345,TraderOne,Tick,2932,2873,59,-59,151000,151500,37942,-161442,-179142,OK
523.547591,TraderOne,Tick,2932,2880,52,-52,151100,151500,37836,-166236,-181836,OK
523.735866,TraderOne,Tick,2942,2880,62,-62,151200,151500,38138,-161538,-180138,OK
523.960468,TraderOne,Tick,2942,2880,62,-62,151300,151500,38138,-161538,-173938,OK
524.233911,TraderOne,Tick,2942,2880,62,-62,151300,151500,38138,-161538,-173938,OK
524.470771,TraderOne,Tick,2942,2880,62,-62,151200,151500,38138,-161538,-180138,OK
524.71823,TraderOne,Tick,2942,2880,62,-62,151300,151900,38138,-161538,-180138,OK
524.962993,TraderOne,Tick,2952,2880,72,-72,151300,151900,38441,-155841,-177441,OK
525.227039,TraderOne,Tick,2952,2880,72,-72,151300,151900,38441,-155841,-177441,OK
525.524405,TraderOne,Tick,2952,2890,62,-62,151200,151900,38743,-162143,-180743,OK
525.720646,TraderOne,Tick,2952,2890,62,-62,151200,151900,38743,-162143,-180743,OK
526.02818,TraderOne,Tick,2952,2890,62,-62,151200,151900,38743,-162143,-180743,OK
526.248292,TraderOne,Tick,2952,2900,52,-52,151100,151700,39045,-168445,-184045,OK
526.499407,TraderOne,Tick,2952,2900,52,-52,151100,151700,39045,-168445,-184045,OK
526.746477,TraderOne,Tick,2952,2900,52,-52,151100,151700,39045,-168445,-184045,OK
526.984547,TraderOne,Tick,2952,2903,49,-49,151300,151700,39000,-169600,-184300,OK
527.22418,TraderOne,Tick,2952,2903,49,-49,151300,151700,39000,-169600,-184300,OK
527.452159,TraderOne,Tick,2952,2903,49,-49,151300,151700,39000,-169600,-184300,OK
527.747227,TraderOne,Tick,2952,2903,49,-49,151300,151700,39000,-169600,-184300,OK
527.994066,TraderOne,Tick,2952,2903,49,-49,151300,151700,39000,-169600,-184300,OK
528.257442,TraderOne,Tick,2952,2903,49,-49,151300,151700,39000,-169600,-184300,OK
528.50597,TraderOne,Tick,2952,2903,49,-49,151300,151700,39000,-169600,-184300,OK
528.749712,TraderOne,Tick,2952,2903,49,-49,151300,151400,39000,-169600,-174500,OK
529.029719,TraderOne,Tick,2952,2913,39,-39,151000,151400,39302,-173902,-185602,OK
529.249133,TraderOne,Tick,2952,2913,39,-39,151000,151400,39302,-173902,-185602,OK
529.498999,TraderOne,Tick,2952,2913,39,-39,151000,151200,39302,-173902,-181702,OK
529.790331,TraderOne,Tick,2952,2923,29,-29,151000,151200,39604,-176204,-182004,OK
529.996076,TraderOne,Tick,2952,2933,19,-19,151000,151200,39906,-178506,-182306,OK
530.248302,TraderOne,Tick,2952,2933,19,-19,151000,151200,39906,-178506,-182306,OK
530.524216,TraderOne,Tick,2952,2933,19,-19,151000,151200,39906,-178506,-182306,OK
530.787047,TraderOne,Tick,2952,2933,19,-19,151000,151400,39906,-178506,-184206,OK
530.958082,TraderOne,Tick,2952,2933,19,-19,151000,150900,39906,-178506,-176606,OK
531.235818,TraderOne,Tick,2952,2943,9,-9,150900,150900,40208,-178808,-178808,OK
531.514444,TraderOne,Tick,2952,2943,9,-9,150900,150900,40208,-178808,-178808,OK
531.773617,TraderOne,Tick,2952,2943,9,-9,150900,150900,40208,-178808,-178808,OK
531.962499,TraderOne,Tick,2952,2943,9,-9,150900,151000,40208,-178808,-179708,OK
532.296729,TraderOne,Tick,2952,2953,-1,1,151500,151000,40057,-177657,-177957,OK
532.540859,TraderOne,Tick,2952,2953,-1,1,151500,151000,40057,-177657,-177957,OK
532.747713,TraderOne,Tick,2952,2953,-1,1,151500,151000,40057,-177657,-177957,OK
532.957342,TraderOne,Tick,2962,2953,9,-9,150800,150900,39906,-179506,-180406,OK
533.292208,TraderOne,Tick,2962,2953,9,-9,150800,150900,39906,-179506,-180406,OK
533.462411,TraderOne,Tick,2962,2953,9,-9,150800,150900,39906,-179506,-180406,OK
533.797292,TraderOne,Tick,2962,2961,1,-1,150900,150900,39785,-179385,-179385,OK
533.969701,TraderOne,Tick,2962,2961,1,-1,150900,150900,39785,-179385,-179385,OK
534.250708,TraderOne,Tick,2962,2963,-1,1,151400,150900,39755,-179355,-179655,OK
534.462524,TraderOne,Tick,2962,2963,-1,1,151400,150700,39755,-179355,-179655,OK
534.709535,TraderOne,Tick,2962,2973,-11,11,150800,150700,40057,-178657,-179757,OK
534.984282,TraderOne,Tick,2962,2983,-21,21,151400,150700,39906,-176506,-182806,OK
535.255361,TraderOne,Tick,2965,2983,-18,18,150900,150700,39861,-177361,-180961,OK
535.48787,TraderOne,Tick,2965,2983,-18,18,150900,150700,39861,-177361,-180961,OK
535.733169,TraderOne,Tick,2965,2983,-18,18,150900,150700,39861,-177361,-180961,OK
536.01687,TraderOne,Tick,2965,2983,-18,18,150900,150800,39861,-177361,-179161,OK
536.216486,TraderOne,Tick,2965,2983,-18,18,150900,150800,39861,-177361,-179161,OK
536.492065,TraderOne,Tick,2965,2983,-18,18,150900,150800,39861,-177361,-179161,OK
536.72767,TraderOne,Tick,2972,2983,-11,11,150800,150700,39755,-178655,-179755,OK
537.037646,TraderOne,Tick,2982,2983,-1,1,150600,150800,39604,-180504,-180304,OK
537.210329,TraderOne,Tick,2982,2983,-1,1,150600,150800,39604,-180504,-180304,OK
537.492993,TraderOne,Tick,2982,2983,-1,1,150600,150800,39604,-180504,-180304,OK
537.768793,TraderOne,Tick,2982,2983,-1,1,150600,151100,39604,-180504,-180204,OK
537.997237,TraderOne,Tick,2982,2983,-1,1,150600,151100,39604,-180504,-180204,OK
538.268823,TraderOne,Tick,2982,2983,-1,1,150600,151100,39604,-180504,-180204,OK
538.545517,TraderOne,Tick,2982,2983,-1,1,150600,151100,39604,-180504,-180204,OK
538.74472,TraderOne,Tick,2982,2983,-1,1,150600,151000,39604,-180504,-180204,OK
539.016509,TraderOne,Tick,2992,2993,-1,1,151600,150900,39302,-180202,-180502,OK
539.247546,TraderOne,Tick,2992,2993,-1,1,151600,150900,39302,-180202,-180502,OK
539.494764,TraderOne,Tick,2992,2993,-1,1,151600,150900,39302,-180202,-180502,OK
539.71987,TraderOne,Tick,2992,2993,-1,1,151600,150900,39302,-180202,-180502,OK
540.027475,TraderOne,Tick,2992,2993,-1,1,151600,150900,39302,-180202,-180502,OK
540.22873,TraderOne,Tick,2992,2993,-1,1,151600,150900,39302,-180202,-180502,OK
540.484437,TraderOne,Tick,2992,2993,-1,1,151600,150900,39302,-180202,-180502,OK
540.744007,TraderOne,Tick,2992,2993,-1,1,151600,150900,39302,-180202,-180502,OK
541.022986,TraderOne,Tick,2992,2993,-1,1,151600,151000,39302,-180202,-180502,OK
541.24983,TraderOne,Tick,2992,2993,-1,1,151600,151100,39302,-180202,-180502,OK
541.498406,TraderOne,Tick,2992,3003,-11,11,151600,151600,39151,-182051,-182051,OK
541.714729,TraderOne,Tick,3002,3003,-1,1,151600,151800,39454,-181354,-181154,OK
542.051171,TraderOne,Tick,3012,3003,9,-9,151600,151800,39757,-180657,-182457,OK
542.213306,TraderOne,Tick,3022,3003,19,-19,151600,151800,40060,-178960,-182760,OK
542.549402,TraderOne,Tick,3032,3003,29,-29,151600,151900,40363,-178263,-186963,OK
542.782727,TraderOne,Tick,3042,3003,39,-39,151600,152000,40666,-175566,-187266,OK
542.980022,TraderOne,Tick,3052,3003,49,-49,151600,152000,40969,-172869,-187569,OK
543.272776,TraderOne,Tick,3057,3003,54,-54,151500,152000,40893,-170793,-186993,OK
543.46646,TraderOne,Tick,3057,3003,54,-54,151500,152000,40893,-170793,-186993,OK
543.746765,TraderOne,Tick,3067,3003,64,-64,151600,152500,41196,-166096,-185296,OK
544.027964,TraderOne,Tick,3077,3003,74,-74,151800,152500,41500,-160400,-182600,OK
544.22474,TraderOne,Tick,3077,3013,64,-64,151800,152500,41804,-167704,-186904,OK
544.609901,TraderOne,Tick,3077,3013,64,-64,151800,152500,41804,-167704,-186904,OK
544.722212,TraderOne,Tick,3077,3013,64,-64,151800,152500,41804,-167704,-186904,OK
545.036757,TraderOne,Tick,3077,3023,54,-54,152000,152600,41652,-173552,-189752,OK
545.297199,TraderOne,Tick,3077,3023,54,-54,152000,152400,41652,-173552,-189752,OK
545.548576,TraderOne,Tick,3077,3023,54,-54,152200,152400,41652,-173552,-184352,OK
545.727305,TraderOne,Tick,3077,3023,54,-54,152200,152400,41652,-173552,-184352,OK
545.959739,TraderOne,Tick,3077,3023,54,-54,152200,152400,41652,-173552,-184352,OK
546.289271,TraderOne,Tick,3077,3033,44,-44,152200,152400,41956,-179856,-188656,OK
546.500517,TraderOne,Tick,3077,3033,44,-44,152200,152400,41956,-179856,-188656,OK
546.768869,TraderOne,Tick,3077,3033,44,-44,152200,152400,41956,-179856,-188656,OK
547.020681,TraderOne,Tick,3077,3033,44,-44,152200,152400,41956,-179856,-188656,OK
547.279959,TraderOne,Tick,3077,3033,44,-44,152200,152400,41956,-179856,-188656,OK
547.539271,TraderOne,Tick,3077,3033,44,-44,152200,152400,41956,-179856,-188656,OK
547.779811,TraderOne,Tick,3077,3033,44,-44,152200,152400,41956,-179856,-188656,OK
547.986433,TraderOne,Tick,3087,3033,54,-54,152300,152400,42261,-176161,-181561,OK
548.295115,TraderOne,Tick,3087,3033,54,-54,152300,152400,42261,-176161,-181561,OK
548.45291,TraderOne,Tick,3087,3043,44,-44,152200,152400,42565,-180465,-189265,OK
548.703999,TraderOne,Tick,3087,3053,34,-34,152300,152400,42413,-184313,-187713,OK
548.97484,TraderOne,Tick,3087,3053,34,-34,152300,152400,42413,-184313,-187713,OK
549.295265,TraderOne,Tick,3087,3053,34,-34,152300,152400,42413,-184313,-187713,OK
549.499797,TraderOne,Tick,3087,3053,34,-34,152300,152500,42413,-184313,-191113,OK
549.725477,TraderOne,Tick,3087,3053,34,-34,152300,152700,42413,-184313,-194513,OK
549.997295,TraderOne,Tick,3097,3053,44,-44,152300,152700,42718,-180618,-193818,OK
550.227241,TraderOne,Tick,3097,3053,44,-44,152300,152700,42718,-180618,-193818,OK
550.476423,TraderOne,Tick,3097,3053,44,-44,152300,152700,42718,-180618,-193818,OK
550.75343,TraderOne,Tick,3097,3053,44,-44,152300,152700,42718,-180618,-193818,OK
551.013466,TraderOne,Tick,3097,3053,44,-44,152300,152700,42718,-180618,-193818,OK
551.257812,TraderOne,Tick,3097,3053,44,-44,152400,153000,42718,-180618,-193818,OK
551.543974,TraderOne,Tick,3107,3053,54,-54,152400,153000,43023,-175923,-192123,OK
551.798678,TraderOne,Tick,3107,3053,54,-54,152400,153000,43023,-175923,-192123,OK
552.040707,TraderOne,Tick,3107,3053,54,-54,152400,153000,43023,-175923,-192123,OK
552.268763,TraderOne,Tick,3107,3063,44,-44,152500,153000,42871,-185771,-198971,OK
552.495338,TraderOne,Tick,3117,3063,54,-54,152600,153000,43176,-179076,-195276,OK
552.701974,TraderOne,Tick,3127,3063,64,-64,152800,153600,43482,-171582,-190782,OK
553.023094,TraderOne,Tick,3137,3063,74,-74,153000,153600,43788,-165888,-188088,OK
553.29877,TraderOne,Tick,3137,3073,64,-64,153100,153600,44094,-171194,-190394,OK
553.459218,TraderOne,Tick,3137,3073,64,-64,153000,153600,44094,-171194,-190394,OK
553.724746,TraderOne,Tick,3137,3073,64,-64,153000,153600,44094,-171194,-190394,OK
553.993209,TraderOne,Tick,3137,3083,54,-54,153300,153600,44400,-178500,-194700,OK
554.296209,TraderOne,Tick,3137,3083,54,-54,153300,153600,44400,-178500,-194700,OK
554.535117,TraderOne,Tick,3137,3089,48,-48,153000,153600,44308,-181408,-195808,OK
554.739749,TraderOne,Tick,3137,3089,48,-48,153000,153600,44308,-181408,-195808,OK
554.976071,TraderOne,Tick,3137,3099,38,-38,153300,153600,44155,-183255,-194655,OK
555.243723,TraderOne,Tick,3137,3099,38,-38,153300,153600,44155,-183255,-194655,OK
555.471764,TraderOne,Tick,3137,3099,38,-38,153300,153200,44155,-183255,-179455,OK
555.730767,TraderOne,Tick,3137,3099,38,-38,153300,153200,44155,-183255,-179455,OK
556.025786,TraderOne,Tick,3137,3099,38,-38,153300,153200,44155,-183255,-179455,OK
556.204655,TraderOne,Tick,3137,3099,38,-38,153300,153200,44155,-183255,-179455,OK
556.481365,TraderOne,Tick,3137,3099,38,-38,153300,153300,44155,-183255,-183255,OK
556.786528,TraderOne,Tick,3147,3109,38,-38,153100,153600,44308,-188408,-199808,OK
556.995813,TraderOne,Tick,3157,3109,48,-48,153300,153600,44615,-184715,-199115,OK
557.223579,TraderOne,Tick,3167,3109,58,-58,153300,153600,44922,-181022,-198422,OK
557.532097,TraderOne,Tick,3167,3109,58,-58,153300,153600,44922,-181022,-198422,OK
557.761437,TraderOne,Tick,3167,3109,58,-58,153300,153600,44922,-181022,-198422,OK
557.96697,TraderOne,Tick,3167,3109,58,-58,153300,153600,44922,-181022,-198422,OK
558.277327,TraderOne,Tick,3167,3109,58,-58,153300,153600,44922,-181022,-198422,OK
558.473504,TraderOne,Tick,3167,3109,58,-58,153300,153600,44922,-181022,-198422,OK
558.70567,TraderOne,Tick,3167,3109,58,-58,153300,153600,44922,-181022,-198422,OK
559.049872,TraderOne,Tick,3167,3119,48,-48,153200,153600,45228,-185328,-199728,OK
559.299445,TraderOne,Tick,3167,3119,48,-48,153200,153600,45228,-185328,-199728,OK
559.527006,TraderOne,Tick,3170,3119,51,-51,153100,153600,45182,-184082,-199382,OK
559.708175,TraderOne,Tick,3170,3129,41,-41,153200,153600,45029,-190929,-203229,OK
559.98413,TraderOne,Tick,3180,3129,51,-51,153300,153600,45336,-187236,-202536,OK
560.234776,TraderOne,Tick,3188,3129,59,-59,153200,153600,45213,-183113,-200813,OK
560.513966,TraderOne,Tick,3188,3129,59,-59,153400,153600,45213,-183113,-194913,OK
560.742879,TraderOne,Tick,3188,3129,59,-59,153400,153600,45213,-183113,-194913,OK
560.974082,TraderOne,Tick,3198,3129,69,-69,153100,153600,45060,-177960,-198660,OK
561.280268,TraderOne,Tick,3198,3139,59,-59,153500,154200,44907,-186807,-204507,OK
561.491838,TraderOne,Tick,3208,3139,69,-69,153600,154400,45214,-182114,-202814,OK
561.748832,TraderOne,Tick,3218,3139,79,-79,153900,154400,45521,-176421,-200121,OK
562.023367,TraderOne,Tick,3218,3149,69,-69,153900,154400,45367,-183267,-203967,OK
562.30025,TraderOne,Tick,3218,3159,59,-59,154000,154600,45213,-190113,-207813,OK
562.47931,TraderOne,Tick,3218,3159,59,-59,154000,154800,45213,-190113,-207813,OK
562.773822,TraderOne,Tick,3228,3159,69,-69,154100,154900,45521,-184421,-205121,OK
563.047849,TraderOne,Tick,3228,3159,69,-69,154100,154800,45521,-184421,-205121,OK
563.285915,TraderOne,Tick,3228,3169,59,-59,154100,154600,45829,-190729,-208429,OK
563.483436,TraderOne,Tick,3238,3179,59,-59,153900,154600,45983,-191883,-209583,OK
563.722239,TraderOne,Tick,3238,3189,49,-49,154200,154700,45829,-197729,-212429,OK
563.960697,TraderOne,Tick,3238,3189,49,-49,154200,154700,45829,-197729,-212429,OK
564.241543,TraderOne,Tick,3238,3189,49,-49,154200,154700,45829,-197729,-212429,OK
564.5317,TraderOne,Tick,3238,3189,49,-49,154200,154900,45829,-197729,-212429,OK
564.763526,TraderOne,Tick,3248,3189,59,-59,154100,154900,45675,-194575,-212275,OK
565.022618,TraderOne,Tick,3248,3189,59,-59,154100,154900,45675,-194575,-212275,OK
565.246401,TraderOne,Tick,3248,3189,59,-59,154100,154900,45675,-194575,-212275,OK
565.533984,TraderOne,Tick,3248,3189,59,-59,154100,154700,45675,-194575,-212275,OK
565.78434,TraderOne,Tick,3248,3189,59,-59,154100,154700,45675,-194575,-212275,OK
566.013493,TraderOne,Tick,3248,3189,59,-59,154100,154700,45675,-194575,-212275,OK
566.27713,TraderOne,Tick,3248,3189,59,-59,154100,154700,45675,-194575,-212275,OK
566.492837,TraderOne,Tick,3248,3189,59,-59,154100,154700,45675,-194575,-212275,OK
566.70596,TraderOne,Tick,3248,3189,59,-59,154100,154700,45675,-194575,-212275,OK
566.987156,TraderOne,Tick,3248,3189,59,-59,154100,154700,45675,-194575,-212275,OK
567.290369,TraderOne,Tick,3248,3189,59,-59,154100,154700,45675,-194575,-212275,OK
567.46972,TraderOne,Tick,3248,3189,59,-59,154100,154700,45675,-194575,-212275,OK
567.791203,TraderOne,Tick,3248,3189,59,-59,154100,154700,45675,-194575,-212275,OK
568.051676,TraderOne,Tick,3248,3189,59,-59,154100,154700,45675,-194575,-212275,OK
568.251679,TraderOne,Tick,3248,3189,59,-59,154100,154400,45675,-194575,-212275,OK
568.544404,TraderOne,Tick,3248,3189,59,-59,154100,154400,45675,-194575,-212275,OK
568.74856,TraderOne,Tick,3248,3199,49,-49,154400,154400,45521,-199421,-199421,OK
568.968716,TraderOne,Tick,3248,3199,49,-49,154400,154400,45521,-199421,-199421,OK
569.237516,TraderOne,Tick,3258,3199,59,-59,154000,154700,45367,-193267,-210967,OK
569.488167,TraderOne,Tick,3258,3199,59,-59,154000,154700,45367,-193267,-210967,OK
569.795457,TraderOne,Tick,3258,3199,59,-59,154400,154700,45367,-193267,-210967,OK
569.996751,TraderOne,Tick,3258,3199,59,-59,154400,154700,45367,-193267,-210967,OK
570.284213,TraderOne,Tick,3258,3199,59,-59,154400,154700,45367,-193267,-210967,OK
570.527594,TraderOne,Tick,3258,3199,59,-59,154400,154700,45367,-193267,-210967,OK
570.747517,TraderOne,Tick,3258,3199,59,-59,154400,154700,45367,-193267,-210967,OK
570.974569,TraderOne,Tick,3258,3199,59,-59,154400,154700,45367,-193267,-210967,OK
571.260351,TraderOne,Tick,3258,3209,49,-49,154600,155400,45213,-203113,-217813,OK
571.482125,TraderOne,Tick,3268,3209,59,-59,154800,155400,45522,-198422,-216122,OK
571.755841,TraderOne,Tick,3278,3219,59,-59,155000,155600,45677,-199577,-217277,OK
572.046086,TraderOne,Tick,3278,3219,59,-59,155100,155700,45677,-199577,-217277,OK
572.223307,TraderOne,Tick,3278,3219,59,-59,155100,155700,45677,-199577,-217277,OK
572.546239,TraderOne,Tick,3278,3219,59,-59,155100,155700,45677,-199577,-217277,OK
572.741703,TraderOne,Tick,3278,3219,59,-59,155200,155700,45677,-199577,-217277,OK
573.051196,TraderOne,Tick,3278,3219,59,-59,155200,155700,45677,-199577,-217277,OK
573.234133,TraderOne,Tick,3278,3219,59,-59,155200,155700,45677,-199577,-217277,OK
573.49285,TraderOne,Tick,3288,3229,59,-59,155700,155700,45366,-201266,-201266,OK
573.74464,TraderOne,Tick,3288,3229,59,-59,155000,155700,45366,-201266,-218966,OK
573.994441,TraderOne,Tick,3288,3229,59,-59,155000,155700,45366,-201266,-218966,OK
574.277781,TraderOne,Tick,3288,3229,59,-59,155000,155500,45366,-201266,-218966,OK
574.453249,TraderOne,Tick,3288,3229,59,-59,155000,155500,45366,-201266,-218966,OK
574.721795,TraderOne,Tick,3288,3239,49,-49,155100,155300,45211,-203111,-212911,OK
575.040519,TraderOne,Tick,3298,3249,49,-49,154600,155300,45366,-200266,-214966,OK
575.240773,TraderOne,Tick,3298,3249,49,-49,154600,155300,45366,-200266,-214966,OK
575.46868,TraderOne,Tick,3298,3249,49,-49,154600,155300,45366,-200266,-214966,OK
575.739022,TraderOne,Tick,3298,3249,49,-49,154600,155300,45366,-200266,-214966,OK
575.99674,TraderOne,Tick,3298,3249,49,-49,154600,155300,45366,-200266,-214966,OK
576.273067,TraderOne,Tick,3298,3249,49,-49,154600,155300,45366,-200266,-214966,OK
576.537754,TraderOne,Tick,3298,3249,49,-49,154600,155300,45366,-200266,-214966,OK
576.74387,TraderOne,Tick,3298,3249,49,-49,154600,155300,45366,-200266,-214966,OK
576.959221,TraderOne,Tick,3298,3249,49,-49,154600,155300,45366,-200266,-214966,OK
577.26919,TraderOne,Tick,3298,3249,49,-49,154600,155100,45366,-200266,-214966,OK
577.482575,TraderOne,Tick,3298,3259,39,-39,155000,155100,45211,-204111,-208011,OK
577.701315,TraderOne,Tick,3298,3262,36,-36,155100,155100,45304,-205104,-205104,OK
577.977064,TraderOne,Tick,3308,3262,46,-46,154600,155100,45149,-201949,-215749,OK
578.21479,TraderOne,Tick,3308,3262,46,-46,154600,155100,45149,-201949,-215749,OK
578.49334,TraderOne,Tick,3308,3262,46,-46,154600,155100,45149,-201949,-215749,OK
578.744216,TraderOne,Tick,3308,3262,46,-46,154600,155100,45149,-201949,-215749,OK
579.031928,TraderOne,Tick,3308,3262,46,-46,154600,155100,45149,-201949,-215749,OK
579.271722,TraderOne,Tick,3308,3262,46,-46,154600,155100,45149,-201949,-215749,OK
579.466288,TraderOne,Tick,3308,3262,46,-46,154600,155100,45149,-201949,-215749,OK
579.747756,TraderOne,Tick,3308,3262,46,-46,154600,155100,45149,-201949,-215749,OK
579.960517,TraderOne,Tick,3308,3262,46,-46,154600,155100,45149,-201949,-215749,OK
580.223657,TraderOne,Tick,3308,3262,46,-46,154600,155400,45149,-201949,-215749,OK
580.488788,TraderOne,Tick,3318,3262,56,-56,154600,155400,44994,-196794,-213594,OK
580.737795,TraderOne,Tick,3318,3262,56,-56,154600,155400,44994,-196794,-213594,OK
581.047183,TraderOne,Tick,3318,3272,46,-46,155300,155400,44839,-204639,-209239,OK
581.25312,TraderOne,Tick,3318,3282,36,-36,155200,155400,45149,-206949,-214149,OK
581.531171,TraderOne,Tick,3318,3292,26,-26,155500,155400,45459,-209259,-206659,OK
581.714066,TraderOne,Tick,3318,3292,26,-26,155500,155500,45459,-209259,-209259,OK
581.97471,TraderOne,Tick,3328,3292,36,-36,155500,155500,45770,-207570,-207570,OK
582.224677,TraderOne,Tick,3328,3292,36,-36,155500,155500,45770,-207570,-207570,OK
582.503675,TraderOne,Tick,3328,3292,36,-36,155500,155600,45770,-207570,-211170,OK
582.767986,TraderOne,Tick,3328,3292,36,-36,155500,155600,45770,-207570,-211170,OK
582.953927,TraderOne,Tick,3328,3292,36,-36,155200,155600,45770,-207570,-218370,OK
583.227159,TraderOne,Tick,3328,3292,36,-36,155200,155600,45770,-207570,-218370,OK
583.507708,TraderOne,Tick,3328,3302,26,-26,155200,155600,46080,-210880,-218680,OK
583.725853,TraderOne,Tick,3328,3302,26,-26,155200,155600,46080,-210880,-218680,OK
584.04959,TraderOne,Tick,3328,3312,16,-16,155800,155600,45925,-213725,-210525,OK
584.298285,TraderOne,Tick,3328,3322,6,-6,156000,155600,45769,-214569,-212769,OK
584.531138,TraderOne,Tick,3328,3322,6,-6,156000,155600,45769,-214569,-212769,OK
584.744886,TraderOne,Tick,3328,3322,6,-6,156000,155600,45769,-214569,-212769,OK
585.022158,TraderOne,Tick,3328,3322,6,-6,156000,155600,45769,-214569,-212769,OK
585.238002,TraderOne,Tick,3328,3322,6,-6,156000,155600,45769,-214569,-212769,OK
585.533225,TraderOne,Tick,3328,3322,6,-6,156000,155600,45769,-214569,-212769,OK
585.752465,TraderOne,Tick,3328,3322,6,-6,156000,155600,45769,-214569,-212769,OK
586.039912,TraderOne,Tick,3328,3322,6,-6,156000,155300,45769,-214569,-212769,OK
586.262309,TraderOne,Tick,3328,3322,6,-6,156000,155500,45769,-214569,-212769,OK
586.500446,TraderOne,Tick,3338,3322,16,-16,155200,155400,45614,-214414,-217614,OK
586.785939,TraderOne,Tick,3338,3322,16,-16,155200,155500,45614,-214414,-219214,OK
586.994103,TraderOne,Tick,3338,3322,16,-16,155200,155600,45614,-214414,-219214,OK
587.229314,TraderOne,Tick,3338,3322,16,-16,155200,155600,45614,-214414,-219214,OK
587.541416,TraderOne,Tick,3338,3322,16,-16,155200,155600,45614,-214414,-219214,OK
587.720029,TraderOne,Tick,3345,3322,23,-23,155400,155600,45505,-213605,-218205,OK
587.981437,TraderOne,Tick,3345,3322,23,-23,155400,155600,45505,-213605,-218205,OK
588.242045,TraderOne,Tick,3345,3322,23,-23,155400,155600,45505,-213605,-218205,OK
588.545115,TraderOne,Tick,3345,3332,13,-13,155900,155600,45816,-214916,-211016,OK
588.77349,TraderOne,Tick,3345,3332,13,-13,155900,155600,45816,-214916,-211016,OK
589.012359,TraderOne,Tick,3345,3332,13,-13,155200,155600,45816,-214916,-218816,OK
589.251455,TraderOne,Tick,3345,3332,13,-13,155200,155600,45816,-214916,-218816,OK
589.51492,TraderOne,Tick,3345,3332,13,-13,155200,155600,45816,-214916,-218816,OK
589.789569,TraderOne,Tick,3345,3332,13,-13,155200,155600,45816,-214916,-218816,OK
589.968699,TraderOne,Tick,3345,3332,13,-13,155200,155600,45816,-214916,-218816,OK
590.235146,TraderOne,Tick,3345,3332,13,-13,155200,155600,45816,-214916,-218816,OK
590.538057,TraderOne,Tick,3345,3332,13,-13,155200,155600,45816,-214916,-218816,OK
590.734741,TraderOne,Tick,3345,3332,13,-13,155200,155600,45816,-214916,-218816,OK
590.959723,TraderOne,Tick,3345,3342,3,-3,155100,155600,46126,-217226,-218126,OK
591.209435,TraderOne,Tick,3345,3342,3,-3,155100,155000,46126,-217226,-216926,OK
591.461223,TraderOne,Tick,3345,3342,3,-3,155100,155000,46126,-217226,-216926,OK
591.770259,TraderOne,Tick,3345,3342,3,-3,155100,155000,46126,-217226,-216926,OK
592.00415,TraderOne,Tick,3345,3342,3,-3,155100,155000,46126,-217226,-216926,OK
592.297203,TraderOne,Tick,3345,3342,3,-3,155100,155300,46126,-217226,-217826,OK
592.457398,TraderOne,Tick,3345,3342,3,-3,155100,155300,46126,-217226,-217826,OK
592.786134,TraderOne,Tick,3345,3342,3,-3,155100,155300,46126,-217226,-217826,OK
593.040437,TraderOne,Tick,3345,3342,3,-3,155100,155500,46126,-217226,-218126,OK
593.263478,TraderOne,Tick,3345,3342,3,-3,155100,155500,46126,-217226,-218126,OK
593.49697,TraderOne,Tick,3345,3351,-6,6,155600,155500,45986,-217086,-217686,OK
593.756086,TraderOne,Tick,3345,3351,-6,6,155600,155400,45986,-217086,-218286,OK
594.006176,TraderOne,Tick,3345,3358,-13,13,155500,155400,45877,-216277,-217577,OK
594.209402,TraderOne,Tick,3345,3358,-13,13,155500,155300,45877,-216277,-218877,OK
594.455874,TraderOne,Tick,3345,3358,-13,13,155500,155400,45877,-216277,-217577,OK
594.792445,TraderOne,Tick,3355,3358,-3,3,155600,155400,45721,-219121,-219721,OK
595.024138,TraderOne,Tick,3365,3358,7,-7,155400,155400,46032,-221432,-221432,OK
595.268839,TraderOne,Tick,3365,3358,7,-7,155400,155400,46032,-221432,-221432,OK
595.480248,TraderOne,Tick,3375,3358,17,-17,155300,155300,46343,-221743,-221743,OK
595.79533,TraderOne,Tick,3375,3363,12,-12,155300,155300,46265,-222165,-222165,OK
595.95723,TraderOne,Tick,3375,3363,12,-12,155300,155300,46265,-222165,-222165,OK
596.236961,TraderOne,Tick,3375,3363,12,-12,155300,155300,46265,-222165,-222165,OK
596.52069,TraderOne,Tick,3375,3363,12,-12,155300,155300,46265,-222165,-222165,OK
596.744082,TraderOne,Tick,3375,3363,12,-12,155300,155200,46265,-222165,-220965,OK
597.01604,TraderOne,Tick,3375,3373,2,-2,155100,155100,46575,-223475,-223475,OK
597.240638,TraderOne,Tick,3375,3373,2,-2,155100,155100,46575,-223475,-223475,OK
597.453772,TraderOne,Tick,3375,3373,2,-2,155100,155100,46575,-223475,-223475,OK
597.759915,TraderOne,Tick,3375,3373,2,-2,155100,155100,46575,-223475,-223475,OK
597.98179,TraderOne,Tick,3375,3383,-8,8,155100,155100,46885,-223785,-223785,OK
598.224259,TraderOne,Tick,3375,3383,-8,8,155100,155100,46885,-223785,-223785,OK
598.478367,TraderOne,Tick,3375,3393,-18,18,155100,154900,47195,-222095,-225695,OK
598.713582,TraderOne,Tick,3375,3393,-18,18,155100,155000,47195,-222095,-223895,OK
598.987524,TraderOne,Tick,3375,3403,-28,28,155400,155100,47040,-220940,-229340,OK
599.287449,TraderOne,Tick,3375,3403,-28,28,155400,155100,47040,-220940,-229340,OK
599.542161,TraderOne,Tick,3375,3413,-38,38,155600,155100,46885,-218785,-230185,OK
599.741754,TraderOne,Tick,3375,3413,-38,38,155600,155100,46885,-218785,-230185,OK
599.990078,TraderOne,Tick,3375,3413,-38,38,155600,155100,46885,-218785,-230185,OK
600.290698,TraderOne,Tick,3375,3413,-38,38,155600,155100,46885,-218785,-230185,OK
600.499549,TraderOne,Tick,3375,3413,-38,38,155600,155100,46885,-218785,-230185,OK
600.722548,TraderOne,Tick,3375,3415,-40,40,155500,155100,46854,-217954,-229954,OK
600.996666,TraderOne,Tick,3375,3415,-40,40,155500,155100,46854,-217954,-229954,OK
601.249003,TraderOne,Tick,3375,3415,-40,40,155500,155100,46854,-217954,-229954,OK
601.473179,TraderOne,Tick,3375,3415,-40,40,155500,155100,46854,-217954,-229954,OK
601.771822,TraderOne,Tick,3375,3415,-40,40,155500,155100,46854,-217954,-229954,OK
602.005351,TraderOne,Tick,3375,3425,-50,50,155800,155100,46698,-214798,-229798,OK
602.288704,TraderOne,Tick,3375,3425,-50,50,155800,155100,46698,-214798,-229798,OK
602.55144,TraderOne,Tick,3375,3425,-50,50,155800,155100,46698,-214798,-229798,OK
602.705151,TraderOne,Tick,3382,3425,-43,43,155600,155100,46589,-218189,-231089,OK
602.959216,TraderOne,Tick,3382,3425,-43,43,155600,155100,46589,-218189,-231089,OK
603.295107,TraderOne,Tick,3382,3425,-43,43,155600,155100,46589,-218189,-231089,OK
603.510611,TraderOne,Tick,3382,3425,-43,43,155600,155100,46589,-218189,-231089,OK
603.747834,TraderOne,Tick,3382,3425,-43,43,155600,155100,46589,-218189,-231089,OK
603.988247,TraderOne,Tick,3382,3425,-43,43,155600,155100,46589,-218189,-231089,OK
604.295687,TraderOne,Tick,3382,3425,-43,43,155600,155100,46589,-218189,-231089,OK
604.546139,TraderOne,Tick,3382,3425,-43,43,155600,155100,46589,-218189,-231089,OK
604.775193,TraderOne,Tick,3382,3425,-43,43,155600,155100,46589,-218189,-231089,OK
605.044863,TraderOne,Tick,3392,3425,-33,33,155300,155100,46434,-228034,-234634,OK
605.236609,TraderOne,Tick,3392,3435,-43,43,155100,154600,46744,-224344,-237244,OK
605.548738,TraderOne,Tick,3392,3445,-53,53,155000,154600,47054,-219654,-235554,OK
605.74816,TraderOne,Tick,3402,3445,-43,43,155000,154600,47364,-224964,-237864,OK
605.967482,TraderOne,Tick,3402,3445,-43,43,155000,154600,47364,-224964,-237864,OK
606.258622,TraderOne,Tick,3402,3445,-43,43,155000,154600,47364,-224964,-237864,OK
606.501537,TraderOne,Tick,3402,3445,-43,43,155000,154700,47364,-224964,-237864,OK
606.776746,TraderOne,Tick,3402,3445,-43,43,155000,154700,47364,-224964,-237864,OK
606.973776,TraderOne,Tick,3402,3445,-43,43,155000,154700,47364,-224964,-237864,OK
607.299018,TraderOne,Tick,3402,3445,-43,43,155000,155000,47364,-224964,-224964,OK
607.461551,TraderOne,Tick,3412,3445,-33,33,154900,155000,47208,-228808,-225508,OK
607.701305,TraderOne,Tick,3412,3445,-33,33,154900,155000,47208,-228808,-225508,OK
607.978905,TraderOne,Tick,3412,3445,-33,33,154900,155000,47208,-228808,-225508,OK
608.220612,TraderOne,Tick,3412,3445,-33,33,155500,155000,47208,-228808,-238708,OK
608.500565,TraderOne,Tick,3416,3445,-29,29,155600,155400,47146,-229946,-235746,OK
608.738247,TraderOne,Tick,3416,3445,-29,29,155600,155400,47146,-229946,-235746,OK
609.028236,TraderOne,Tick,3416,3445,-29,29,155600,155400,47146,-229946,-235746,OK
609.20639,TraderOne,Tick,3416,3445,-29,29,155600,155400,47146,-229946,-235746,OK
609.532419,TraderOne,Tick,3426,3445,-19,19,155500,155700,46990,-232790,-228990,OK
609.786967,TraderOne,Tick,3436,3445,-9,9,155000,155700,46834,-236634,-233934,OK
610.006582,TraderOne,Tick,3436,3445,-9,9,155000,155700,46834,-236634,-233934,OK
610.257326,TraderOne,Tick,3436,3445,-9,9,155000,155700,46834,-236634,-233934,OK
610.466111,TraderOne,Tick,3436,3445,-9,9,155000,155700,46834,-236634,-233934,OK
610.787145,TraderOne,Tick,3436,3445,-9,9,155000,155500,46834,-236634,-233934,OK
611.006133,TraderOne,Tick,3446,3445,1,-1,155800,155500,46678,-237478,-237178,OK
611.290154,TraderOne,Tick,3446,3445,1,-1,155800,155500,46678,-237478,-237178,OK
611.505548,TraderOne,Tick,3446,3445,1,-1,155800,155500,46678,-237478,-237178,OK
611.807398,TraderOne,Tick,3454,3445,9,-9,155800,155500,46927,-237727,-235027,OK
611.966697,TraderOne,Tick,3454,3445,9,-9,155800,155500,46927,-237727,-235027,OK
612.206148,TraderOne,Tick,3454,3445,9,-9,155800,156000,46927,-237727,-239527,OK
612.491015,TraderOne,Tick,3454,3445,9,-9,155900,156000,46927,-237727,-238627,OK
612.722464,TraderOne,Tick,3463,3445,18,-18,155900,156000,47208,-238008,-239808,OK
612.964957,TraderOne,Tick,3464,3445,19,-19,155400,156000,47192,-237992,-243692,OK
613.293945,TraderOne,Tick,3464,3445,19,-19,155400,156300,47192,-237992,-243692,OK
613.473743,TraderOne,Tick,3474,3445,29,-29,156000,156100,47504,-238304,-241204,OK
613.705857,TraderOne,Tick,3474,3445,29,-29,156000,156100,47504,-238304,-241204,OK
614.042976,TraderOne,Tick,3474,3445,29,-29,156000,156400,47504,-238304,-247004,OK
614.300496,TraderOne,Tick,3484,3445,39,-39,156000,156400,47816,-236616,-248316,OK
614.492505,TraderOne,Tick,3494,3445,49,-49,156000,156400,48128,-234928,-249628,OK
614.763939,TraderOne,Tick,3494,3445,49,-49,156000,156400,48128,-234928,-249628,OK
614.975956,TraderOne,Tick,3494,3445,49,-49,156000,156400,48128,-234928,-249628,OK
615.241938,TraderOne,Tick,3494,3445,49,-49,156000,156400,48128,-234928,-249628,OK
615.534609,TraderOne,Tick,3494,3445,49,-49,156000,156400,48128,-234928,-249628,OK
615.787295,TraderOne,Tick,3494,3445,49,-49,156000,156400,48128,-234928,-249628,OK
616.000763,TraderOne,Tick,3494,3445,49,-49,156000,156400,48128,-234928,-249628,OK
616.236563,TraderOne,Tick,3494,3445,49,-49,156000,156400,48128,-234928,-249628,OK
616.544682,TraderOne,Tick,3494,3445,49,-49,156000,156400,48128,-234928,-249628,OK
616.798371,TraderOne,Tick,3494,3445,49,-49,156000,156400,48128,-234928,-249628,OK
616.99188,TraderOne,Tick,3494,3445,49,-49,156000,156400,48128,-234928,-249628,OK
617.224156,TraderOne,Tick,3494,3445,49,-49,156000,156400,48128,-234928,-249628,OK
617.518088,TraderOne,Tick,3494,3445,49,-49,156000,155900,48128,-234928,-230028,OK
617.712686,TraderOne,Tick,3494,3445,49,-49,156000,155900,48128,-234928,-230028,OK
617.99704,TraderOne,Tick,3494,3445,49,-49,156000,155900,48128,-234928,-230028,OK
618.202342,TraderOne,Tick,3494,3445,49,-49,156000,155900,48128,-234928,-230028,OK
618.471588,TraderOne,Tick,3494,3445,49,-49,156000,155900,48128,-234928,-230028,OK
618.742237,TraderOne,Tick,3494,3445,49,-49,156000,155700,48128,-234928,-220228,OK
619.024314,TraderOne,Tick,3494,3455,39,-39,155400,155600,48439,-239239,-247039,OK
619.221474,TraderOne,Tick,3504,3455,49,-49,155000,155600,48284,-236084,-250784,OK
619.546613,TraderOne,Tick,3504,3465,39,-39,156000,155600,48129,-239929,-228229,OK
619.735567,TraderOne,Tick,3504,3465,39,-39,156000,155600,48129,-239929,-228229,OK
619.973863,TraderOne,Tick,3504,3472,32,-32,155400,155600,48020,-241920,-248320,OK
620.223017,TraderOne,Tick,3504,3472,32,-32,155400,155600,48020,-241920,-248320,OK
620.544524,TraderOne,Tick,3504,3472,32,-32,155400,155600,48020,-241920,-248320,OK
620.757998,TraderOne,Tick,3504,3472,32,-32,155400,155700,48020,-241920,-251520,OK
620.977723,TraderOne,Tick,3513,3472,41,-41,155300,155700,47880,-238180,-250480,OK
621.242291,TraderOne,Tick,3513,3472,41,-41,155300,155700,47880,-238180,-250480,OK
621.504041,TraderOne,Tick,3513,3472,41,-41,155300,155700,47880,-238180,-250480,OK
621.758994,TraderOne,Tick,3523,3472,51,-51,155400,155700,47724,-234024,-249324,OK
621.991646,TraderOne,Tick,3523,3472,51,-51,155400,156200,47724,-234024,-249324,OK
622.252076,TraderOne,Tick,3523,3472,51,-51,155400,156200,47724,-234024,-249324,OK
622.496853,TraderOne,Tick,3523,3472,51,-51,155400,156200,47724,-234024,-249324,OK
622.735008,TraderOne,Tick,3523,3482,41,-41,156400,156200,47568,-238868,-230668,OK
622.979891,TraderOne,Tick,3523,3482,41,-41,156400,156200,47568,-238868,-230668,OK
623.223221,TraderOne,Tick,3523,3482,41,-41,156400,156200,47568,-238868,-230668,OK
623.459951,TraderOne,Tick,3523,3482,41,-41,156400,156200,47568,-238868,-230668,OK
623.792732,TraderOne,Tick,3523,3492,31,-31,156400,156200,47412,-241712,-235512,OK
623.951827,TraderOne,Tick,3523,3492,31,-31,156400,156200,47412,-241712,-235512,OK
624.249603,TraderOne,Tick,3523,3502,21,-21,156000,155900,47256,-247556,-245456,OK
624.47208,TraderOne,Tick,3523,3502,21,-21,156000,155900,47256,-247556,-245456,OK
624.716755,TraderOne,Tick,3523,3502,21,-21,156000,155900,47256,-247556,-245456,OK
624.968377,TraderOne,Tick,3523,3502,21,-21,156000,155900,47256,-247556,-245456,OK
625.265618,TraderOne,Tick,3523,3502,21,-21,156000,155900,47256,-247556,-245456,OK
625.534164,TraderOne,Tick,3523,3502,21,-21,156000,155500,47256,-247556,-241256,OK
625.794189,TraderOne,Tick,3523,3502,21,-21,156000,155400,47256,-247556,-241256,OK
625.994543,TraderOne,Tick,3523,3502,21,-21,156000,155200,47256,-247556,-241256,OK
626.261971,TraderOne,Tick,3523,3512,11,-11,155200,155200,47566,-249866,-249866,OK
626.477322,TraderOne,Tick,3523,3512,11,-11,155200,155200,47566,-249866,-249866,OK
626.738884,TraderOne,Tick,3523,3512,11,-11,155200,155200,47566,-249866,-249866,OK
626.975486,TraderOne,Tick,3523,3512,11,-11,155200,155200,47566,-249866,-249866,OK
627.257509,TraderOne,Tick,3523,3512,11,-11,155200,155500,47566,-249866,-253166,OK
627.482359,TraderOne,Tick,3523,3512,11,-11,155200,155500,47566,-249866,-253166,OK
627.786164,TraderOne,Tick,3523,3512,11,-11,155200,155500,47566,-249866,-253166,OK
628.008818,TraderOne,Tick,3523,3512,11,-11,155200,155500,47566,-249866,-253166,OK
628.261717,TraderOne,Tick,3523,3512,11,-11,155200,155800,47566,-249866,-253166,OK
628.455992,TraderOne,Tick,3523,3512,11,-11,155200,155800,47566,-249866,-253166,OK
628.721893,TraderOne,Tick,3523,3512,11,-11,155200,155800,47566,-249866,-253166,OK
629.046472,TraderOne,Tick,3523,3512,11,-11,155200,155800,47566,-249866,-253166,OK
629.286897,TraderOne,Tick,3523,3512,11,-11,155200,155800,47566,-249866,-253166,OK
629.486208,TraderOne,Tick,3523,3512,11,-11,156000,155800,47566,-249866,-247666,OK
629.750452,TraderOne,Tick,3523,3512,11,-11,156000,155800,47566,-249866,-247666,OK
630.00474,TraderOne,Tick,3523,3512,11,-11,156000,155800,47566,-249866,-247666,OK
630.291695,TraderOne,Tick,3523,3512,11,-11,156000,155800,47566,-249866,-247666,OK
630.451355,TraderOne,Tick,3523,3512,11,-11,156000,155800,47566,-249866,-247666,OK
630.74036,TraderOne,Tick,3523,3512,11,-11,156000,155800,47566,-249866,-247666,OK
631.007956,TraderOne,Tick,3523,3522,1,-1,155900,155700,47410,-251710,-251510,OK
631.234366,TraderOne,Tick,3523,3522,1,-1,155900,155700,47410,-251710,-251510,OK
631.524693,TraderOne,Tick,3523,3522,1,-1,155900,155700,47410,-251710,-251510,OK
631.734382,TraderOne,Tick,3523,3522,1,-1,155900,155700,47410,-251710,-251510,OK
632.032722,TraderOne,Tick,3533,3522,11,-11,156000,156000,47722,-252022,-252022,OK
632.244037,TraderOne,Tick,3533,3532,1,-1,155900,156000,48034,-253334,-253434,OK
632.538023,TraderOne,Tick,3533,3532,1,-1,156000,156000,48034,-253334,-253334,OK
632.773145,TraderOne,Tick,3533,3532,1,-1,156000,156000,48034,-253334,-253334,OK
632.990517,TraderOne,Tick,3533,3532,1,-1,156000,155800,48034,-253334,-253134,OK
633.236572,TraderOne,Tick,3533,3542,-9,9,155900,155800,48346,-252646,-253546,OK
633.456661,TraderOne,Tick,3533,3552,-19,19,155900,155800,48658,-251958,-253858,OK
633.76016,TraderOne,Tick,3533,3552,-19,19,155900,155800,48658,-251958,-253858,OK
634.051226,TraderOne,Tick,3543,3552,-9,9,155600,155800,48502,-253802,-252002,OK
634.291743,TraderOne,Tick,3543,3552,-9,9,155600,155800,48502,-253802,-252002,OK
634.550526,TraderOne,Tick,3543,3552,-9,9,155600,155800,48502,-253802,-252002,OK
634.745101,TraderOne,Tick,3543,3552,-9,9,155600,155800,48502,-253802,-252002,OK
634.963733,TraderOne,Tick,3543,3552,-9,9,155600,155800,48502,-253802,-252002,OK
635.286844,TraderOne,Tick,3553,3552,1,-1,155700,155800,48346,-254646,-254746,OK
635.450233,TraderOne,Tick,3553,3552,1,-1,155700,155800,48346,-254646,-254746,OK
635.798323,TraderOne,Tick,3553,3552,1,-1,155700,155800,48346,-254646,-254746,OK
636.015288,TraderOne,Tick,3553,3552,1,-1,155600,155800,48346,-254646,-254846,OK
636.213391,TraderOne,Tick,3563,3552,11,-11,155700,155800,48657,-253957,-255057,OK
636.462595,TraderOne,Tick,3563,3552,11,-11,155700,155900,48657,-253957,-256157,OK
636.774719,TraderOne,Tick,3563,3552,11,-11,155600,155900,48657,-253957,-257257,OK
637.001614,TraderOne,Tick,3563,3552,11,-11,155600,155900,48657,-253957,-257257,OK
637.204911,TraderOne,Tick,3563,3552,11,-11,155600,155900,48657,-253957,-257257,OK
637.490537,TraderOne,Tick,3563,3552,11,-11,155600,155900,48657,-253957,-257257,OK
637.776285,TraderOne,Tick,3573,3552,21,-21,155700,155900,48968,-253268,-257468,OK
638.042625,TraderOne,Tick,3583,3552,31,-31,155700,155900,49279,-251579,-257779,OK
638.219003,TraderOne,Tick,3593,3552,41,-41,155400,155900,49123,-248423,-260723,OK
638.504005,TraderOne,Tick,3593,3562,31,-31,155800,155900,48967,-254267,-257367,OK
638.778105,TraderOne,Tick,3603,3562,41,-41,155800,155900,49279,-250579,-254679,OK
639.023422,TraderOne,Tick,3603,3562,41,-41,155800,155900,49279,-250579,-254679,OK
639.278076,TraderOne,Tick,3603,3562,41,-41,155800,155900,49279,-250579,-254679,OK
639.490566,TraderOne,Tick,3603,3562,41,-41,155800,155900,49279,-250579,-254679,OK
639.782,TraderOne,Tick,3603,3562,41,-41,155800,155900,49279,-250579,-254679,OK
640.01842,TraderOne,Tick,3603,3562,41,-41,155800,155900,49279,-250579,-254679,OK
640.261206,TraderOne,Tick,3603,3562,41,-41,155800,155900,49279,-250579,-254679,OK
640.501241,TraderOne,Tick,3603,3572,31,-31,155800,155900,49123,-253423,-256523,OK
640.773774,TraderOne,Tick,3603,3572,31,-31,155500,155900,49123,-253423,-262723,OK
641.023026,TraderOne,Tick,3603,3582,21,-21,156100,155900,48967,-256267,-252067,OK
641.215366,TraderOne,Tick,3603,3582,21,-21,156100,155900,48967,-256267,-252067,OK
641.540821,TraderOne,Tick,3603,3582,21,-21,156100,155700,48967,-256267,-249967,OK
641.731501,TraderOne,Tick,3603,3582,21,-21,156100,155700,48967,-256267,-249967,OK
642.027717,TraderOne,Tick,3603,3582,21,-21,156100,156000,48967,-256267,-254167,OK
642.2486,TraderOne,Tick,3603,3592,11,-11,156100,156000,48811,-258111,-257011,OK
642.500551,TraderOne,Tick,3613,3592,21,-21,156000,156000,48655,-256955,-256955,OK
642.784472,TraderOne,Tick,3623,3592,31,-31,155600,156000,48967,-254267,-263567,OK
643.03231,TraderOne,Tick,3623,3592,31,-31,155600,156500,48967,-254267,-263567,OK
643.226221,TraderOne,Tick,3633,3592,41,-41,155900,156500,49279,-250579,-262879,OK
643.473156,TraderOne,Tick,3643,3592,51,-51,155900,156500,49591,-245891,-261191,OK
643.783038,TraderOne,Tick,3643,3592,51,-51,156100,156700,49591,-245891,-261191,OK
643.978679,TraderOne,Tick,3653,3592,61,-61,156100,156700,49903,-241203,-259503,OK
644.265792,TraderOne,Tick,3663,3592,71,-71,156100,157100,50215,-234515,-255815,OK
644.492338,TraderOne,Tick,3663,3592,71,-71,156400,157000,50215,-234515,-255815,OK
644.73008,TraderOne,Tick,3663,3602,61,-61,156400,157000,50528,-239828,-258128,OK
644.97089,TraderOne,Tick,3663,3612,51,-51,156200,157000,50840,-246140,-261440,OK
645.211357,TraderOne,Tick,3663,3622,41,-41,156600,157000,50684,-250984,-263284,OK
645.482547,TraderOne,Tick,3663,3622,41,-41,156600,157000,50684,-250984,-263284,OK
645.714217,TraderOne,Tick,3663,3622,41,-41,156600,157000,50684,-250984,-263284,OK
646.035003,TraderOne,Tick,3663,3622,41,-41,156600,156400,50684,-250984,-242784,OK
646.226996,TraderOne,Tick,3663,3622,41,-41,156600,156400,50684,-250984,-242784,OK
646.538743,TraderOne,Tick,3663,3622,41,-41,156600,156400,50684,-250984,-242784,OK
646.712242,TraderOne,Tick,3663,3622,41,-41,156600,156400,50684,-250984,-242784,OK
647.039705,TraderOne,Tick,3663,3622,41,-41,156600,156400,50684,-250984,-242784,OK
647.202199,TraderOne,Tick,3663,3632,31,-31,156100,156400,50528,-254828,-264128,OK
647.534473,TraderOne,Tick,3663,3632,31,-31,156100,156300,50528,-254828,-261028,OK
647.760096,TraderOne,Tick,3663,3632,31,-31,156100,156300,50528,-254828,-261028,OK
648.012215,TraderOne,Tick,3663,3632,31,-31,156100,156200,50528,-254828,-257928,OK
648.241333,TraderOne,Tick,3663,3632,31,-31,156100,156200,50528,-254828,-257928,OK
648.464915,TraderOne,Tick,3663,3632,31,-31,156100,156000,50528,-254828,-251728,OK
648.797871,TraderOne,Tick,3663,3632,31,-31,156100,156000,50528,-254828,-251728,OK
648.991271,TraderOne,Tick,3663,3632,31,-31,156100,156000,50528,-254828,-251728,OK
649.294718,TraderOne,Tick,3663,3642,21,-21,156600,156000,50372,-258672,-252372,OK
649.539887,TraderOne,Tick,3663,3642,21,-21,156600,156000,50372,-258672,-252372,OK
649.781182,TraderOne,Tick,3663,3652,11,-11,156600,156000,50216,-260516,-257216,OK
650.02366,TraderOne,Tick,3663,3652,11,-11,156600,156000,50216,-260516,-257216,OK
650.285475,TraderOne,Tick,3663,3652,11,-11,156600,156000,50216,-260516,-257216,OK
650.550012,TraderOne,Tick,3663,3652,11,-11,156600,156000,50216,-260516,-257216,OK
650.788481,TraderOne,Tick,3663,3652,11,-11,156600,155900,50216,-260516,-257216,OK
650.995535,TraderOne,Tick,3673,3652,21,-21,155500,155800,50060,-260360,-266660,OK
651.279363,TraderOne,Tick,3673,3662,11,-11,155600,155800,49904,-262204,-264404,OK
651.478689,TraderOne,Tick,3673,3672,1,-1,156000,155800,50216,-262516,-262316,OK
651.703647,TraderOne,Tick,3673,3682,-9,9,156000,155800,50528,-261828,-263628,OK
652.007443,TraderOne,Tick,3673,3692,-19,19,156000,155800,50840,-261140,-264940,OK
652.302396,TraderOne,Tick,3673,3692,-19,19,156000,155800,50840,-261140,-264940,OK
652.484119,TraderOne,Tick,3673,3702,-29,29,156000,155700,51152,-259452,-268152,OK
652.776258,TraderOne,Tick,3673,3702,-29,29,156000,155700,51152,-259452,-268152,OK
652.969131,TraderOne,Tick,3673,3702,-29,29,156000,155700,51152,-259452,-268152,OK
653.266016,TraderOne,Tick,3673,3702,-29,29,156000,155800,51152,-259452,-265252,OK
653.498458,TraderOne,Tick,3673,3702,-29,29,156000,155800,51152,-259452,-265252,OK
653.708802,TraderOne,Tick,3673,3702,-29,29,156000,155800,51152,-259452,-265252,OK
653.990495,TraderOne,Tick,3673,3702,-29,29,156000,155800,51152,-259452,-265252,OK
654.207936,TraderOne,Tick,3673,3702,-29,29,156000,155800,51152,-259452,-265252,OK
654.496424,TraderOne,Tick,3673,3702,-29,29,156000,155800,51152,-259452,-265252,OK
654.780439,TraderOne,Tick,3673,3702,-29,29,156000,155800,51152,-259452,-265252,OK
654.959301,TraderOne,Tick,3673,3702,-29,29,156000,155800,51152,-259452,-265252,OK
655.233782,TraderOne,Tick,3673,3702,-29,29,156000,155700,51152,-259452,-268152,OK
655.525755,TraderOne,Tick,3673,3712,-39,39,156300,155700,51371,-256871,-268571,OK
655.734868,TraderOne,Tick,3673,3712,-39,39,156300,155700,51371,-256871,-268571,OK
656.018686,TraderOne,Tick,3673,3712,-39,39,156300,155700,51371,-256871,-268571,OK
656.265092,TraderOne,Tick,3673,3712,-39,39,156300,155800,51371,-256871,-268571,OK
656.506187,TraderOne,Tick,3673,3712,-39,39,156300,155800,51371,-256871,-268571,OK
656.79043,TraderOne,Tick,3683,3712,-29,29,155500,155800,51215,-260715,-252015,OK
657.039105,TraderOne,Tick,3683,3712,-29,29,155500,155800,51215,-260715,-252015,OK
657.225589,TraderOne,Tick,3693,3712,-19,19,156000,155800,51059,-261559,-265359,OK
657.514664,TraderOne,Tick,3700,3712,-12,12,155600,155800,51277,-259677,-257277,OK
657.72123,TraderOne,Tick,3700,3722,-22,22,156600,155800,51121,-257521,-264121,OK
658.008107,TraderOne,Tick,3700,3732,-32,32,156600,155800,50965,-254365,-263965,OK
658.226443,TraderOne,Tick,3700,3732,-32,32,156600,155800,50965,-254365,-263965,OK
658.48407,TraderOne,Tick,3700,3732,-32,32,156600,155800,50965,-254365,-263965,OK
658.762675,TraderOne,Tick,3710,3732,-22,22,155500,155800,50809,-258209,-251609,OK
659.033073,TraderOne,Tick,3710,3732,-22,22,155500,155800,50809,-258209,-251609,OK
659.241284,TraderOne,Tick,3710,3732,-22,22,155500,155800,50809,-258209,-251609,OK
659.519413,TraderOne,Tick,3720,3732,-12,12,156200,155800,51121,-261521,-265121,OK
659.739853,TraderOne,Tick,3720,3732,-12,12,156200,155800,51121,-261521,-265121,OK
660.042538,TraderOne,Tick,3720,3732,-12,12,156200,155900,51121,-261521,-265121,OK
660.260399,TraderOne,Tick,3720,3732,-12,12,156200,155900,51121,-261521,-265121,OK
660.476441,TraderOne,Tick,3720,3732,-12,12,156200,156100,51121,-261521,-262721,OK
660.725827,TraderOne,Tick,3730,3732,-2,2,156200,156100,51433,-262833,-263033,OK
661.036149,TraderOne,Tick,3740,3732,8,-8,156200,156100,51745,-264145,-263345,OK
661.227094,TraderOne,Tick,3740,3732,8,-8,156200,156000,51745,-264145,-262545,OK
661.540212,TraderOne,Tick,3740,3732,8,-8,156200,156000,51745,-264145,-262545,OK
661.75579,TraderOne,Tick,3740,3742,-2,2,156200,156000,51589,-265989,-266389,OK
662.013433,TraderOne,Tick,3740,3742,-2,2,156200,156000,51589,-265989,-266389,OK
662.257536,TraderOne,Tick,3740,3742,-2,2,156200,156000,51589,-265989,-266389,OK
662.535948,TraderOne,Tick,3740,3742,-2,2,156200,156000,51589,-265989,-266389,OK
662.741875,TraderOne,Tick,3750,3742,8,-8,155900,156000,51433,-266833,-267633,OK
662.973374,TraderOne,Tick,3750,3742,8,-8,155900,156000,51433,-266833,-267633,OK
663.280717,TraderOne,Tick,3750,3742,8,-8,155900,156000,51433,-266833,-267633,OK
663.468747,TraderOne,Tick,3750,3752,-2,2,156200,156000,51277,-266677,-267077,OK
663.769949,TraderOne,Tick,3750,3752,-2,2,156200,155900,51277,-266677,-267277,OK
663.998183,TraderOne,Tick,3750,3752,-2,2,156200,155900,51277,-266677,-267277,OK
664.288095,TraderOne,Tick,3750,3752,-2,2,156200,155900,51277,-266677,-267277,OK
664.536043,TraderOne,Tick,3760,3752,8,-8,155700,155800,51121,-267521,-268321,OK
664.708583,TraderOne,Tick,3760,3752,8,-8,155700,155800,51121,-267521,-268321,OK
665.005144,TraderOne,Tick,3760,3752,8,-8,155700,155800,51121,-267521,-268321,OK
665.236399,TraderOne,Tick,3760,3752,8,-8,155700,155900,51121,-267521,-269121,OK
665.456039,TraderOne,Tick,3760,3752,8,-8,155700,155900,51121,-267521,-269121,OK
665.733996,TraderOne,Tick,3760,3752,8,-8,155700,155900,51121,-267521,-269121,OK
665.951763,TraderOne,Tick,3760,3752,8,-8,155700,155900,51121,-267521,-269121,OK
666.269035,TraderOne,Tick,3760,3762,-2,2,156500,155900,50965,-268365,-268965,OK
666.461744,TraderOne,Tick,3760,3762,-2,2,156500,155900,50965,-268365,-268965,OK
666.73761,TraderOne,Tick,3760,3762,-2,2,156500,155900,50965,-268365,-268965,OK
667.037496,TraderOne,Tick,3760,3772,-12,12,156700,156600,50809,-273209,-274409,OK
667.249064,TraderOne,Tick,3770,3772,-2,2,156800,156800,51123,-275523,-275523,OK
667.519529,TraderOne,Tick,3770,3772,-2,2,156800,156800,51123,-275523,-275523,OK
667.764722,TraderOne,Tick,3780,3772,8,-8,156800,156800,51437,-276837,-276837,OK
668.033642,TraderOne,Tick,3780,3772,8,-8,156800,156800,51437,-276837,-276837,OK
668.274536,TraderOne,Tick,3780,3772,8,-8,156800,156400,51437,-276837,-274437,OK
668.4917,TraderOne,Tick,3780,3782,-2,2,156800,156400,51750,-276150,-276750,OK
668.729903,TraderOne,Tick,3780,3792,-12,12,156700,156400,52063,-274463,-278063,OK
669.036025,TraderOne,Tick,3780,3792,-12,12,156700,156400,52063,-274463,-278063,OK
669.238509,TraderOne,Tick,3780,3792,-12,12,156700,156400,52063,-274463,-278063,OK
669.459393,TraderOne,Tick,3780,3792,-12,12,156700,156400,52063,-274463,-278063,OK
669.78328,TraderOne,Tick,3790,3792,-2,2,156100,156400,51906,-277306,-276706,OK
669.991751,TraderOne,Tick,3790,3792,-2,2,156100,156400,51906,-277306,-276706,OK
670.288252,TraderOne,Tick,3790,3792,-2,2,156100,156300,51906,-277306,-276906,OK
670.543185,TraderOne,Tick,3790,3792,-2,2,156100,156400,51906,-277306,-276706,OK
670.723252,TraderOne,Tick,3790,3792,-2,2,156100,156400,51906,-277306,-276706,OK
671.012847,TraderOne,Tick,3790,3792,-2,2,156100,156400,51906,-277306,-276706,OK
671.204242,TraderOne,Tick,3790,3792,-2,2,156100,156400,51906,-277306,-276706,OK
671.549535,TraderOne,Tick,3790,3792,-2,2,156100,156400,51906,-277306,-276706,OK
671.780787,TraderOne,Tick,3790,3792,-2,2,156100,156200,51906,-277306,-277106,OK
671.99518,TraderOne,Tick,3790,3792,-2,2,156100,156200,51906,-277306,-277106,OK
672.218017,TraderOne,Tick,3790,3792,-2,2,156100,156200,51906,-277306,-277106,OK
672.515928,TraderOne,Tick,3790,3792,-2,2,156100,156200,51906,-277306,-277106,OK
672.76463,TraderOne,Tick,3790,3794,-4,4,156700,156200,51875,-277075,-278275,OK
672.992592,TraderOne,Tick,3790,3794,-4,4,156700,156200,51875,-277075,-278275,OK
673.274434,TraderOne,Tick,3790,3794,-4,4,156700,156200,51875,-277075,-278275,OK
673.485319,TraderOne,Tick,3790,3794,-4,4,156700,156200,51875,-277075,-278275,OK
673.743104,TraderOne,Tick,3790,3794,-4,4,156700,156200,51875,-277075,-278275,OK
673.964599,TraderOne,Tick,3800,3794,6,-6,156100,156200,51719,-277919,-278519,OK
674.288441,TraderOne,Tick,3800,3794,6,-6,156100,156200,51719,-277919,-278519,OK
674.531378,TraderOne,Tick,3800,3794,6,-6,156100,156200,51719,-277919,-278519,OK
674.728436,TraderOne,Tick,3800,3794,6,-6,156100,155900,51719,-277919,-276719,OK
674.983726,TraderOne,Tick,3800,3804,-4,4,156200,155800,52031,-276231,-277431,OK
675.260679,TraderOne,Tick,3800,3814,-14,14,156200,155800,52343,-275543,-279743,OK
675.534781,TraderOne,Tick,3800,3814,-14,14,156200,155800,52343,-275543,-279743,OK
675.77636,TraderOne,Tick,3800,3814,-14,14,156200,155800,52343,-275543,-279743,OK
675.999167,TraderOne,Tick,3800,3824,-24,24,156200,155800,52655,-273855,-281055,OK
676.258123,TraderOne,Tick,3800,3824,-24,24,156200,155800,52655,-273855,-281055,OK
676.456752,TraderOne,Tick,3800,3824,-24,24,156200,155800,52655,-273855,-281055,OK
676.763041,TraderOne,Tick,3810,3824,-14,14,155700,155800,52499,-276699,-275299,OK
676.974791,TraderOne,Tick,3820,3824,-4,4,155700,155800,52810,-275010,-274610,OK
677.225729,TraderOne,Tick,3830,3824,6,-6,155700,155800,53121,-273321,-273921,OK
677.516852,TraderOne,Tick,3840,3824,16,-16,155700,155800,53432,-272632,-274232,OK
677.720938,TraderOne,Tick,3850,3824,26,-26,155700,155800,53743,-271943,-274543,OK
677.95584,TraderOne,Tick,3850,3824,26,-26,155700,155900,53743,-271943,-277143,OK
678.225594,TraderOne,Tick,3860,3824,36,-36,155700,155900,54054,-270254,-277454,OK
678.549328,TraderOne,Tick,3860,3824,36,-36,155700,155900,54054,-270254,-277454,OK
678.78364,TraderOne,Tick,3860,3824,36,-36,155600,155900,54054,-270254,-281054,OK
678.985431,TraderOne,Tick,3860,3834,26,-26,155500,155900,54365,-272865,-280665,OK
679.294887,TraderOne,Tick,3860,3834,26,-26,155500,155700,54365,-272865,-278065,OK
679.500755,TraderOne,Tick,3860,3844,16,-16,155700,155700,54676,-275176,-275176,OK
679.734852,TraderOne,Tick,3860,3844,16,-16,155700,155700,54676,-275176,-275176,OK
679.982808,TraderOne,Tick,3860,3844,16,-16,155700,155700,54676,-275176,-275176,OK
680.268786,TraderOne,Tick,3860,3854,6,-6,155700,155700,54520,-276020,-276020,OK
680.520051,TraderOne,Tick,3870,3864,6,-6,155500,155600,54676,-274176,-274776,OK
680.766828,TraderOne,Tick,3870,3864,6,-6,155500,155600,54676,-274176,-274776,OK
681.027575,TraderOne,Tick,3870,3864,6,-6,155500,155600,54676,-274176,-274776,OK
681.222847,TraderOne,Tick,3870,3864,6,-6,155500,155600,54676,-274176,-274776,OK
681.528279,TraderOne,Tick,3870,3864,6,-6,155500,155600,54676,-274176,-274776,OK
681.702251,TraderOne,Tick,3870,3870,0,0,155700,155600,54583,-274083,-274083,OK
681.998232,TraderOne,Tick,3870,3870,0,0,155700,155600,54583,-274083,-274083,OK
682.214454,TraderOne,Tick,3870,3870,0,0,155700,155700,54583,-274083,-274083,OK
682.454688,TraderOne,Tick,3870,3870,0,0,155700,155700,54583,-274083,-274083,OK
682.79024,TraderOne,Tick,3870,3880,-10,10,156200,155400,54427,-270927,-273927,OK
682.96056,TraderOne,Tick,3870,3880,-10,10,156200,155400,54427,-270927,-273927,OK
683.212882,TraderOne,Tick,3870,3880,-10,10,156200,155400,54427,-270927,-273927,OK
683.535515,TraderOne,Tick,3870,3880,-10,10,156200,155400,54427,-270927,-273927,OK
683.768414,TraderOne,Tick,3870,3880,-10,10,156200,155400,54427,-270927,-273927,OK
683.974691,TraderOne,Tick,3870,3880,-10,10,156200,155400,54427,-270927,-273927,OK
684.289511,TraderOne,Tick,3870,3890,-20,20,155300,155400,54271,-269771,-267771,OK
684.471096,TraderOne,Tick,3870,3890,-20,20,155300,155400,54271,-269771,-267771,OK
684.738821,TraderOne,Tick,3870,3890,-20,20,155300,155400,54271,-269771,-267771,OK
685.008522,TraderOne,Tick,3870,3890,-20,20,155300,155400,54271,-269771,-267771,OK
685.236442,TraderOne,Tick,3870,3890,-20,20,155300,155400,54271,-269771,-267771,OK
685.4655,TraderOne,Tick,3870,3890,-20,20,155300,155400,54271,-269771,-267771,OK
685.718273,TraderOne,Tick,3880,3890,-10,10,155600,155400,54582,-272082,-274082,OK
686.020859,TraderOne,Tick,3880,3890,-10,10,155600,155600,54582,-272082,-272082,OK
686.265913,TraderOne,Tick,3890,3890,0,0,155600,155600,54893,-272393,-272393,OK
686.521708,TraderOne,Tick,3900,3890,10,-10,155600,155600,55204,-272704,-272704,OK
686.784975,TraderOne,Tick,3900,3900,0,0,155700,155600,55048,-272548,-272548,OK
686.983977,TraderOne,Tick,3900,3900,0,0,155700,155600,55048,-272548,-272548,OK
687.257377,TraderOne,Tick,3900,3900,0,0,155700,155600,55048,-272548,-272548,OK
687.477485,TraderOne,Tick,3900,3900,0,0,155700,155200,55048,-272548,-272548,OK
687.785296,TraderOne,Tick,3900,3910,-10,10,155300,155200,55359,-271859,-272859,OK
688.005755,TraderOne,Tick,3900,3920,-20,20,155300,155000,55670,-270170,-276170,OK
688.233905,TraderOne,Tick,3900,3920,-20,20,155300,155000,55670,-270170,-276170,OK
688.489404,TraderOne,Tick,3900,3930,-30,30,155200,155000,55980,-268480,-274480,OK
688.783505,TraderOne,Tick,3900,3930,-30,30,155200,155000,55980,-268480,-274480,OK
689.024555,TraderOne,Tick,3900,3930,-30,30,155200,155000,55980,-268480,-274480,OK
689.288571,TraderOne,Tick,3900,3930,-30,30,155200,155000,55980,-268480,-274480,OK
689.52217,TraderOne,Tick,3900,3940,-40,40,155300,155000,55825,-265325,-277325,OK
689.710154,TraderOne,Tick,3900,3940,-40,40,155300,155000,55825,-265325,-277325,OK
689.986149,TraderOne,Tick,3900,3940,-40,40,155300,155000,55825,-265325,-277325,OK
690.252488,TraderOne,Tick,3900,3940,-40,40,155300,155100,55825,-265325,-273325,OK
690.531348,TraderOne,Tick,3900,3940,-40,40,155300,155200,55825,-265325,-269325,OK
690.743062,TraderOne,Tick,3900,3940,-40,40,155300,155200,55825,-265325,-269325,OK
690.966934,TraderOne,Tick,3900,3940,-40,40,155300,155200,55825,-265325,-269325,OK
691.264293,TraderOne,Tick,3900,3940,-40,40,155300,155200,55825,-265325,-269325,OK
691.466622,TraderOne,Tick,3900,3940,-40,40,155300,155200,55825,-265325,-269325,OK
691.783203,TraderOne,Tick,3900,3940,-40,40,155300,155200,55825,-265325,-269325,OK
692.025772,TraderOne,Tick,3910,3940,-30,30,155200,155200,55669,-270169,-270169,OK
692.257031,TraderOne,Tick,3910,3940,-30,30,155200,155200,55669,-270169,-270169,OK
692.506951,TraderOne,Tick,3910,3940,-30,30,155200,155200,55669,-270169,-270169,OK
692.721728,TraderOne,Tick,3920,3950,-30,30,155500,155200,55358,-269858,-278858,OK
692.951174,TraderOne,Tick,3920,3950,-30,30,155500,155200,55358,-269858,-278858,OK
693.243482,TraderOne,Tick,3920,3960,-40,40,155500,155200,55669,-267169,-279169,OK
693.466369,TraderOne,Tick,3920,3960,-40,40,155500,155200,55669,-267169,-279169,OK
693.759102,TraderOne,Tick,3930,3960,-30,30,155200,155100,55513,-272013,-275013,OK
694.007512,TraderOne,Tick,3930,3960,-30,30,155200,155100,55513,-272013,-275013,OK
694.225384,TraderOne,Tick,3930,3960,-30,30,155200,155100,55513,-272013,-275013,OK
694.526899,TraderOne,Tick,3930,3960,-30,30,155200,155100,55513,-272013,-275013,OK
694.735903,TraderOne,Tick,3930,3960,-30,30,155200,155100,55513,-272013,-275013,OK
695.027257,TraderOne,Tick,3930,3960,-30,30,155200,155100,55513,-272013,-275013,OK
695.21096,TraderOne,Tick,3930,3960,-30,30,155200,155100,55513,-272013,-275013,OK
695.499864,TraderOne,Tick,3930,3960,-30,30,155200,155100,55513,-272013,-275013,OK
695.71641,TraderOne,Tick,3940,3960,-20,20,155200,155100,55358,-274858,-276858,OK
696.017278,TraderOne,Tick,3940,3960,-20,20,155200,155100,55358,-274858,-276858,OK
696.257854,TraderOne,Tick,3940,3960,-20,20,155200,155100,55358,-274858,-276858,OK
696.471464,TraderOne,Tick,3940,3960,-20,20,155200,155100,55358,-274858,-276858,OK
696.75539,TraderOne,Tick,3950,3960,-10,10,155100,155100,55203,-274703,-274703,OK
697.046145,TraderOne,Tick,3960,3960,0,0,155100,155100,55047,-276547,-276547,OK
697.269676,TraderOne,Tick,3960,3960,0,0,155100,155600,55047,-276547,-276547,OK
697.456515,TraderOne,Tick,3960,3960,0,0,155100,155600,55047,-276547,-276547,OK
697.745201,TraderOne,Tick,3960,3960,0,0,155100,155700,55047,-276547,-276547,OK
698.043884,TraderOne,Tick,3970,3970,0,0,156000,155700,55202,-276702,-276702,OK
698.258524,TraderOne,Tick,3970,3970,0,0,156000,155700,55202,-276702,-276702,OK
698.451741,TraderOne,Tick,3970,3970,0,0,156000,155700,55202,-276702,-276702,OK
698.702,TraderOne,Tick,3970,3970,0,0,156000,155700,55202,-276702,-276702,OK
698.957335,TraderOne,Tick,3980,3970,10,-10,155100,155700,55046,-276546,-279546,OK
699.200443,TraderOne,Tick,3980,3970,10,-10,155100,155700,55046,-276546,-279546,OK
699.543863,TraderOne,Tick,3980,3970,10,-10,155100,155700,55046,-276546,-279546,OK
699.707721,TraderOne,Tick,3980,3970,10,-10,155100,155700,55046,-276546,-279546,OK
699.994004,TraderOne,Tick,3980,3970,10,-10,155100,155700,55046,-276546,-279546,OK
700.234884,TraderOne,Tick,3980,3970,10,-10,155100,155700,55046,-276546,-279546,OK
700.517579,TraderOne,Tick,3980,3980,0,0,155300,155700,54891,-277391,-277391,OK
700.796921,TraderOne,Tick,3980,3990,-10,10,155900,155700,54875,-276475,-278475,OK
701.04609,TraderOne,Tick,3980,3990,-10,10,155900,155700,54875,-276475,-278475,OK
701.205923,TraderOne,Tick,3980,3997,-17,17,155500,155200,54766,-275666,-280766,OK
701.534588,TraderOne,Tick,3980,3997,-17,17,155500,155200,54766,-275666,-280766,OK
701.760101,TraderOne,Tick,3980,3997,-17,17,155500,155200,54766,-275666,-280766,OK
702.038387,TraderOne,Tick,3980,4007,-27,27,155600,155200,54611,-274511,-282611,OK
702.237759,TraderOne,Tick,3980,4007,-27,27,155600,155200,54611,-274511,-282611,OK
702.475957,TraderOne,Tick,3990,4007,-17,17,155100,155200,54456,-277356,-275656,OK
702.772054,TraderOne,Tick,3990,4007,-17,17,155100,155200,54456,-277356,-275656,OK
703.031059,TraderOne,Tick,3990,4007,-17,17,155100,155200,54456,-277356,-275656,OK
703.225242,TraderOne,Tick,3990,4007,-17,17,155100,155200,54456,-277356,-275656,OK
703.474793,TraderOne,Tick,3990,4007,-17,17,155100,155200,54456,-277356,-275656,OK
703.745201,TraderOne,Tick,3990,4007,-17,17,155100,155200,54456,-277356,-275656,OK
704.045673,TraderOne,Tick,3990,4012,-22,22,155400,155200,54611,-276011,-280411,OK
704.248281,TraderOne,Tick,4000,4012,-12,12,154900,155200,54456,-278856,-275256,OK
704.500205,TraderOne,Tick,4000,4012,-12,12,154900,155000,54456,-278856,-277656,OK
704.75152,TraderOne,Tick,4000,4014,-14,14,155300,155000,54425,-278425,-282625,OK
704.994117,TraderOne,Tick,4000,4014,-14,14,155300,155000,54425,-278425,-282625,OK
705.246242,TraderOne,Tick,4000,4014,-14,14,155300,155000,54425,-278425,-282625,OK
705.458957,TraderOne,Tick,4000,4014,-14,14,155300,155000,54425,-278425,-282625,OK
705.749493,TraderOne,Tick,4000,4014,-14,14,155300,155000,54425,-278425,-282625,OK
706.008474,TraderOne,Tick,4000,4014,-14,14,155300,154800,54425,-278425,-282625,OK
706.272417,TraderOne,Tick,4000,4014,-14,14,154900,154800,54425,-278425,-279825,OK
706.453968,TraderOne,Tick,4000,4014,-14,14,154900,154800,54425,-278425,-279825,OK
706.735387,TraderOne,Tick,4000,4014,-14,14,154900,154600,54425,-278425,-282625,OK
706.975716,TraderOne,Tick,4000,4024,-24,24,154800,154600,54735,-278435,-283235,OK
707.261626,TraderOne,Tick,4000,4024,-24,24,154800,154600,54735,-278435,-283235,OK
707.492427,TraderOne,Tick,4000,4024,-24,24,154800,154500,54735,-278435,-285635,OK
707.740959,TraderOne,Tick,4000,4024,-24,24,154800,154700,54735,-278435,-280835,OK
708.005663,TraderOne,Tick,4000,4032,-32,32,155200,154700,54611,-275911,-285511,OK
708.290025,TraderOne,Tick,4010,4032,-22,22,154800,154700,54456,-279756,-281956,OK
708.489705,TraderOne,Tick,4018,4032,-14,14,155100,154700,54332,-282832,-287032,OK
708.771864,TraderOne,Tick,4018,4032,-14,14,155100,154600,54332,-282832,-287032,OK
708.989751,TraderOne,Tick,4018,4032,-14,14,155100,154600,54332,-282832,-287032,OK
709.214654,TraderOne,Tick,4018,4042,-24,24,154800,154600,54642,-281142,-285942,OK
709.500692,TraderOne,Tick,4018,4042,-24,24,154800,154600,54642,-281142,-285942,OK
709.79143,TraderOne,Tick,4018,4042,-24,24,154800,154500,54642,-281142,-288342,OK
709.979981,TraderOne,Tick,4018,4042,-24,24,154800,154500,54642,-281142,-288342,OK
710.253915,TraderOne,Tick,4018,4042,-24,24,154800,154500,54642,-281142,-288342,OK
710.470604,TraderOne,Tick,4018,4042,-24,24,154800,154500,54642,-281142,-288342,OK
710.788258,TraderOne,Tick,4018,4042,-24,24,154800,154500,54642,-281142,-288342,OK
710.96781,TraderOne,Tick,4018,4052,-34,34,154800,154500,54952,-278452,-288652,OK
711.240517,TraderOne,Tick,4018,4062,-44,44,155000,154400,54797,-274297,-287497,OK
711.461191,TraderOne,Tick,4018,4062,-44,44,154800,154400,54797,-274297,-287497,OK
711.763801,TraderOne,Tick,4018,4062,-44,44,154800,154400,54797,-274297,-287497,OK
712.00409,TraderOne,Tick,4018,4072,-54,54,155000,154400,54642,-268142,-284342,OK
712.298676,TraderOne,Tick,4018,4072,-54,54,154900,154400,54642,-268142,-284342,OK
712.547345,TraderOne,Tick,4028,4072,-44,44,154900,154400,54952,-274452,-287652,OK
712.701473,TraderOne,Tick,4028,4072,-44,44,154900,154400,54952,-274452,-287652,OK
712.982698,TraderOne,Tick,4028,4072,-44,44,154800,154400,54952,-274452,-287652,OK
713.254552,TraderOne,Tick,4028,4072,-44,44,154800,154400,54952,-274452,-287652,OK
713.531782,TraderOne,Tick,4038,4072,-34,34,154800,154400,55262,-279762,-289962,OK
713.746587,TraderOne,Tick,4038,4072,-34,34,154800,154400,55262,-279762,-289962,OK
714.040835,TraderOne,Tick,4038,4072,-34,34,154800,154200,55262,-279762,-289962,OK
714.24338,TraderOne,Tick,4038,4082,-44,44,154700,154200,55572,-274372,-287572,OK
714.501967,TraderOne,Tick,4038,4092,-54,54,154700,154000,55881,-269681,-285881,OK
714.774496,TraderOne,Tick,4048,4092,-44,44,154500,153800,55726,-277526,-290726,OK
714.996624,TraderOne,Tick,4048,4092,-44,44,154500,154000,55726,-277526,-290726,OK
715.262241,TraderOne,Tick,4048,4092,-44,44,154500,154100,55726,-277526,-290726,OK
715.548533,TraderOne,Tick,4048,4092,-44,44,154500,153900,55726,-277526,-290726,OK
715.780416,TraderOne,Tick,4048,4092,-44,44,154500,153900,55726,-277526,-290726,OK
716.019746,TraderOne,Tick,4048,4092,-44,44,154400,153900,55726,-277526,-290726,OK
716.249879,TraderOne,Tick,4048,4092,-44,44,154400,153800,55726,-277526,-290726,OK
716.541075,TraderOne,Tick,4048,4102,-54,54,154400,153900,56035,-272835,-289035,OK
716.725999,TraderOne,Tick,4058,4102,-44,44,154500,153900,55881,-279681,-292881,OK
716.960122,TraderOne,Tick,4058,4102,-44,44,154400,153900,55881,-279681,-292881,OK
717.237263,TraderOne,Tick,4058,4102,-44,44,154400,153900,55881,-279681,-292881,OK
717.535519,TraderOne,Tick,4058,4102,-44,44,154400,153700,55881,-279681,-292881,OK
717.761615,TraderOne,Tick,4058,4112,-54,54,154400,153700,56190,-274990,-291190,OK
718.030501,TraderOne,Tick,4068,4112,-44,44,154200,153700,56036,-281836,-295036,OK
718.282513,TraderOne,Tick,4068,4112,-44,44,154200,153700,56036,-281836,-295036,OK
718.530219,TraderOne,Tick,4068,4112,-44,44,154200,153700,56036,-281836,-295036,OK
718.766973,TraderOne,Tick,4068,4112,-44,44,154200,153600,56036,-281836,-295036,OK
719.014524,TraderOne,Tick,4068,4112,-44,44,154200,153600,56036,-281836,-295036,OK
719.225057,TraderOne,Tick,4068,4112,-44,44,154200,153600,56036,-281836,-295036,OK
719.545498,TraderOne,Tick,4068,4122,-54,54,154300,153600,55882,-276682,-292882,OK
719.764163,TraderOne,Tick,4068,4122,-54,54,154300,153800,55882,-276682,-292882,OK
720.049763,TraderOne,Tick,4078,4122,-44,44,154100,153800,56191,-282991,-296191,OK
720.265095,TraderOne,Tick,4088,4122,-34,34,154200,153700,56037,-288837,-299037,OK
720.543385,TraderOne,Tick,4088,4132,-44,44,154100,153700,56345,-285145,-298345,OK
720.760031,TraderOne,Tick,4088,4132,-44,44,154100,153700,56345,-285145,-298345,OK
721.035122,TraderOne,Tick,4088,4132,-44,44,154100,153700,56345,-285145,-298345,OK
721.247815,TraderOne,Tick,4088,4132,-44,44,154000,153700,56345,-285145,-298345,OK
721.505137,TraderOne,Tick,4088,4132,-44,44,154000,153700,56345,-285145,-298345,OK
721.758556,TraderOne,Tick,4088,4132,-44,44,154000,153700,56345,-285145,-298345,OK
722.044149,TraderOne,Tick,4088,4132,-44,44,154000,153700,56345,-285145,-298345,OK
722.248212,TraderOne,Tick,4088,4132,-44,44,154000,153700,56345,-285145,-298345,OK
722.52033,TraderOne,Tick,4088,4132,-44,44,154000,153700,56345,-285145,-298345,OK
722.794994,TraderOne,Tick,4088,4142,-54,54,154000,153700,56653,-280453,-296653,OK
722.968205,TraderOne,Tick,4098,4142,-44,44,154000,153700,56961,-286761,-299961,OK
723.205248,TraderOne,Tick,4098,4142,-44,44,154100,153700,56961,-286761,-299961,OK
723.497303,TraderOne,Tick,4098,4142,-44,44,154100,153700,56961,-286761,-299961,OK
723.715162,TraderOne,Tick,4098,4142,-44,44,154100,153700,56961,-286761,-299961,OK
723.961958,TraderOne,Tick,4108,4142,-34,34,153700,153000,56807,-295607,-305807,OK
724.246336,TraderOne,Tick,4108,4142,-34,34,153700,153000,56807,-295607,-305807,OK
724.457447,TraderOne,Tick,4108,4152,-44,44,153500,153000,57114,-291914,-305114,OK
724.798077,TraderOne,Tick,4108,4152,-44,44,153500,153000,57114,-291914,-305114,OK
724.99404,TraderOne,Tick,4108,4152,-44,44,153500,152900,57114,-291914,-305114,OK
725.265099,TraderOne,Tick,4108,4162,-54,54,153400,152800,57421,-286221,-302421,OK
725.47424,TraderOne,Tick,4108,4162,-54,54,153400,152800,57421,-286221,-302421,OK
725.788421,TraderOne,Tick,4118,4162,-44,44,153100,152800,57728,-292528,-305728,OK
726.032028,TraderOne,Tick,4118,4162,-44,44,153100,152800,57728,-292528,-305728,OK
726.260786,TraderOne,Tick,4128,4162,-34,34,153300,152600,57575,-300375,-310575,OK
726.473701,TraderOne,Tick,4128,4172,-44,44,153100,152700,57881,-296681,-309881,OK
726.7191,TraderOne,Tick,4128,4172,-44,44,153100,152700,57881,-296681,-309881,OK
726.977543,TraderOne,Tick,4128,4172,-44,44,153100,152700,57881,-296681,-309881,OK
727.20181,TraderOne,Tick,4128,4172,-44,44,153100,152700,57881,-296681,-309881,OK
727.488605,TraderOne,Tick,4128,4172,-44,44,153100,152700,57881,-296681,-309881,OK
727.771981,TraderOne,Tick,4128,4172,-44,44,153500,152700,57881,-296681,-309881,OK
728.030157,TraderOne,Tick,4138,4172,-34,34,153000,152700,57728,-301528,-311728,OK
728.229643,TraderOne,Tick,4138,4172,-34,34,153000,152700,57728,-301528,-311728,OK
728.526146,TraderOne,Tick,4138,4172,-34,34,153000,152700,57728,-301528,-311728,OK
728.787726,TraderOne,Tick,4138,4172,-34,34,153000,152700,57728,-301528,-311728,OK
729.048713,TraderOne,Tick,4138,4172,-34,34,153000,152700,57728,-301528,-311728,OK
729.290278,TraderOne,Tick,4148,4172,-24,24,153000,152700,57575,-305375,-312575,OK
729.475953,TraderOne,Tick,4148,4172,-24,24,153000,152700,57575,-305375,-312575,OK
729.75647,TraderOne,Tick,4148,4175,-27,27,153200,152700,57529,-304729,-312829,OK
729.976137,TraderOne,Tick,4148,4175,-27,27,153200,152700,57529,-304729,-312829,OK
730.248583,TraderOne,Tick,4148,4175,-27,27,153200,152700,57529,-304729,-312829,OK
730.461754,TraderOne,Tick,4148,4175,-27,27,153200,152700,57529,-304729,-312829,OK
730.756423,TraderOne,Tick,4148,4175,-27,27,153200,152900,57529,-304729,-312829,OK
730.969054,TraderOne,Tick,4148,4175,-27,27,153200,152900,57529,-304729,-312829,OK
731.220966,TraderOne,Tick,4148,4175,-27,27,153200,152900,57529,-304729,-312829,OK
731.53515,TraderOne,Tick,4158,4175,-17,17,153100,152900,57376,-306576,-309976,OK
731.774444,TraderOne,Tick,4158,4175,-17,17,153100,152900,57376,-306576,-309976,OK
732.026887,TraderOne,Tick,4168,4175,-7,7,153100,152900,57682,-307882,-309282,OK
732.273755,TraderOne,Tick,4168,4175,-7,7,153100,152900,57682,-307882,-309282,OK
732.507919,TraderOne,Tick,4168,4175,-7,7,153100,152900,57682,-307882,-309282,OK
732.733915,TraderOne,Tick,4168,4175,-7,7,153100,152900,57682,-307882,-309282,OK
732.951622,TraderOne,Tick,4168,4175,-7,7,153100,152900,57682,-307882,-309282,OK
733.228943,TraderOne,Tick,4168,4175,-7,7,153100,152900,57682,-307882,-309282,OK
733.46628,TraderOne,Tick,4168,4175,-7,7,153100,152900,57682,-307882,-309282,OK
733.791157,TraderOne,Tick,4168,4175,-7,7,153100,152900,57682,-307882,-309282,OK
733.985606,TraderOne,Tick,4168,4175,-7,7,153100,152900,57682,-307882,-309282,OK
734.297089,TraderOne,Tick,4168,4175,-7,7,153100,152800,57682,-307882,-309982,OK
734.506251,TraderOne,Tick,4168,4175,-7,7,153100,152800,57682,-307882,-309982,OK
734.728955,TraderOne,Tick,4168,4175,-7,7,153100,152800,57682,-307882,-309982,OK
734.986901,TraderOne,Tick,4168,4175,-7,7,153100,152800,57682,-307882,-309982,OK
735.278131,TraderOne,Tick,4168,4175,-7,7,153100,153100,57682,-307882,-307882,OK
735.471313,TraderOne,Tick,4168,4185,-17,17,153600,152900,57529,-306729,-311829,OK
735.738554,TraderOne,Tick,4178,4185,-7,7,153000,152900,57376,-308576,-309276,OK
736.023959,TraderOne,Tick,4178,4185,-7,7,153000,152800,57376,-308576,-309976,OK
736.221082,TraderOne,Tick,4178,4195,-17,17,153000,152600,57682,-304882,-309982,OK
736.472822,TraderOne,Tick,4178,4205,-27,27,153000,152600,57988,-302188,-310288,OK
736.719239,TraderOne,Tick,4178,4215,-37,37,152800,152500,58294,-299494,-310594,OK
737.043482,TraderOne,Tick,4188,4215,-27,27,152800,152500,58141,-303341,-311441,OK
737.234183,TraderOne,Tick,4188,4215,-27,27,152800,152500,58141,-303341,-311441,OK
737.511282,TraderOne,Tick,4188,4215,-27,27,152800,152500,58141,-303341,-311441,OK
737.765512,TraderOne,Tick,4188,4215,-27,27,152800,152500,58141,-303341,-311441,OK
737.955258,TraderOne,Tick,4188,4225,-37,37,153200,152500,57988,-301188,-312288,OK
738.241423,TraderOne,Tick,4188,4225,-37,37,153200,152500,57988,-301188,-312288,OK
738.537415,TraderOne,Tick,4198,4225,-27,27,152700,152500,57835,-305035,-310435,OK
738.720208,TraderOne,Tick,4198,4225,-27,27,152700,152500,57835,-305035,-310435,OK
739.008562,TraderOne,Tick,4198,4235,-37,37,152700,152500,58140,-302340,-309740,OK
739.267143,TraderOne,Tick,4198,4235,-37,37,152700,152100,58140,-302340,-313440,OK
739.526063,TraderOne,Tick,4198,4235,-37,37,152700,152100,58140,-302340,-313440,OK
739.758552,TraderOne,Tick,4198,4235,-37,37,152600,152100,58140,-302340,-313440,OK
740.016663,TraderOne,Tick,4198,4235,-37,37,152600,152100,58140,-302340,-313440,OK
740.223586,TraderOne,Tick,4198,4235,-37,37,152600,152100,58140,-302340,-313440,OK
740.458797,TraderOne,Tick,4198,4235,-37,37,152600,152400,58140,-302340,-309740,OK
740.800119,TraderOne,Tick,4198,4235,-37,37,152600,152500,58140,-302340,-306040,OK
740.981517,TraderOne,Tick,4198,4235,-37,37,152600,152500,58140,-302340,-306040,OK
741.202614,TraderOne,Tick,4198,4235,-37,37,152600,152500,58140,-302340,-306040,OK
741.521959,TraderOne,Tick,4198,4235,-37,37,152600,152000,58140,-302340,-313440,OK
741.761476,TraderOne,Tick,4198,4235,-37,37,152600,151900,58140,-302340,-313440,OK
742.045979,TraderOne,Tick,4198,4235,-37,37,152600,151800,58140,-302340,-313440,OK
742.276276,TraderOne,Tick,4198,4235,-37,37,152600,151800,58140,-302340,-313440,OK
742.494362,TraderOne,Tick,4198,4235,-37,37,152600,151700,58140,-302340,-313440,OK
742.738215,TraderOne,Tick,4198,4235,-37,37,152600,151700,58140,-302340,-313440,OK
743.042163,TraderOne,Tick,4198,4235,-37,37,152600,151700,58140,-302340,-313440,OK
743.242083,TraderOne,Tick,4198,4235,-37,37,152600,151700,58140,-302340,-313440,OK
743.500996,TraderOne,Tick,4198,4235,-37,37,152600,151900,58140,-302340,-313440,OK
743.743655,TraderOne,Tick,4198,4235,-37,37,152600,151900,58140,-302340,-313440,OK
743.994016,TraderOne,Tick,4198,4235,-37,37,152600,151900,58140,-302340,-313440,OK
744.274772,TraderOne,Tick,4198,4235,-37,37,152600,151900,58140,-302340,-313440,OK
744.513046,TraderOne,Tick,4198,4235,-37,37,152600,151900,58140,-302340,-313440,OK
744.708804,TraderOne,Tick,4198,4235,-37,37,152600,151900,58140,-302340,-313440,OK
745.046105,TraderOne,Tick,4198,4235,-37,37,152600,151900,58140,-302340,-313440,OK
745.257856,TraderOne,Tick,4198,4235,-37,37,152600,151900,58140,-302340,-313440,OK
745.472465,TraderOne,Tick,4198,4235,-37,37,152600,151900,58140,-302340,-313440,OK
745.770898,TraderOne,Tick,4208,4235,-27,27,152200,151900,57988,-306188,-314288,OK
746.021832,TraderOne,Tick,4208,4235,-27,27,152200,151900,57988,-306188,-314288,OK
746.214071,TraderOne,Tick,4208,4235,-27,27,152200,151800,57988,-306188,-314288,OK
746.512019,TraderOne,Tick,4208,4235,-27,27,152200,151800,57988,-306188,-314288,OK
746.723459,TraderOne,Tick,4208,4235,-27,27,152200,151900,57988,-306188,-314288,OK
746.972162,TraderOne,Tick,4208,4235,-27,27,152200,151900,57988,-306188,-314288,OK
747.281192,TraderOne,Tick,4208,4245,-37,37,152100,151700,58292,-303492,-314592,OK
747.485553,TraderOne,Tick,4208,4245,-37,37,152100,151700,58292,-303492,-314592,OK
747.754885,TraderOne,Tick,4208,4255,-47,47,152200,151700,58596,-299796,-313896,OK
748.050998,TraderOne,Tick,4208,4255,-47,47,152000,151700,58596,-299796,-313896,OK
748.255684,TraderOne,Tick,4208,4255,-47,47,152000,151700,58596,-299796,-313896,OK
748.532692,TraderOne,Tick,4208,4255,-47,47,152000,151700,58596,-299796,-313896,OK
748.721872,TraderOne,Tick,4208,4255,-47,47,152000,151700,58596,-299796,-313896,OK
748.986166,TraderOne,Tick,4218,4255,-37,37,152000,151700,58444,-303644,-314744,OK
749.270813,TraderOne,Tick,4218,4255,-37,37,152000,151700,58444,-303644,-314744,OK
749.539871,TraderOne,Tick,4228,4255,-27,27,151500,151700,58292,-308492,-303092,OK
749.710995,TraderOne,Tick,4238,4255,-17,17,151400,151700,58595,-306795,-301695,OK
750.035168,TraderOne,Tick,4248,4255,-7,7,151400,151700,58898,-305098,-302998,OK
750.283316,TraderOne,Tick,4258,4255,3,-3,151400,151700,59201,-304401,-305301,OK
750.487459,TraderOne,Tick,4259,4255,4,-4,151400,151700,59231,-304331,-305531,OK
750.788099,TraderOne,Tick,4268,4255,13,-13,151000,151500,59095,-304195,-308095,OK
751.029709,TraderOne,Tick,4268,4255,13,-13,151000,151500,59095,-304195,-308095,OK
751.207379,TraderOne,Tick,4268,4255,13,-13,151000,151500,59095,-304195,-308095,OK
751.457753,TraderOne,Tick,4268,4255,13,-13,151000,151500,59095,-304195,-308095,OK
751.725346,TraderOne,Tick,4268,4255,13,-13,151000,151500,59095,-304195,-308095,OK
751.952039,TraderOne,Tick,4268,4255,13,-13,151000,151500,59095,-304195,-308095,OK
752.207266,TraderOne,Tick,4268,4255,13,-13,151000,151500,59095,-304195,-308095,OK
752.510792,TraderOne,Tick,4268,4255,13,-13,151000,151700,59095,-304195,-308095,OK
752.71867,TraderOne,Tick,4268,4255,13,-13,151000,151700,59095,-304195,-308095,OK
753.049749,TraderOne,Tick,4268,4255,13,-13,151000,151000,59095,-304195,-304195,OK
753.24341,TraderOne,Tick,4268,4255,13,-13,151000,151000,59095,-304195,-304195,OK
753.523686,TraderOne,Tick,4268,4257,11,-11,151000,151000,59155,-304455,-304455,OK
753.705557,TraderOne,Tick,4268,4257,11,-11,151000,151000,59155,-304455,-304455,OK
753.999191,TraderOne,Tick,4268,4257,11,-11,151000,151100,59155,-304455,-305555,OK
754.23366,TraderOne,Tick,4268,4257,11,-11,151000,151100,59155,-304455,-305555,OK
754.481534,TraderOne,Tick,4268,4257,11,-11,151000,151100,59155,-304455,-305555,OK
754.743962,TraderOne,Tick,4268,4257,11,-11,151000,151100,59155,-304455,-305555,OK
754.958837,TraderOne,Tick,4268,4257,11,-11,151000,151100,59155,-304455,-305555,OK
755.298204,TraderOne,Tick,4268,4257,11,-11,151000,151100,59155,-304455,-305555,OK
755.503066,TraderOne,Tick,4268,4257,11,-11,151000,151200,59155,-304455,-306655,OK
755.775684,TraderOne,Tick,4278,4257,21,-21,150800,151200,59004,-304304,-310604,OK
756.044769,TraderOne,Tick,4278,4257,21,-21,150800,151200,59004,-304304,-310604,OK
756.283231,TraderOne,Tick,4278,4264,14,-14,151300,151300,58898,-304898,-304898,OK
756.53871,TraderOne,Tick,4278,4264,14,-14,151300,151100,58898,-304898,-302098,OK
756.73091,TraderOne,Tick,4278,4264,14,-14,151300,151100,58898,-304898,-302098,OK
756.997325,TraderOne,Tick,4278,4274,4,-4,151900,151100,58747,-306747,-305547,OK
757.217468,TraderOne,Tick,4278,4274,4,-4,151900,151100,58747,-306747,-305547,OK
757.54933,TraderOne,Tick,4278,4274,4,-4,151900,151100,58747,-306747,-305547,OK
757.781719,TraderOne,Tick,4278,4274,4,-4,151900,151100,58747,-306747,-305547,OK
758.000353,TraderOne,Tick,4278,4274,4,-4,151900,151100,58747,-306747,-305547,OK
758.245057,TraderOne,Tick,4278,4284,-6,6,151900,151100,58596,-306596,-308396,OK
758.517582,TraderOne,Tick,4278,4284,-6,6,151900,151100,58596,-306596,-308396,OK
758.708137,TraderOne,Tick,4278,4284,-6,6,151900,151400,58596,-306596,-308396,OK
758.987253,TraderOne,Tick,4278,4284,-6,6,151900,151500,58596,-306596,-308396,OK
759.290314,TraderOne,Tick,4278,4284,-6,6,151900,151500,58596,-306596,-308396,OK
759.511557,TraderOne,Tick,4278,4284,-6,6,151900,151500,58596,-306596,-308396,OK
759.734173,TraderOne,Tick,4278,4284,-6,6,151900,151500,58596,-306596,-308396,OK
759.956048,TraderOne,Tick,4278,4294,-16,16,151800,151500,58445,-305445,-310245,OK
760.288012,TraderOne,Tick,4278,4294,-16,16,151800,151500,58445,-305445,-310245,OK
760.523026,TraderOne,Tick,4288,4294,-6,6,150900,151500,58294,-307294,-305494,OK
760.712537,TraderOne,Tick,4288,4294,-6,6,150900,151500,58294,-307294,-305494,OK
760.98711,TraderOne,Tick,4288,4294,-6,6,150900,151500,58294,-307294,-305494,OK
761.220642,TraderOne,Tick,4288,4294,-6,6,150900,151300,58294,-307294,-305494,OK
761.525387,TraderOne,Tick,4288,4294,-6,6,150900,151300,58294,-307294,-305494,OK
761.742337,TraderOne,Tick,4288,4304,-16,16,151800,151300,58142,-306142,-310942,OK
762.005139,TraderOne,Tick,4288,4314,-26,26,151800,151300,57990,-302990,-310790,OK
762.243002,TraderOne,Tick,4288,4314,-26,26,151800,151000,57990,-302990,-310790,OK
762.499261,TraderOne,Tick,4298,4324,-26,26,151600,151000,57688,-302688,-310488,OK
762.786352,TraderOne,Tick,4298,4324,-26,26,151600,151100,57688,-302688,-310488,OK
763.015115,TraderOne,Tick,4298,4324,-26,26,151600,151000,57688,-302688,-310488,OK
763.217134,TraderOne,Tick,4298,4324,-26,26,151600,151000,57688,-302688,-310488,OK
763.459353,TraderOne,Tick,4298,4324,-26,26,151600,151000,57688,-302688,-310488,OK
763.745274,TraderOne,Tick,4308,4324,-16,16,150800,150900,57537,-305537,-303937,OK
764.043418,TraderOne,Tick,4308,4324,-16,16,150800,150900,57537,-305537,-303937,OK
764.281324,TraderOne,Tick,4308,4324,-16,16,150800,150900,57537,-305537,-303937,OK
764.520243,TraderOne,Tick,4315,4324,-9,9,150900,150900,57431,-306831,-306831,OK
764.759722,TraderOne,Tick,4315,4324,-9,9,150800,150900,57431,-306831,-305931,OK
764.991255,TraderOne,Tick,4315,4324,-9,9,150800,150900,57431,-306831,-305931,OK
765.245304,TraderOne,Tick,4325,4324,1,-1,150800,150900,57733,-308133,-308233,OK
765.54127,TraderOne,Tick,4326,4324,2,-2,150800,150900,57763,-308163,-308363,OK
765.76729,TraderOne,Tick,4326,4324,2,-2,150800,150900,57763,-308163,-308363,OK
766.007507,TraderOne,Tick,4326,4324,2,-2,150800,150900,57763,-308163,-308363,OK
766.270512,TraderOne,Tick,4326,4324,2,-2,150800,150900,57763,-308163,-308363,OK
766.519526,TraderOne,Tick,4336,4324,12,-12,150700,150900,57612,-308012,-310412,OK
766.723495,TraderOne,Tick,4336,4324,12,-12,150700,150900,57612,-308012,-310412,OK
766.955329,TraderOne,Tick,4336,4324,12,-12,150700,150900,57612,-308012,-310412,OK
767.249614,TraderOne,Tick,4336,4324,12,-12,150700,150900,57612,-308012,-310412,OK
767.546312,TraderOne,Tick,4336,4324,12,-12,150700,150900,57612,-308012,-310412,OK
767.764543,TraderOne,Tick,4336,4324,12,-12,150700,150700,57612,-308012,-308012,OK
767.96995,TraderOne,Tick,4336,4334,2,-2,150700,150700,57913,-309313,-309313,OK
768.232616,TraderOne,Tick,4336,4334,2,-2,150700,150700,57913,-309313,-309313,OK
768.468669,TraderOne,Tick,4336,4334,2,-2,150700,150700,57913,-309313,-309313,OK
768.720695,TraderOne,Tick,4336,4334,2,-2,150700,150700,57913,-309313,-309313,OK
769.048895,TraderOne,Tick,4336,4334,2,-2,150700,150700,57913,-309313,-309313,OK
769.24652,TraderOne,Tick,4346,4334,12,-12,150600,150700,58215,-308615,-309815,OK
769.51833,TraderOne,Tick,4356,4334,22,-22,150900,151100,58517,-306917,-311317,OK
769.733049,TraderOne,Tick,4356,4334,22,-22,150900,151100,58517,-306917,-311317,OK
769.950998,TraderOne,Tick,4356,4334,22,-22,150900,151100,58517,-306917,-311317,OK
770.257943,TraderOne,Tick,4356,4334,22,-22,150900,151100,58517,-306917,-311317,OK
770.505099,TraderOne,Tick,4356,4334,22,-22,150900,151100,58517,-306917,-311317,OK
770.744202,TraderOne,Tick,4366,4334,32,-32,150900,151100,58819,-304219,-310619,OK
770.97935,TraderOne,Tick,4366,4334,32,-32,150900,151100,58819,-304219,-310619,OK
771.241157,TraderOne,Tick,4366,4334,32,-32,150900,151100,58819,-304219,-310619,OK
771.522127,TraderOne,Tick,4366,4334,32,-32,150900,151100,58819,-304219,-310619,OK
771.742914,TraderOne,Tick,4366,4334,32,-32,150900,151100,58819,-304219,-310619,OK
771.954763,TraderOne,Tick,4366,4334,32,-32,150900,151100,58819,-304219,-310619,OK
772.298001,TraderOne,Tick,4366,4334,32,-32,150900,151100,58819,-304219,-310619,OK
772.545316,TraderOne,Tick,4366,4334,32,-32,150900,151100,58819,-304219,-310619,OK
772.793725,TraderOne,Tick,4366,4334,32,-32,150900,151100,58819,-304219,-310619,OK
772.982416,TraderOne,Tick,4366,4334,32,-32,150600,151100,58819,-304219,-313819,OK
773.204066,TraderOne,Tick,4366,4344,22,-22,151400,151100,58759,-307159,-300559,OK
773.458009,TraderOne,Tick,4366,4344,22,-22,151400,151100,58759,-307159,-300559,OK
773.783619,TraderOne,Tick,4376,4344,32,-32,150500,151100,58608,-305008,-314608,OK
773.971624,TraderOne,Tick,4376,4344,32,-32,150500,151100,58608,-305008,-314608,OK
774.285056,TraderOne,Tick,4376,4344,32,-32,150500,151100,58608,-305008,-314608,OK
774.546104,TraderOne,Tick,4376,4344,32,-32,150500,151100,58608,-305008,-314608,OK
774.712852,TraderOne,Tick,4376,4344,32,-32,150500,151100,58608,-305008,-314608,OK
774.968979,TraderOne,Tick,4376,4344,32,-32,150500,151100,58608,-305008,-314608,OK
775.280347,TraderOne,Tick,4376,4344,32,-32,150500,151100,58608,-305008,-314608,OK
775.550461,TraderOne,Tick,4376,4344,32,-32,150500,151100,58608,-305008,-314608,OK
775.775169,TraderOne,Tick,4376,4344,32,-32,150500,151100,58608,-305008,-314608,OK
776.025738,TraderOne,Tick,4376,4354,22,-22,151000,151100,58457,-308857,-311057,OK
776.213587,TraderOne,Tick,4376,4364,12,-12,151500,151100,58760,-308160,-304560,OK
776.520924,TraderOne,Tick,4376,4374,2,-2,151500,151100,59063,-306463,-305863,OK
776.722211,TraderOne,Tick,4376,4376,0,0,151500,151100,59124,-305924,-305924,OK
777.020088,TraderOne,Tick,4376,4376,0,0,151500,151100,59124,-305924,-305924,OK
777.221587,TraderOne,Tick,4376,4376,0,0,151500,151100,59124,-305924,-305924,OK
777.544749,TraderOne,Tick,4376,4376,0,0,151500,151100,59124,-305924,-305924,OK
777.766628,TraderOne,Tick,4376,4376,0,0,151500,151100,59124,-305924,-305924,OK
777.975009,TraderOne,Tick,4376,4376,0,0,151500,151100,59124,-305924,-305924,OK
778.279046,TraderOne,Tick,4376,4386,-10,10,151100,151100,58973,-306773,-306773,OK
778.465274,TraderOne,Tick,4376,4386,-10,10,151300,151100,58973,-306773,-308773,OK
778.757502,TraderOne,Tick,4376,4386,-10,10,151300,151100,58973,-306773,-308773,OK
779.028757,TraderOne,Tick,4376,4396,-20,20,151700,151100,58822,-305622,-311622,OK
779.208591,TraderOne,Tick,4376,4396,-20,20,151700,151100,58822,-305622,-311622,OK
779.499809,TraderOne,Tick,4376,4396,-20,20,151700,151100,58822,-305622,-311622,OK
779.762778,TraderOne,Tick,4378,4396,-18,18,151100,151100,58792,-305792,-305792,OK
780.044022,TraderOne,Tick,4378,4396,-18,18,151100,151100,58792,-305792,-305792,OK
780.2825,TraderOne,Tick,4378,4396,-18,18,151100,151100,58792,-305792,-305792,OK
780.534671,TraderOne,Tick,4378,4396,-18,18,151100,151100,58792,-305792,-305792,OK
780.77905,TraderOne,Tick,4378,4396,-18,18,151100,151100,58792,-305792,-305792,OK
781.022756,TraderOne,Tick,4378,4396,-18,18,151100,150800,58792,-305792,-311192,OK
781.266727,TraderOne,Tick,4378,4406,-28,28,151600,150800,58641,-304641,-313041,OK
781.466266,TraderOne,Tick,4378,4406,-28,28,151600,150800,58641,-304641,-313041,OK
781.732879,TraderOne,Tick,4378,4406,-28,28,151600,150800,58641,-304641,-313041,OK
781.964373,TraderOne,Tick,4378,4406,-28,28,151600,150800,58641,-304641,-313041,OK
782.290348,TraderOne,Tick,4378,4406,-28,28,151600,151200,58641,-304641,-313041,OK
782.510628,TraderOne,Tick,4378,4406,-28,28,151600,151200,58641,-304641,-313041,OK
782.737,TraderOne,Tick,4388,4406,-18,18,150900,151400,58489,-307489,-302089,OK
782.997895,TraderOne,Tick,4388,4406,-18,18,150900,151400,58489,-307489,-302089,OK
783.20121,TraderOne,Tick,4388,4406,-18,18,150900,151400,58489,-307489,-302089,OK
783.492735,TraderOne,Tick,4388,4406,-18,18,150900,151400,58489,-307489,-302089,OK
783.773003,TraderOne,Tick,4388,4416,-28,28,151500,151400,58338,-303338,-306138,OK
784.040164,TraderOne,Tick,4388,4416,-28,28,151500,151400,58338,-303338,-306138,OK
784.29356,TraderOne,Tick,4388,4416,-28,28,151500,151400,58338,-303338,-306138,OK
784.492296,TraderOne,Tick,4388,4416,-28,28,151500,151400,58338,-303338,-306138,OK
784.773439,TraderOne,Tick,4388,4416,-28,28,151500,151400,58338,-303338,-306138,OK
785.030343,TraderOne,Tick,4388,4426,-38,38,151500,151400,58187,-300187,-303987,OK
785.249029,TraderOne,Tick,4398,4426,-28,28,150500,151400,58036,-304036,-295636,OK
785.546162,TraderOne,Tick,4398,4426,-28,28,150500,151400,58036,-304036,-295636,OK
785.788817,TraderOne,Tick,4408,4426,-18,18,150500,151400,57885,-306885,-301485,OK
785.982113,TraderOne,Tick,4408,4426,-18,18,150500,151400,57885,-306885,-301485,OK
786.213555,TraderOne,Tick,4408,4426,-18,18,150500,151400,57885,-306885,-301485,OK
786.511566,TraderOne,Tick,4408,4426,-18,18,150500,151400,57885,-306885,-301485,OK
786.77853,TraderOne,Tick,4408,4426,-18,18,150500,151400,57885,-306885,-301485,OK
786.952558,TraderOne,Tick,4408,4426,-18,18,150500,151400,57885,-306885,-301485,OK
787.281933,TraderOne,Tick,4408,4426,-18,18,150500,151400,57885,-306885,-301485,OK
787.521785,TraderOne,Tick,4418,4426,-8,8,150500,150800,57734,-309734,-307334,OK
787.787308,TraderOne,Tick,4418,4426,-8,8,150500,150800,57734,-309734,-307334,OK
787.954332,TraderOne,Tick,4418,4436,-18,18,151400,150500,57583,-304583,-309983,OK
788.26277,TraderOne,Tick,4418,4436,-18,18,151400,150500,57583,-304583,-309983,OK
788.481782,TraderOne,Tick,4418,4436,-18,18,151400,150500,57583,-304583,-309983,OK
788.781948,TraderOne,Tick,4428,4446,-18,18,150500,150500,57281,-303281,-303281,OK
788.985753,TraderOne,Tick,4428,4446,-18,18,150500,150300,57281,-303281,-306881,OK
789.250924,TraderOne,Tick,4428,4446,-18,18,150500,150300,57281,-303281,-306881,OK
789.492922,TraderOne,Tick,4428,4456,-28,28,150500,150200,57582,-301582,-309982,OK
789.712384,TraderOne,Tick,4428,4456,-28,28,150500,150200,57582,-301582,-309982,OK
789.973062,TraderOne,Tick,4428,4456,-28,28,150500,150200,57582,-301582,-309982,OK
790.281372,TraderOne,Tick,4428,4465,-37,37,150700,150200,57446,-298746,-309846,OK
790.520221,TraderOne,Tick,4428,4466,-38,38,150900,150200,57431,-298431,-309831,OK
790.79168,TraderOne,Tick,4428,4466,-38,38,150900,150200,57431,-298431,-309831,OK
791.050014,TraderOne,Tick,4428,4466,-38,38,150900,150400,57431,-298431,-309831,OK
791.223731,TraderOne,Tick,4428,4466,-38,38,150900,150400,57431,-298431,-309831,OK
791.467799,TraderOne,Tick,4428,4466,-38,38,151000,150800,57431,-298431,-306031,OK
791.712351,TraderOne,Tick,4438,4466,-28,28,151100,150800,57733,-301733,-310133,OK
792.015364,TraderOne,Tick,4438,4466,-28,28,151100,150800,57733,-301733,-310133,OK
792.236425,TraderOne,Tick,4448,4466,-18,18,150500,150800,57582,-303582,-298182,OK
792.508464,TraderOne,Tick,4448,4466,-18,18,150500,150800,57582,-303582,-298182,OK
792.70009,TraderOne,Tick,4448,4466,-18,18,150500,150900,57582,-303582,-298182,OK
792.9526,TraderOne,Tick,4448,4466,-18,18,150500,150900,57582,-303582,-298182,OK
793.247534,TraderOne,Tick,4448,4466,-18,18,150500,150900,57582,-303582,-298182,OK
793.502712,TraderOne,Tick,4458,4466,-8,8,150300,150900,57431,-305431,-303031,OK
793.764567,TraderOne,Tick,4458,4466,-8,8,150300,151000,57431,-305431,-303031,OK
793.951391,TraderOne,Tick,4458,4466,-8,8,150300,151000,57431,-305431,-303031,OK
794.293821,TraderOne,Tick,4458,4466,-8,8,150300,151000,57431,-305431,-303031,OK
794.47892,TraderOne,Tick,4458,4466,-8,8,150300,151000,57431,-305431,-303031,OK
794.766973,TraderOne,Tick,4458,4466,-8,8,150300,151000,57431,-305431,-303031,OK
795.028682,TraderOne,Tick,4458,4466,-8,8,150300,150900,57431,-305431,-303031,OK
795.259831,TraderOne,Tick,4458,4466,-8,8,150300,150900,57431,-305431,-303031,OK
795.51459,TraderOne,Tick,4458,4466,-8,8,150300,150900,57431,-305431,-303031,OK
795.72834,TraderOne,Tick,4458,4466,-8,8,150300,150900,57431,-305431,-303031,OK
796.039796,TraderOne,Tick,4458,4476,-18,18,151500,150900,57280,-303280,-308680,OK
796.238908,TraderOne,Tick,4458,4476,-18,18,151500,150600,57280,-303280,-308680,OK
796.488793,TraderOne,Tick,4458,4476,-18,18,151500,150500,57280,-303280,-308680,OK
796.774379,TraderOne,Tick,4458,4486,-28,28,150700,150500,57581,-300581,-306181,OK
796.970029,TraderOne,Tick,4458,4496,-38,38,150700,150500,57882,-297882,-305482,OK
797.268387,TraderOne,Tick,4458,4496,-38,38,150700,150500,57882,-297882,-305482,OK
797.517579,TraderOne,Tick,4458,4496,-38,38,150700,150500,57882,-297882,-305482,OK
797.731352,TraderOne,Tick,4458,4496,-38,38,150700,150500,57882,-297882,-305482,OK
797.99723,TraderOne,Tick,4458,4496,-38,38,150700,150500,57882,-297882,-305482,OK
798.278102,TraderOne,Tick,4458,4496,-38,38,150700,150500,57882,-297882,-305482,OK
798.502684,TraderOne,Tick,4468,4496,-28,28,150700,150500,57731,-301731,-307331,OK
798.70488,TraderOne,Tick,4468,4496,-28,28,150700,150500,57731,-301731,-307331,OK
799.043015,TraderOne,Tick,4468,4496,-28,28,150700,150500,57731,-301731,-307331,OK
799.288175,TraderOne,Tick,4468,4496,-28,28,150700,150500,57731,-301731,-307331,OK
799.457746,TraderOne,Tick,4468,4496,-28,28,150700,150500,57731,-301731,-307331,OK
799.729305,TraderOne,Tick,4468,4496,-28,28,150700,150500,57731,-301731,-307331,OK
799.962388,TraderOne,Tick,4468,4496,-28,28,150700,150500,57731,-301731,-307331,OK
800.237673,TraderOne,Tick,4468,4496,-28,28,150700,150500,57731,-301731,-307331,OK
800.544752,TraderOne,Tick,4478,4496,-18,18,150400,150800,57580,-303580,-298180,OK
800.765068,TraderOne,Tick,4478,4496,-18,18,150400,150800,57580,-303580,-298180,OK
800.995525,TraderOne,Tick,4478,4496,-18,18,150400,150800,57580,-303580,-298180,OK
801.213052,TraderOne,Tick,4478,4496,-18,18,150400,150800,57580,-303580,-298180,OK
801.517048,TraderOne,Tick,4488,4496,-8,8,150200,150800,57429,-305429,-303029,OK
801.753326,TraderOne,Tick,4488,4496,-8,8,150200,150800,57429,-305429,-303029,OK
801.978721,TraderOne,Tick,4498,4496,2,-2,150800,151100,57278,-306278,-306878,OK
802.22313,TraderOne,Tick,4498,4496,2,-2,150800,151100,57278,-306278,-306878,OK
802.494009,TraderOne,Tick,4498,4496,2,-2,150800,151100,57278,-306278,-306878,OK
802.74539,TraderOne,Tick,4498,4496,2,-2,150800,151200,57278,-306278,-306878,OK
803.005765,TraderOne,Tick,4498,4496,2,-2,150800,151200,57278,-306278,-306878,OK
803.249594,TraderOne,Tick,4498,4496,2,-2,150800,151200,57278,-306278,-306878,OK
803.502775,TraderOne,Tick,4498,4496,2,-2,150800,151200,57278,-306278,-306878,OK
803.711453,TraderOne,Tick,4498,4506,-8,8,151600,151200,57127,-305127,-307527,OK
803.964785,TraderOne,Tick,4498,4506,-8,8,151600,151200,57127,-305127,-307527,OK
804.255993,TraderOne,Tick,4498,4506,-8,8,151600,150900,57127,-305127,-307527,OK
804.541821,TraderOne,Tick,4498,4506,-8,8,151600,150900,57127,-305127,-307527,OK
804.751677,TraderOne,Tick,4508,4506,2,-2,150300,150900,56976,-305976,-306576,OK
805.046766,TraderOne,Tick,4508,4506,2,-2,150300,150900,56976,-305976,-306576,OK
805.230006,TraderOne,Tick,4518,4506,12,-12,150400,150900,56825,-305825,-309425,OK
805.469255,TraderOne,Tick,4518,4506,12,-12,150400,150900,56825,-305825,-309425,OK
805.731618,TraderOne,Tick,4518,4506,12,-12,150400,150900,56825,-305825,-309425,OK
805.975061,TraderOne,Tick,4518,4506,12,-12,150400,150900,56825,-305825,-309425,OK
806.223903,TraderOne,Tick,4518,4516,2,-2,151600,150900,56674,-306674,-306074,OK
806.474008,TraderOne,Tick,4518,4516,2,-2,151600,150900,56674,-306674,-306074,OK
806.799198,TraderOne,Tick,4518,4516,2,-2,151600,151100,56674,-306674,-306074,OK
807.049589,TraderOne,Tick,4518,4526,-8,8,151800,151100,56523,-307523,-309923,OK
807.244668,TraderOne,Tick,4518,4526,-8,8,151800,151100,56523,-307523,-309923,OK
807.509762,TraderOne,Tick,4518,4526,-8,8,151800,151100,56523,-307523,-309923,OK
807.707095,TraderOne,Tick,4518,4526,-8,8,151800,151100,56523,-307523,-309923,OK
807.964094,TraderOne,Tick,4518,4526,-8,8,151800,151100,56523,-307523,-309923,OK
808.232231,TraderOne,Tick,4528,4526,2,-2,150500,151300,56372,-309372,-309972,OK
808.465515,TraderOne,Tick,4538,4526,12,-12,150600,151300,56221,-310221,-313821,OK
808.711266,TraderOne,Tick,4538,4526,12,-12,150600,151300,56221,-310221,-313821,OK
809.014243,TraderOne,Tick,4538,4526,12,-12,150600,151300,56221,-310221,-313821,OK
809.249672,TraderOne,Tick,4538,4526,12,-12,150600,151300,56221,-310221,-313821,OK
809.547895,TraderOne,Tick,4538,4536,2,-2,151800,151300,56070,-311070,-310470,OK
809.715344,TraderOne,Tick,4538,4536,2,-2,151800,151300,56070,-311070,-310470,OK
810.041598,TraderOne,Tick,4548,4536,12,-12,150800,151300,55919,-310919,-314519,OK
810.288768,TraderOne,Tick,4548,4536,12,-12,150800,151300,55919,-310919,-314519,OK
810.532975,TraderOne,Tick,4548,4536,12,-12,150800,151300,55919,-310919,-314519,OK
810.716958,TraderOne,Tick,4548,4536,12,-12,150800,151300,55919,-310919,-314519,OK
810.983259,TraderOne,Tick,4548,4536,12,-12,150800,151300,55919,-310919,-314519,OK
811.238598,TraderOne,Tick,4548,4546,2,-2,151800,151300,55768,-311768,-311168,OK
811.500029,TraderOne,Tick,4548,4546,2,-2,151800,151300,55768,-311768,-311168,OK
811.752776,TraderOne,Tick,4548,4546,2,-2,151800,151500,55768,-311768,-311168,OK
811.990505,TraderOne,Tick,4548,4546,2,-2,151800,151500,55768,-311768,-311168,OK
812.300349,TraderOne,Tick,4558,4546,12,-12,150900,151500,55617,-311617,-315217,OK
812.483445,TraderOne,Tick,4558,4546,12,-12,150900,151500,55617,-311617,-315217,OK
812.718762,TraderOne,Tick,4558,4546,12,-12,150900,151400,55617,-311617,-315217,OK
813.048024,TraderOne,Tick,4558,4546,12,-12,150900,151400,55617,-311617,-315217,OK
813.251439,TraderOne,Tick,4560,4546,14,-14,151200,151700,55587,-311187,-315387,OK
813.463577,TraderOne,Tick,4560,4546,14,-14,151200,151900,55587,-311187,-315387,OK
813.746959,TraderOne,Tick,4570,4546,24,-24,151700,152100,55890,-310490,-317690,OK
814.038319,TraderOne,Tick,4580,4546,34,-34,151700,152100,56193,-308793,-318993,OK
814.279172,TraderOne,Tick,4580,4546,34,-34,151700,152100,56193,-308793,-318993,OK
814.479723,TraderOne,Tick,4580,4546,34,-34,151700,152100,56193,-308793,-318993,OK
814.727315,TraderOne,Tick,4580,4556,24,-24,151800,152100,56041,-311641,-318841,OK
815.004697,TraderOne,Tick,4580,4556,24,-24,151800,152100,56041,-311641,-318841,OK
815.253999,TraderOne,Tick,4580,4561,19,-19,151800,152100,55965,-313065,-318765,OK
815.485948,TraderOne,Tick,4580,4561,19,-19,151800,152100,55965,-313065,-318765,OK
815.739042,TraderOne,Tick,4600,4561,39,-39,151900,152100,56117,-310217,-318017,OK
816.037367,TraderOne,Tick,4600,4561,39,-39,151900,152100,56117,-310217,-318017,OK
816.205671,TraderOne,Tick,4600,4561,39,-39,151900,152100,56117,-310217,-318017,OK
816.45336,TraderOne,Tick,4610,4561,49,-49,151900,152100,56421,-306521,-316321,OK
816.736051,TraderOne,Tick,4610,4561,49,-49,151900,152100,56421,-306521,-316321,OK
817.00875,TraderOne,Tick,4610,4561,49,-49,151900,152100,56421,-306521,-316321,OK
817.247646,TraderOne,Tick,4610,4561,49,-49,151900,152100,56421,-306521,-316321,OK
817.545624,TraderOne,Tick,4610,4561,49,-49,151900,152100,56421,-306521,-316321,OK
817.707279,TraderOne,Tick,4620,4561,59,-59,151600,152100,56269,-302369,-320069,OK
817.97695,TraderOne,Tick,4620,4571,49,-49,151900,152100,56117,-308217,-318017,OK
818.298388,TraderOne,Tick,4620,4571,49,-49,151900,152100,56117,-308217,-318017,OK
818.458715,TraderOne,Tick,4620,4571,49,-49,151900,152100,56117,-308217,-318017,OK
818.703177,TraderOne,Tick,4620,4571,49,-49,151900,152400,56117,-308217,-322917,OK
819.021168,TraderOne,Tick,4630,4571,59,-59,151900,152400,56421,-303521,-321221,OK
819.278712,TraderOne,Tick,4640,4571,69,-69,151900,152300,56725,-298825,-319525,OK
819.482294,TraderOne,Tick,4640,4581,59,-59,151600,152300,57028,-304128,-321828,OK
819.753399,TraderOne,Tick,4640,4581,59,-59,151600,152300,57028,-304128,-321828,OK
819.957388,TraderOne,Tick,4640,4581,59,-59,151600,152300,57028,-304128,-321828,OK
820.217708,TraderOne,Tick,4640,4581,59,-59,151600,152300,57028,-304128,-321828,OK
820.495588,TraderOne,Tick,4640,4581,59,-59,151600,152300,57028,-304128,-321828,OK
820.761031,TraderOne,Tick,4640,4581,59,-59,151600,152300,57028,-304128,-321828,OK
820.958205,TraderOne,Tick,4650,4581,69,-69,151900,152300,57332,-299432,-320132,OK
821.233433,TraderOne,Tick,4650,4591,59,-59,151800,152300,57636,-305736,-323436,OK
821.538009,TraderOne,Tick,4660,4591,69,-69,151900,152300,57940,-301040,-321740,OK
821.72335,TraderOne,Tick,4660,4591,69,-69,151900,152300,57940,-301040,-321740,OK
821.969502,TraderOne,Tick,4660,4591,69,-69,151900,152500,57940,-301040,-321740,OK
822.227877,TraderOne,Tick,4660,4591,69,-69,151900,152500,57940,-301040,-321740,OK
822.480839,TraderOne,Tick,4660,4601,59,-59,151900,152500,57788,-307888,-325588,OK
822.756953,TraderOne,Tick,4660,4601,59,-59,151900,152500,57788,-307888,-325588,OK
822.978672,TraderOne,Tick,4660,4611,49,-49,151900,152500,58092,-313192,-327892,OK
823.279631,TraderOne,Tick,4660,4611,49,-49,151900,152300,58092,-313192,-327892,OK
823.536303,TraderOne,Tick,4660,4621,39,-39,152100,152100,57940,-317040,-317040,OK
823.775969,TraderOne,Tick,4660,4621,39,-39,152100,152200,57940,-317040,-320940,OK
823.984875,TraderOne,Tick,4660,4621,39,-39,152100,152200,57940,-317040,-320940,OK
824.251535,TraderOne,Tick,4660,4621,39,-39,152100,152200,57940,-317040,-320940,OK
824.483709,TraderOne,Tick,4660,4621,39,-39,152100,152200,57940,-317040,-320940,OK
824.702812,TraderOne,Tick,4660,4621,39,-39,152100,152000,57940,-317040,-313140,OK
824.960883,TraderOne,Tick,4670,4621,49,-49,151500,152000,57788,-313888,-328588,OK
825.282626,TraderOne,Tick,4670,4621,49,-49,151500,152000,57788,-313888,-328588,OK
825.48183,TraderOne,Tick,4670,4621,49,-49,151500,152000,57788,-313888,-328588,OK
825.744603,TraderOne,Tick,4670,4621,49,-49,151500,152000,57788,-313888,-328588,OK
826.009846,TraderOne,Tick,4670,4621,49,-49,151500,152000,57788,-313888,-328588,OK
826.268793,TraderOne,Tick,4670,4621,49,-49,151500,152000,57788,-313888,-328588,OK
826.467272,TraderOne,Tick,4670,4621,49,-49,151500,152000,57788,-313888,-328588,OK
826.749543,TraderOne,Tick,4670,4621,49,-49,151500,152000,57788,-313888,-328588,OK
826.975634,TraderOne,Tick,4670,4621,49,-49,151500,152000,57788,-313888,-328588,OK
827.215198,TraderOne,Tick,4680,4621,59,-59,151500,152000,57636,-309736,-327436,OK
827.548074,TraderOne,Tick,4680,4621,59,-59,151500,152000,57636,-309736,-327436,OK
827.789218,TraderOne,Tick,4690,4621,69,-69,151500,152000,57484,-304584,-325284,OK
827.997481,TraderOne,Tick,4690,4621,69,-69,151500,152000,57484,-304584,-325284,OK
828.257711,TraderOne,Tick,4690,4631,59,-59,151500,152000,57332,-314432,-332132,OK
828.488073,TraderOne,Tick,4690,4631,59,-59,151500,152300,57332,-314432,-332132,OK
828.754755,TraderOne,Tick,4690,4641,49,-49,152200,152300,57180,-319280,-324180,OK
829.010252,TraderOne,Tick,4690,4641,49,-49,152200,152300,57180,-319280,-324180,OK
829.263251,TraderOne,Tick,4690,4641,49,-49,152200,152500,57180,-319280,-333980,OK
829.475402,TraderOne,Tick,4690,4641,49,-49,152200,152500,57180,-319280,-333980,OK
829.760967,TraderOne,Tick,4690,4651,39,-39,152200,152500,57028,-323128,-334828,OK
829.9785,TraderOne,Tick,4690,4651,39,-39,152200,152400,57028,-323128,-330928,OK
830.221664,TraderOne,Tick,4690,4651,39,-39,152200,152400,57028,-323128,-330928,OK
830.506045,TraderOne,Tick,4700,4651,49,-49,151800,152400,56876,-319976,-334676,OK
830.726291,TraderOne,Tick,4710,4651,59,-59,151800,152500,56724,-315824,-333524,OK
831.001086,TraderOne,Tick,4710,4661,49,-49,152000,152500,56572,-320672,-335372,OK
831.258158,TraderOne,Tick,4710,4661,49,-49,152000,152500,56572,-320672,-335372,OK
831.541903,TraderOne,Tick,4710,4661,49,-49,152000,152500,56572,-320672,-335372,OK
831.783133,TraderOne,Tick,4710,4671,39,-39,152100,152600,56420,-324520,-336220,OK
832.049786,TraderOne,Tick,4720,4671,49,-49,152200,152600,56724,-321824,-336524,OK
832.233489,TraderOne,Tick,4720,4671,49,-49,152200,152600,56724,-321824,-336524,OK
832.530758,TraderOne,Tick,4720,4675,45,-45,152000,152500,56846,-323546,-337046,OK
832.752319,TraderOne,Tick,4720,4675,45,-45,152000,152500,56846,-323546,-337046,OK
832.964293,TraderOne,Tick,4720,4675,45,-45,152000,152600,56846,-323546,-337046,OK
833.255619,TraderOne,Tick,4730,4675,55,-55,152200,152600,57150,-319850,-336350,OK
833.451406,TraderOne,Tick,4730,4675,55,-55,152200,152600,57150,-319850,-336350,OK
833.70992,TraderOne,Tick,4730,4675,55,-55,152200,152600,57150,-319850,-336350,OK
834.038208,TraderOne,Tick,4730,4675,55,-55,152200,152600,57150,-319850,-336350,OK
834.242851,TraderOne,Tick,4730,4675,55,-55,152200,152600,57150,-319850,-336350,OK
834.489204,TraderOne,Tick,4730,4675,55,-55,152200,152600,57150,-319850,-336350,OK
834.78094,TraderOne,Tick,4730,4675,55,-55,152200,152400,57150,-319850,-330850,OK
834.9909,TraderOne,Tick,4730,4675,55,-55,152200,152400,57150,-319850,-330850,OK
835.282969,TraderOne,Tick,4730,4675,55,-55,152200,152400,57150,-319850,-330850,OK
835.480803,TraderOne,Tick,4730,4675,55,-55,152200,152400,57150,-319850,-330850,OK
835.781467,TraderOne,Tick,4730,4675,55,-55,152200,152400,57150,-319850,-330850,OK
836.00361,TraderOne,Tick,4730,4685,45,-45,152200,152400,56998,-324698,-333698,OK
836.278814,TraderOne,Tick,4730,4685,45,-45,152200,152200,56998,-324698,-324698,OK
836.476869,TraderOne,Tick,4730,4685,45,-45,152200,152200,56998,-324698,-324698,OK
836.721491,TraderOne,Tick,4730,4695,35,-35,152000,152200,56846,-328546,-335546,OK
837.027367,TraderOne,Tick,4730,4695,35,-35,152000,152200,56846,-328546,-335546,OK
837.289753,TraderOne,Tick,4740,4695,45,-45,151600,152200,56694,-324394,-337894,OK
837.53687,TraderOne,Tick,4740,4695,45,-45,151600,152200,56694,-324394,-337894,OK
837.735756,TraderOne,Tick,4740,4695,45,-45,151600,152200,56694,-324394,-337894,OK
838.040561,TraderOne,Tick,4740,4705,35,-35,152000,152200,56542,-329242,-336242,OK
838.214772,TraderOne,Tick,4740,4715,25,-25,152100,152200,56846,-331546,-334046,OK
838.529717,TraderOne,Tick,4740,4725,15,-15,152100,152200,57150,-333850,-335350,OK
838.773284,TraderOne,Tick,4740,4735,5,-5,152100,152100,57454,-334154,-334154,OK
838.984517,TraderOne,Tick,4740,4745,-5,5,152300,152100,57302,-334002,-335002,OK
839.292053,TraderOne,Tick,4740,4745,-5,5,152300,152100,57302,-334002,-335002,OK
839.497235,TraderOne,Tick,4744,4745,-1,1,152200,152100,57241,-333941,-334041,OK
839.720605,TraderOne,Tick,4754,4745,9,-9,152300,152100,57546,-336246,-334446,OK
840.000907,TraderOne,Tick,4754,4745,9,-9,152300,152100,57546,-336246,-334446,OK
840.288686,TraderOne,Tick,4754,4745,9,-9,152300,152100,57546,-336246,-334446,OK
840.476295,TraderOne,Tick,4754,4745,9,-9,152100,152100,57546,-336246,-336246,OK
840.776807,TraderOne,Tick,4764,4745,19,-19,152300,152100,57851,-335551,-331751,OK
840.977316,TraderOne,Tick,4773,4745,28,-28,152300,152100,58125,-334025,-328425,OK
841.286491,TraderOne,Tick,4773,4745,28,-28,152400,152100,58125,-334025,-325625,OK
841.476805,TraderOne,Tick,4773,4745,28,-28,152400,152400,58125,-334025,-334025,OK
841.761444,TraderOne,Tick,4773,4745,28,-28,152400,152400,58125,-334025,-334025,OK
841.995449,TraderOne,Tick,4773,4745,28,-28,152400,152400,58125,-334025,-334025,OK
842.241913,TraderOne,Tick,4773,4755,18,-18,152100,152400,58429,-336329,-341729,OK
842.482022,TraderOne,Tick,4773,4755,18,-18,152100,152400,58429,-336329,-341729,OK
842.740148,TraderOne,Tick,4773,4755,18,-18,152100,152400,58429,-336329,-341729,OK
842.99741,TraderOne,Tick,4773,4755,18,-18,152100,152400,58429,-336329,-341729,OK
843.246242,TraderOne,Tick,4773,4755,18,-18,152100,152400,58429,-336329,-341729,OK
843.523677,TraderOne,Tick,4773,4755,18,-18,152100,152400,58429,-336329,-341729,OK
843.742894,TraderOne,Tick,4773,4755,18,-18,152100,152400,58429,-336329,-341729,OK
844.046443,TraderOne,Tick,4773,4755,18,-18,152100,152400,58429,-336329,-341729,OK
844.232198,TraderOne,Tick,4773,4755,18,-18,152100,152700,58429,-336329,-341729,OK
844.533219,TraderOne,Tick,4783,4755,28,-28,152400,153000,58734,-333634,-342034,OK
844.722109,TraderOne,Tick,4793,4755,38,-38,152400,153000,59039,-328939,-340339,OK
845.018375,TraderOne,Tick,4803,4755,48,-48,152500,152900,59344,-324244,-338644,OK
845.285125,TraderOne,Tick,4803,4755,48,-48,152500,152900,59344,-324244,-338644,OK
845.484901,TraderOne,Tick,4803,4755,48,-48,152500,152900,59344,-324244,-338644,OK
845.754878,TraderOne,Tick,4803,4755,48,-48,152500,152900,59344,-324244,-338644,OK
845.968606,TraderOne,Tick,4803,4755,48,-48,152500,152400,59344,-324244,-319444,OK
846.215866,TraderOne,Tick,4803,4765,38,-38,152100,152400,59648,-328548,-339948,OK
846.514521,TraderOne,Tick,4803,4765,38,-38,152100,152400,59648,-328548,-339948,OK
846.770031,TraderOne,Tick,4803,4765,38,-38,152100,152400,59648,-328548,-339948,OK
847.024578,TraderOne,Tick,4805,4765,40,-40,152500,152400,59709,-328009,-324009,OK
847.285059,TraderOne,Tick,4805,4765,40,-40,152500,152700,59709,-328009,-336009,OK
847.494789,TraderOne,Tick,4805,4765,40,-40,152500,152700,59709,-328009,-336009,OK
847.765761,TraderOne,Tick,4805,4765,40,-40,152500,152700,59709,-328009,-336009,OK
848.032206,TraderOne,Tick,4805,4775,30,-30,152300,152700,59557,-335857,-344857,OK
848.286608,TraderOne,Tick,4815,4775,40,-40,152500,152700,59862,-332162,-340162,OK
848.51304,TraderOne,Tick,4819,4775,44,-44,152500,152700,59984,-330684,-339484,OK
848.707034,TraderOne,Tick,4819,4775,44,-44,152500,152700,59984,-330684,-339484,OK
848.98069,TraderOne,Tick,4829,4775,54,-54,152600,152700,60289,-326989,-332389,OK
849.243815,TraderOne,Tick,4829,4775,54,-54,152600,152900,60289,-326989,-343189,OK
849.534344,TraderOne,Tick,4829,4785,44,-44,152600,153100,60594,-332294,-345494,OK
849.776492,TraderOne,Tick,4829,4785,44,-44,152600,153100,60594,-332294,-345494,OK
850.007635,TraderOne,Tick,4829,4785,44,-44,152700,153100,60594,-332294,-345494,OK
850.221626,TraderOne,Tick,4829,4785,44,-44,152700,153100,60594,-332294,-345494,OK
850.550816,TraderOne,Tick,4829,4785,44,-44,152700,153200,60594,-332294,-345494,OK
850.774306,TraderOne,Tick,4839,4785,54,-54,152700,153200,60900,-327100,-343300,OK
850.962553,TraderOne,Tick,4849,4785,64,-64,152700,153200,61205,-322405,-341605,OK
851.276193,TraderOne,Tick,4849,4785,64,-64,152700,153200,61205,-322405,-341605,OK
851.509523,TraderOne,Tick,4849,4785,64,-64,152700,153800,61205,-322405,-341605,OK
851.799951,TraderOne,Tick,4859,4785,74,-74,153200,153800,61510,-312710,-334910,OK
852.016115,TraderOne,Tick,4859,4795,64,-64,153200,153700,61816,-319016,-338216,OK
852.276875,TraderOne,Tick,4859,4795,64,-64,153200,153700,61816,-319016,-338216,OK
852.478227,TraderOne,Tick,4859,4795,64,-64,153200,153700,61816,-319016,-338216,OK
852.754856,TraderOne,Tick,4869,4795,74,-74,153000,153600,61663,-314863,-337063,OK
853.01919,TraderOne,Tick,4869,4805,64,-64,153000,153600,61969,-322169,-341369,OK
853.292313,TraderOne,Tick,4869,4815,54,-54,153400,154100,61816,-330016,-346216,OK
853.487015,TraderOne,Tick,4869,4815,54,-54,153400,154100,61816,-330016,-346216,OK
853.800669,TraderOne,Tick,4869,4815,54,-54,153400,154000,61816,-330016,-346216,OK
853.967587,TraderOne,Tick,4869,4815,54,-54,153400,154000,61816,-330016,-346216,OK
854.212813,TraderOne,Tick,4869,4815,54,-54,153500,153900,61816,-330016,-346216,OK
854.504955,TraderOne,Tick,4869,4815,54,-54,153500,153900,61816,-330016,-346216,OK
854.773216,TraderOne,Tick,4869,4815,54,-54,153500,153900,61816,-330016,-346216,OK
855.048104,TraderOne,Tick,4869,4815,54,-54,153500,153900,61816,-330016,-346216,OK
855.211728,TraderOne,Tick,4869,4815,54,-54,153500,153900,61816,-330016,-346216,OK
855.537775,TraderOne,Tick,4869,4815,54,-54,153500,153900,61816,-330016,-346216,OK
855.724219,TraderOne,Tick,4869,4815,54,-54,153500,153900,61816,-330016,-346216,OK
856.004559,TraderOne,Tick,4869,4815,54,-54,153500,153800,61816,-330016,-346216,OK
856.247228,TraderOne,Tick,4869,4815,54,-54,153500,153800,61816,-330016,-346216,OK
856.51856,TraderOne,Tick,4869,4815,54,-54,153500,153800,61816,-330016,-346216,OK
856.757898,TraderOne,Tick,4869,4825,44,-44,153300,154000,61663,-335863,-349063,OK
857.013739,TraderOne,Tick,4869,4825,44,-44,153300,154000,61663,-335863,-349063,OK
857.266856,TraderOne,Tick,4869,4825,44,-44,153300,154000,61663,-335863,-349063,OK
857.454963,TraderOne,Tick,4869,4825,44,-44,153300,154000,61663,-335863,-349063,OK
857.73044,TraderOne,Tick,4879,4825,54,-54,153700,154000,61509,-331709,-347909,OK
857.995099,TraderOne,Tick,4879,4825,54,-54,153700,154000,61509,-331709,-347909,OK
858.228133,TraderOne,Tick,4879,4825,54,-54,153700,154000,61509,-331709,-347909,OK
858.469902,TraderOne,Tick,4879,4825,54,-54,153700,154000,61509,-331709,-347909,OK
858.773486,TraderOne,Tick,4879,4835,44,-44,153700,154000,61355,-335555,-348755,OK
858.970426,TraderOne,Tick,4879,4835,44,-44,153700,154000,61355,-335555,-348755,OK
859.210655,TraderOne,Tick,4879,4835,44,-44,153700,153600,61355,-335555,-331155,OK
859.474822,TraderOne,Tick,4879,4835,44,-44,153200,153800,61355,-335555,-348755,OK
859.772886,TraderOne,Tick,4879,4835,44,-44,153200,153800,61355,-335555,-348755,OK
860.028652,TraderOne,Tick,4879,4835,44,-44,153200,153600,61355,-335555,-348755,OK
860.287476,TraderOne,Tick,4879,4845,34,-34,153700,153600,61661,-339861,-336461,OK
860.511054,TraderOne,Tick,4879,4845,34,-34,153700,153600,61661,-339861,-336461,OK
860.773053,TraderOne,Tick,4879,4845,34,-34,153700,153600,61661,-339861,-336461,OK
860.957817,TraderOne,Tick,4879,4845,34,-34,153700,153600,61661,-339861,-336461,OK
861.279163,TraderOne,Tick,4879,4855,24,-24,153700,153600,61508,-342708,-340308,OK
861.544441,TraderOne,Tick,4879,4855,24,-24,153700,153700,61508,-342708,-342708,OK
861.716511,TraderOne,Tick,4879,4855,24,-24,153700,153700,61508,-342708,-342708,OK
861.975072,TraderOne,Tick,4879,4855,24,-24,153700,153600,61508,-342708,-340308,OK
862.221129,TraderOne,Tick,4879,4865,14,-14,153900,153600,61354,-344554,-340354,OK
862.454573,TraderOne,Tick,4889,4865,24,-24,153000,153600,61201,-342401,-349601,OK
862.799458,TraderOne,Tick,4889,4868,21,-21,153600,153600,61155,-342655,-342655,OK
863.012233,TraderOne,Tick,4889,4868,21,-21,153600,153300,61155,-342655,-336355,OK
863.261102,TraderOne,Tick,4889,4878,11,-11,152900,153000,61461,-344961,-346061,OK
863.489435,TraderOne,Tick,4889,4888,1,-1,153100,153000,61308,-344808,-344708,OK
863.741914,TraderOne,Tick,4889,4898,-9,9,153200,153000,61614,-345114,-346914,OK
864.028225,TraderOne,Tick,4899,4908,-9,9,152900,153000,61767,-345267,-344367,OK
864.256117,TraderOne,Tick,4899,4918,-19,19,153400,153000,61614,-344114,-349814,OK
864.50017,TraderOne,Tick,4899,4918,-19,19,153400,153000,61614,-344114,-349814,OK
864.779336,TraderOne,Tick,4899,4918,-19,19,153400,153000,61614,-344114,-349814,OK
864.962706,TraderOne,Tick,4899,4928,-29,29,153400,153000,61461,-341961,-350661,OK
865.246579,TraderOne,Tick,4907,4928,-21,21,153100,153000,61339,-345039,-347139,OK
865.535102,TraderOne,Tick,4907,4928,-21,21,153100,153000,61339,-345039,-347139,OK
865.763881,TraderOne,Tick,4907,4928,-21,21,153100,153000,61339,-345039,-347139,OK
866.015408,TraderOne,Tick,4907,4938,-31,31,153400,153000,61186,-341886,-351186,OK
866.29523,TraderOne,Tick,4907,4938,-31,31,153400,153000,61186,-341886,-351186,OK
866.538941,TraderOne,Tick,4907,4948,-41,41,153400,152900,61033,-336733,-349033,OK
866.716049,TraderOne,Tick,4907,4948,-41,41,153400,152900,61033,-336733,-349033,OK
867.001607,TraderOne,Tick,4917,4948,-31,31,152900,152900,60880,-342580,-342580,OK
867.248236,TraderOne,Tick,4917,4948,-31,31,152900,152900,60880,-342580,-342580,OK
867.454595,TraderOne,Tick,4927,4948,-21,31,152600,152900,60727,-1875427,-340127,OK
867.746666,TraderOne,Tick,4937,4948,-11,11,153200,152900,60574,-349274,-352574,OK
868.041318,TraderOne,Tick,4947,4948,-1,1,153000,152900,60880,-350580,-350680,OK
868.223639,TraderOne,Tick,4951,4949,2,-2,153100,153000,60804,-350804,-350604,OK
868.459447,TraderOne,Tick,4951,4949,2,-2,153100,153200,60804,-350804,-351004,OK
868.738013,TraderOne,Tick,4951,4949,2,-2,153100,153200,60804,-350804,-351004,OK
868.999008,TraderOne,Tick,4951,4949,2,-2,153100,153200,60804,-350804,-351004,OK
869.260412,TraderOne,Tick,4951,4949,2,-2,153100,153200,60804,-350804,-351004,OK
869.474725,TraderOne,Tick,4951,4949,2,-2,153100,153200,60804,-350804,-351004,OK
869.730087,TraderOne,Tick,4951,4949,2,-2,153100,153200,60804,-350804,-351004,OK
870.016115,TraderOne,Tick,4951,4949,2,-2,153100,153200,60804,-350804,-351004,OK
870.227843,TraderOne,Tick,4951,4949,2,-2,153100,153200,60804,-350804,-351004,OK
870.456004,TraderOne,Tick,4951,4949,2,-2,153100,153200,60804,-350804,-351004,OK
870.712979,TraderOne,Tick,4951,4963,-12,12,153200,153200,61049,-350649,-350649,OK
871.009591,TraderOne,Tick,4951,4963,-12,12,153200,153200,61049,-350649,-350649,OK
871.264786,TraderOne,Tick,4951,4963,-12,12,153200,153200,61049,-350649,-350649,OK
871.519233,TraderOne,Tick,4951,4963,-12,12,153200,153200,61049,-350649,-350649,OK
871.762796,TraderOne,Tick,4951,4963,-12,12,153200,153200,61049,-350649,-350649,OK
872.021626,TraderOne,Tick,4951,4963,-12,12,153200,153200,61049,-350649,-350649,OK
872.275178,TraderOne,Tick,4951,4963,-12,12,153200,153200,61049,-350649,-350649,OK
872.542972,TraderOne,Tick,4951,4963,-12,12,153200,152500,61049,-350649,-354249,OK
872.735305,TraderOne,Tick,4951,4973,-22,22,152900,152500,61355,-347955,-354555,OK
872.983984,TraderOne,Tick,4951,4983,-32,32,152900,152500,61661,-344261,-353861,OK
873.214097,TraderOne,Tick,4951,4983,-32,32,152900,152200,61661,-344261,-353861,OK
873.521052,TraderOne,Tick,4961,4983,-22,22,152900,152200,61508,-352108,-358708,OK
873.755982,TraderOne,Tick,4961,4993,-32,32,152600,152300,61813,-349413,-359013,OK
874.01684,TraderOne,Tick,4971,4993,-22,22,152600,152400,61660,-353260,-357660,OK
874.262614,TraderOne,Tick,4971,5003,-32,32,153000,152400,61507,-350107,-359707,OK
874.495018,TraderOne,Tick,4971,5013,-42,42,153000,152400,61354,-345954,-358554,OK
874.787769,TraderOne,Tick,4981,5013,-32,32,152800,152400,61201,-351801,-361401,OK
875.024811,TraderOne,Tick,4981,5013,-32,32,152800,152400,61201,-351801,-361401,OK
875.275182,TraderOne,Tick,4991,5013,-22,22,152700,152500,61506,-355106,-359506,OK
875.46293,TraderOne,Tick,5001,5013,-12,12,152700,152500,61811,-358411,-360811,OK
875.759509,TraderOne,Tick,5001,5013,-12,12,152700,152500,61811,-358411,-360811,OK
875.974341,TraderOne,Tick,5001,5013,-12,12,152700,152500,61811,-358411,-360811,OK
876.21715,TraderOne,Tick,5001,5013,-12,12,152700,152500,61811,-358411,-360811,OK
876.539304,TraderOne,Tick,5001,5023,-22,22,152600,152500,62116,-355716,-357916,OK
876.728521,TraderOne,Tick,5001,5033,-32,32,152600,152500,62421,-352021,-355221,OK
876.982214,TraderOne,Tick,5001,5043,-42,42,152600,152500,62726,-348326,-352526,OK
877.284983,TraderOne,Tick,5001,5043,-42,42,152600,152500,62726,-348326,-352526,OK
877.529706,TraderOne,Tick,5001,5053,-52,52,152800,152500,62573,-343173,-358773,OK
877.746242,TraderOne,Tick,5001,5053,-52,52,152800,152500,62573,-343173,-358773,OK
877.983559,TraderOne,Tick,5001,5053,-52,52,152800,152500,62573,-343173,-358773,OK
878.28815,TraderOne,Tick,5011,5053,-42,42,152300,152500,62420,-349020,-340620,OK
878.540144,TraderOne,Tick,5011,5053,-42,42,152300,152500,62420,-349020,-340620,OK
878.767222,TraderOne,Tick,5011,5063,-52,52,152700,152500,62267,-343867,-354267,OK
879.02176,TraderOne,Tick,5011,5063,-52,52,152700,152500,62267,-343867,-354267,OK
879.236359,TraderOne,Tick,5011,5063,-52,52,152700,152500,62267,-343867,-354267,OK
879.511711,TraderOne,Tick,5021,5073,-52,52,152800,152500,61961,-344561,-360161,OK
879.774945,TraderOne,Tick,5021,5073,-52,52,152800,152300,61961,-344561,-360161,OK
880.040995,TraderOne,Tick,5031,5073,-42,42,152700,151800,61808,-351408,-364008,OK
880.29577,TraderOne,Tick,5031,5083,-52,52,152300,151700,62113,-345713,-361313,OK
880.468689,TraderOne,Tick,5031,5083,-52,52,152300,151500,62113,-345713,-361313,OK
880.700172,TraderOne,Tick,5031,5093,-62,62,152100,151500,62417,-340017,-358617,OK
881.008658,TraderOne,Tick,5041,5093,-52,52,152100,151500,62265,-346865,-362465,OK
881.25951,TraderOne,Tick,5041,5093,-52,52,152100,151500,62265,-346865,-362465,OK
881.536835,TraderOne,Tick,5041,5093,-52,52,152100,151500,62265,-346865,-362465,OK
881.75055,TraderOne,Tick,5051,5093,-42,42,152000,151500,62113,-352713,-365313,OK
882.032691,TraderOne,Tick,5051,5102,-51,51,151900,151500,62386,-348486,-363786,OK
882.247311,TraderOne,Tick,5061,5102,-41,41,152000,151500,62690,-352790,-365090,OK
882.532707,TraderOne,Tick,5061,5102,-41,41,152300,151500,62690,-352790,-365090,OK
882.744799,TraderOne,Tick,5070,5112,-42,42,152300,151500,62401,-352001,-364601,OK
882.961694,TraderOne,Tick,5070,5112,-42,42,152300,151500,62401,-352001,-364601,OK
883.273368,TraderOne,Tick,5070,5112,-42,42,152300,151500,62401,-352001,-364601,OK
883.521314,TraderOne,Tick,5070,5112,-42,42,152300,151500,62401,-352001,-364601,OK
883.721489,TraderOne,Tick,5080,5112,-32,32,152300,151500,62706,-355306,-364906,OK
884.045808,TraderOne,Tick,5090,5112,-22,22,152300,151500,63011,-358611,-365211,OK
884.290443,TraderOne,Tick,5100,5112,-12,12,152300,152200,63316,-360916,-362116,OK
884.451585,TraderOne,Tick,5100,5112,-12,12,152300,152200,63316,-360916,-362116,OK
884.734739,TraderOne,Tick,5110,5112,-2,2,152300,152200,63621,-364221,-364421,OK
885.026527,TraderOne,Tick,5110,5112,-2,2,152300,152200,63621,-364221,-364421,OK
885.221926,TraderOne,Tick,5120,5112,8,-8,151700,152200,63697,-364297,-366697,OK
885.525822,TraderOne,Tick,5120,5112,8,-8,151700,152200,63697,-364297,-366697,OK
885.702318,TraderOne,Tick,5120,5112,8,-8,151700,152200,63697,-364297,-366697,OK
885.992662,TraderOne,Tick,5120,5112,8,-8,151700,152200,63697,-364297,-366697,OK
886.287724,TraderOne,Tick,5130,5112,18,-18,152300,152200,63545,-364145,-362345,OK
886.479583,TraderOne,Tick,5140,5112,28,-28,152000,152200,63849,-360449,-366049,OK
886.790425,TraderOne,Tick,5150,5112,38,-38,152000,152200,64153,-356753,-364353,OK
887.01112,TraderOne,Tick,5160,5112,48,-48,152000,152200,64457,-352057,-361657,OK
887.229366,TraderOne,Tick,5160,5122,38,-38,153000,152200,64305,-354905,-343505,OK
887.508954,TraderOne,Tick,5160,5132,28,-28,152900,152200,64611,-352211,-343811,OK
887.76466,TraderOne,Tick,5160,5142,18,-18,152900,152200,64917,-349517,-344117,OK
888.044648,TraderOne,Tick,5160,5143,17,-17,152900,152200,64948,-349148,-344048,OK
888.249416,TraderOne,Tick,5170,5143,27,-27,152300,152200,64796,-348996,-346296,OK
888.54483,TraderOne,Tick,5170,5153,17,-17,153000,152200,64644,-349844,-344744,OK
888.74228,TraderOne,Tick,5170,5153,17,-17,153000,152200,64644,-349844,-344744,OK
888.960988,TraderOne,Tick,5180,5153,27,-27,152200,152200,64492,-350692,-350692,OK
889.278007,TraderOne,Tick,5190,5163,27,-27,153000,152000,64644,-349844,-341744,OK
889.467303,TraderOne,Tick,5190,5173,17,-17,152600,152000,64492,-351692,-346592,OK
889.755605,TraderOne,Tick,5190,5173,17,-17,152600,152000,64492,-351692,-346592,OK
889.985856,TraderOne,Tick,5190,5173,17,-17,152600,152000,64492,-351692,-346592,OK
890.212523,TraderOne,Tick,5190,5183,7,-7,152400,152000,64340,-352540,-350440,OK
890.543422,TraderOne,Tick,5190,5183,7,-7,152400,151900,64340,-352540,-350440,OK
890.794758,TraderOne,Tick,5200,5183,17,-17,151400,152000,64188,-352388,-357488,OK
891.049063,TraderOne,Tick,5210,5183,27,-27,151400,152000,64036,-351236,-359336,OK
891.239001,TraderOne,Tick,5210,5183,27,-27,151400,152000,64036,-351236,-359336,OK
891.493401,TraderOne,Tick,5220,5193,27,-27,151700,152000,63732,-351932,-360032,OK
891.744535,TraderOne,Tick,5230,5193,37,-37,151500,152000,64035,-348235,-359335,OK
891.966658,TraderOne,Tick,5240,5193,47,-47,151500,152000,64338,-343538,-357638,OK
892.216659,TraderOne,Tick,5241,5193,48,-48,151500,152000,64368,-343168,-357568,OK
892.457831,TraderOne,Tick,5241,5193,48,-48,151500,152000,64368,-343168,-357568,OK
892.702758,TraderOne,Tick,5241,5193,48,-48,151500,152000,64368,-343168,-357568,OK
893.024947,TraderOne,Tick,5241,5203,38,-38,152600,152100,64216,-347016,-335616,OK
893.22904,TraderOne,Tick,5241,5203,38,-38,152600,152100,64216,-347016,-335616,OK
893.503545,TraderOne,Tick,5241,5203,38,-38,152600,152100,64216,-347016,-335616,OK
893.754817,TraderOne,Tick,5241,5203,38,-38,152600,151900,64216,-347016,-335616,OK
893.974376,TraderOne,Tick,5241,5213,28,-28,151700,151900,64519,-348319,-353919,OK
894.299823,TraderOne,Tick,5241,5223,18,-18,151700,151700,64822,-348622,-348622,OK
894.513818,TraderOne,Tick,5241,5233,8,-8,151800,151700,65126,-347926,-347126,OK
894.761301,TraderOne,Tick,5241,5243,-2,2,151800,151700,65430,-348230,-348430,OK
895.046771,TraderOne,Tick,5241,5243,-2,2,151800,151600,65430,-348230,-348630,OK
895.204707,TraderOne,Tick,5241,5253,-12,12,151800,151600,65734,-346534,-348934,OK
895.54934,TraderOne,Tick,5241,5263,-22,22,151800,151500,66038,-344838,-351438,OK
895.725137,TraderOne,Tick,5241,5273,-32,32,151800,151500,66342,-342142,-351742,OK
895.95173,TraderOne,Tick,5241,5273,-32,32,151800,151500,66342,-342142,-351742,OK
896.299225,TraderOne,Tick,5241,5283,-42,42,152100,151500,66190,-336990,-349590,OK
896.546058,TraderOne,Tick,5251,5283,-32,32,151900,151500,66494,-342294,-351894,OK
896.770735,TraderOne,Tick,5251,5283,-32,32,151900,151500,66494,-342294,-351894,OK
896.962874,TraderOne,Tick,5261,5283,-22,22,151900,151500,66798,-345598,-352198,OK
897.250427,TraderOne,Tick,5271,5283,-12,12,151900,151500,67102,-348902,-352502,OK
897.513793,TraderOne,Tick,5271,5283,-12,12,151900,151500,67102,-348902,-352502,OK
897.764049,TraderOne,Tick,5271,5283,-12,12,151900,151500,67102,-348902,-352502,OK
897.989962,TraderOne,Tick,5271,5283,-12,12,151900,151700,67102,-348902,-351302,OK
898.269899,TraderOne,Tick,5272,5293,-21,21,152400,151700,66980,-346880,-353180,OK
898.510854,TraderOne,Tick,5272,5293,-21,21,152400,151700,66980,-346880,-353180,OK
898.77998,TraderOne,Tick,5272,5303,-31,31,152400,151700,66828,-343728,-353028,OK
898.971124,TraderOne,Tick,5272,5303,-31,31,152400,151700,66828,-343728,-353028,OK
899.256813,TraderOne,Tick,5272,5303,-31,31,152400,151800,66828,-343728,-353028,OK
899.513895,TraderOne,Tick,5272,5303,-31,31,152400,151800,66828,-343728,-353028,OK
899.703502,TraderOne,Tick,5272,5303,-31,31,152400,151600,66828,-343728,-353028,OK
899.991193,TraderOne,Tick,5272,5303,-31,31,152400,151600,66828,-343728,-353028,OK
900.297503,TraderOne,Tick,5272,5303,-31,31,152400,151600,66828,-343728,-353028,OK
